,District,Area (m²),Bedrooms,Bathrooms,Garage Cars,Rent (R$),Condominium Fee (R$),Total Value (R$),Value per m²
0,Vila Nova Conceição,100,3,3,1,8500,600,9100,91.0
1,Centro,70,2,2,1,2100,780,2880,41.142857
2,Moema,110,2,3,2,4200,1400,5600,50.909092
3,Liberdade,39,1,1,1,2700,540,3240,83.07692
4,Campo Belo,45,1,1,1,1950,580,2530,56.22222
5,Outro,70,2,2,1,3200,700,3900,55.714287
6,Tatuapé,20,1,1,0,1240,117,1357,67.85
7,Vila Madalena,48,1,1,1,2200,982,3182,66.291664
8,Vila Leopoldina,61,2,2,1,2900,650,3550,58.19672
9,Itaim Bibi,125,3,4,2,9500,1850,11350,90.8
10,Jardim Paulista,100,1,2,1,3750,1200,4950,49.5
11,Vila Andrade,74,2,2,2,2900,660,3560,48.10811
12,Outro,55,2,1,1,1490,0,1490,27.09091
13,Moema,144,4,6,2,5700,1640,7340,50.97222
14,Jardins,72,2,2,1,5700,1123,6823,94.763885
15,Jardim Marajoara,72,1,1,1,1495,720,2215,30.76389
16,Chácara Santo Antônio,240,5,5,4,13000,3300,16300,67.916664
17,Perdizes,65,2,1,2,1700,800,2500,38.46154
18,Outro,76,2,2,1,2350,1050,3400,44.736843
19,Vila Clementino,34,1,1,1,1750,505,2255,66.32353
20,Pinheiros,240,4,5,3,12000,2995,14995,62.479168
21,Jardim Paulista,168,3,3,2,22000,2766,24766,147.41667
22,Indianópolis,36,1,1,0,3200,450,3650,101.388885
23,Vila Uberabinha,245,4,4,4,22000,3940,25940,105.87755
24,Indianópolis,70,2,2,1,2400,907,3307,47.24286
25,Jardim Paulista,57,1,1,1,3380,1600,4980,87.36842
26,Outro,75,3,2,1,2100,0,2100,28.0
27,Consolação,50,1,1,0,2000,600,2600,52.0
28,Vila Mariana,44,1,1,0,1800,410,2210,50.227272
29,Vila Mariana,54,2,1,1,2300,630,2930,54.25926
30,Outro,66,1,2,1,2780,750,3530,53.484848
31,Outro,60,2,1,1,2000,550,2550,42.5
32,Itaim Bibi,205,3,4,2,7900,2380,10280,50.146343
33,Indianópolis,31,1,1,1,1260,1700,2960,95.48387
34,Itaim Bibi,100,3,3,1,2700,1300,4000,40.0
35,Jardim Paulista,200,3,4,4,23000,4800,27800,139.0
36,Pinheiros,35,1,1,1,3800,548,4348,124.22857
37,Brás,36,1,1,1,1900,420,2320,64.44444
38,Brás,29,1,1,0,1200,380,1580,54.482758
39,Vila Leopoldina,68,3,2,1,2350,780,3130,46.02941
40,Itaim Bibi,75,1,1,1,5000,1800,6800,90.666664
41,Outro,60,2,2,1,2500,550,3050,50.833332
42,Outro,60,2,2,1,3500,800,4300,71.666664
43,Indianópolis,75,2,2,1,2400,1093,3493,46.573334
44,Brooklin,68,2,2,1,2665,1032,3697,54.367645
45,Paraíso,240,4,6,3,10500,3540,14040,58.5
46,Itaim Bibi,95,2,1,0,4199,925,5124,53.936844
47,Jardim Paulista,77,2,2,1,5900,900,6800,88.31169
48,Brooklin,50,1,2,1,2100,730,2830,56.6
49,Santa Cecília,105,3,2,1,3000,1250,4250,40.47619
50,Consolação,50,2,1,1,1700,650,2350,47.0
51,Moema,65,2,1,1,3800,410,4210,64.76923
52,Brás,56,2,2,1,3000,500,3500,62.5
53,Cerqueira César,69,2,2,2,2800,1100,3900,56.52174
54,Outro,100,4,2,1,3200,1100,4300,43.0
55,Barra Funda,65,2,2,1,2000,780,2780,42.76923
56,Jardim Paulista,45,1,1,1,3900,760,4660,103.55556
57,Barra Funda,60,2,2,1,2100,506,2606,43.433334
58,Moema,48,1,1,1,5000,780,5780,120.416664
59,Outro,65,2,1,1,1200,300,1500,23.076923
60,Outro,55,3,1,1,1650,547,2197,39.945454
61,Tatuapé,97,3,2,1,3000,0,3000,30.927835
62,República,380,4,6,1,10000,2800,12800,33.68421
63,Santana,45,1,1,0,1900,713,2613,58.066666
64,Água Branca,90,2,2,1,1700,800,2500,27.777779
65,Chácara Santo Antônio,30,1,1,0,1656,900,2556,85.2
66,Jardim Paulista,114,3,5,1,4990,1850,6840,60.0
67,Perdizes,115,2,2,1,2599,1157,3756,32.66087
68,Vila Olímpia,52,1,2,1,6900,1100,8000,153.84616
69,Cerqueira César,90,2,2,2,7300,1300,8600,95.55556
70,Centro,56,1,1,0,1600,0,1600,28.571428
71,Brooklin,47,1,1,1,2800,536,3336,70.97872
72,Outro,105,2,4,3,3800,1600,5400,51.42857
73,Vila Madalena,77,2,2,1,2400,795,3195,41.493507
74,Higienópolis,62,2,1,0,1811,689,2500,40.322582
75,Sumaré,74,2,3,2,5900,850,6750,91.21622
76,Consolação,50,1,1,0,2125,475,2600,52.0
77,Vila Nova Conceição,78,1,2,2,8800,2308,11108,142.41026
78,Jardim Paulista,75,2,2,1,3000,1200,4200,56.0
79,Perdizes,21,1,1,0,1100,250,1350,64.28571
80,Outro,50,2,1,1,2000,500,2500,50.0
81,Saúde,70,3,2,1,2100,901,3001,42.87143
82,Jardins,62,2,1,0,1900,640,2540,40.967743
83,Vila Mariana,48,1,1,0,1350,530,1880,39.166668
84,Vila Clementino,121,3,5,2,3900,1683,5583,46.140495
85,Higienópolis,127,3,2,1,3000,900,3900,30.708662
86,Vila Mariana,131,3,2,1,3300,1480,4780,36.48855
87,Tatuapé,20,1,1,0,1240,117,1357,67.85
88,Outro,47,2,1,1,1250,380,1630,34.68085
89,Centro,51,1,1,0,2050,350,2400,47.058823
90,Outro,118,3,4,2,5000,1642,6642,56.288136
91,Bela Vista,38,1,1,0,1508,439,1947,51.236843
92,Vila Leopoldina,56,2,2,1,3400,535,3935,70.26786
93,Barra Funda,38,1,1,1,1500,479,1979,52.07895
94,Liberdade,20,1,1,0,2450,0,2450,122.5
95,Vila Olímpia,64,2,2,1,4490,840,5330,83.28125
96,Paraíso,17,1,1,0,2150,360,2510,147.64706
97,Outro,79,2,2,2,2800,700,3500,44.3038
98,Mirandópolis,37,1,1,1,2700,450,3150,85.13513
99,Alto da Lapa,105,3,3,1,2900,867,3767,35.87619
100,Moema,75,2,3,2,6000,960,6960,92.8
101,Outro,141,3,4,2,3700,1700,5400,38.29787
102,Chácara Santo Antônio,40,1,1,1,3000,590,3590,89.75
103,Outro,54,1,1,1,2000,550,2550,47.22222
104,Vila Nova Conceição,48,1,1,1,5200,1462,6662,138.79167
105,Outro,67,2,2,1,2600,819,3419,51.02985
106,Pinheiros,30,1,1,1,2200,450,2650,88.333336
107,Pinheiros,90,3,3,2,6300,1100,7400,82.22222
108,Outro,75,2,2,1,1500,651,2151,28.68
109,Centro,50,1,1,0,1100,500,1600,32.0
110,Butantã,72,3,1,1,1500,618,2118,29.416666
111,Itaim Bibi,78,2,2,1,7300,1735,9035,115.833336
112,Vila Prudente,80,2,2,1,1800,798,2598,32.475
113,Cerqueira César,60,2,1,1,1800,977,2777,46.283333
114,Vila Mariana,110,3,3,1,5900,990,6890,62.636364
115,Brooklin,35,1,1,1,1570,530,2100,60.0
116,Indianópolis,92,3,3,1,3000,790,3790,41.195652
117,Outro,97,2,3,2,2350,1230,3580,36.907215
118,Outro,52,2,1,1,1000,424,1424,27.384615
119,Jardim Paulista,50,1,1,1,2500,603,3103,62.06
120,Campo Belo,47,1,1,1,3250,800,4050,86.17021
121,Moema,115,2,1,1,8500,1239,9739,84.68696
122,Santana,66,1,2,1,3400,780,4180,63.333332
123,Outro,101,3,4,2,3300,950,4250,42.07921
124,Outro,274,4,5,3,7500,3434,10934,39.90511
125,Higienópolis,35,1,1,1,1750,519,2269,64.828575
126,Morumbi,47,1,1,0,1199,420,1619,34.446808
127,Itaim Bibi,117,2,2,1,7750,1190,8940,76.410255
128,Outro,47,1,1,1,1000,0,1000,21.276596
129,Outro,76,3,2,1,1800,724,2524,33.210526
130,Outro,50,2,1,1,2000,480,2480,49.6
131,Santo Amaro,85,3,2,2,4200,0,4200,49.411766
132,Itaim Bibi,118,2,2,1,6000,1650,7650,64.830505
133,República,400,4,5,1,5000,3000,8000,20.0
134,Vila Buarque,40,1,1,1,2500,450,2950,73.75
135,Bela Vista,64,2,1,1,2000,615,2615,40.859375
136,Jardim Paulista,105,2,2,1,5000,1100,6100,58.095238
137,Vila Mariana,110,3,2,1,3200,1150,4350,39.545456
138,Pompeia,48,1,1,1,2300,650,2950,61.458332
139,Outro,65,3,1,1,1200,580,1780,27.384615
140,Outro,50,2,1,1,1950,330,2280,45.6
141,Consolação,35,1,1,1,3000,600,3600,102.85714
142,Vila Mariana,100,3,4,3,3100,1340,4440,44.4
143,Outro,65,2,2,1,2800,691,3491,53.70769
144,Vila Anastácio,62,2,3,1,3000,453,3453,55.69355
145,Pompeia,46,1,1,1,2300,586,2886,62.739132
146,Cidade Monções,44,1,2,1,2000,616,2616,59.454544
147,Móoca,62,2,2,1,2100,458,2558,41.258064
148,Aclimação,45,1,1,0,2400,0,2400,53.333332
149,Brooklin,96,2,3,2,8250,1420,9670,100.729164
150,Outro,73,3,2,2,2100,605,2705,37.054794
151,Perdizes,170,4,5,3,8800,2200,11000,64.70588
152,Bela Vista,48,1,1,0,2600,0,2600,54.166668
153,Jaguaré,70,3,2,2,2300,700,3000,42.857143
154,Santa Cecília,255,3,3,3,8000,4900,12900,50.588234
155,Vila Carrão,16,1,1,0,550,90,640,40.0
156,Vila Olímpia,70,1,1,1,5800,0,5800,82.85714
157,Cerqueira César,28,1,1,0,2700,1000,3700,132.14285
158,Barra Funda,65,2,2,1,2100,511,2611,40.16923
159,Cerqueira César,111,3,3,1,3300,1699,4999,45.036037
160,Bela Vista,40,1,1,0,1600,408,2008,50.2
161,Vila Olímpia,83,2,2,1,2500,1572,4072,49.06024
162,Lapa,67,2,2,2,3500,490,3990,59.55224
163,Pinheiros,157,3,5,3,10000,2110,12110,77.13376
164,Jardim Paulista,52,1,1,0,2700,350,3050,58.653847
165,Outro,21,1,1,1,990,300,1290,61.42857
166,Outro,52,2,2,1,1900,0,1900,36.53846
167,Barra Funda,38,1,1,0,1700,377,2077,54.657894
168,Outro,45,1,1,0,1300,250,1550,34.444443
169,Liberdade,46,1,1,0,1500,333,1833,39.847828
170,Perdizes,140,3,3,2,4500,0,4500,32.142857
171,Outro,50,1,1,0,1750,100,1850,37.0
172,Paraíso,110,2,2,1,1875,605,2480,22.545454
173,Vila Olímpia,45,1,1,1,4380,700,5080,112.888885
174,Cidade Monções,65,3,2,2,2750,950,3700,56.923077
175,Perdizes,100,3,3,2,3400,1235,4635,46.35
176,Vila Clementino,110,3,3,2,2400,825,3225,29.318182
177,Barra Funda,33,1,1,0,1700,301,2001,60.636364
178,Perdizes,240,4,5,3,11000,3000,14000,58.333332
179,Itaim Bibi,50,1,1,1,2700,755,3455,69.1
180,Vila Prudente,75,3,2,1,3070,500,3570,47.6
181,Jardins,30,1,1,0,1700,440,2140,71.333336
182,Pinheiros,120,3,2,1,2500,0,2500,20.833334
183,Indianópolis,158,3,3,3,11000,2700,13700,86.70886
184,Liberdade,60,2,1,0,1900,690,2590,43.166668
185,Vila Sônia,48,2,1,1,1300,340,1640,34.166668
186,Pompeia,53,2,1,1,1650,757,2407,45.415092
187,Jardim Paulista,78,2,2,1,3200,0,3200,41.025642
188,Higienópolis,90,3,1,0,3000,0,3000,33.333332
189,Vila Mariana,65,2,2,1,1900,490,2390,36.76923
190,Consolação,50,1,1,0,2000,600,2600,52.0
191,Jabaquara,37,2,1,0,1295,0,1295,35.0
192,Consolação,27,1,1,0,1100,361,1461,54.11111
193,Jabaquara,20,1,1,0,1135,185,1320,66.0
194,Outro,65,2,1,1,1195,586,1781,27.4
195,Bela Vista,25,1,1,1,1700,600,2300,92.0
196,Pinheiros,75,2,2,0,2400,550,2950,39.333332
197,Vila Mariana,18,1,1,0,1600,0,1600,88.888885
198,Santa Cecília,50,1,1,0,1500,800,2300,46.0
199,Consolação,25,1,1,0,1951,380,2331,93.24
200,Outro,288,4,6,4,6500,0,6500,22.569445
201,Alto de Pinheiros,90,3,2,1,2800,825,3625,40.27778
202,Centro,37,1,1,1,2200,380,2580,69.72973
203,Cambuci,25,1,1,0,950,0,950,38.0
204,Outro,207,5,6,3,9500,2100,11600,56.038647
205,Vila Anastácio,157,4,5,3,8500,1300,9800,62.420383
206,Outro,59,2,1,1,900,265,1165,19.745762
207,Ipiranga,25,1,1,0,800,100,900,36.0
208,Outro,45,2,1,1,900,0,900,20.0
209,Outro,20,1,1,0,890,0,890,44.5
210,Outro,65,2,1,1,1800,480,2280,35.076923
211,Vila Mariana,62,2,2,1,2250,700,2950,47.580647
212,Jardim Anália Franco,100,3,3,2,6390,1040,7430,74.3
213,Perdizes,110,3,3,1,3500,1700,5200,47.272728
214,Outro,56,2,2,1,2000,250,2250,40.17857
215,Sumaré,50,1,1,1,2000,780,2780,55.6
216,Santa Cecília,70,2,2,1,2700,667,3367,48.1
217,Brooklin,84,2,3,2,7900,1100,9000,107.14286
218,Brooklin,55,1,1,1,1600,812,2412,43.854546
219,Jaguaré,82,3,3,2,4200,650,4850,59.146343
220,Perdizes,126,3,3,0,3000,1300,4300,34.126984
221,Outro,42,1,2,1,1000,622,1622,38.61905
222,Liberdade,30,1,1,0,500,360,860,28.666666
223,Pinheiros,32,1,1,1,2500,800,3300,103.125
224,Perdizes,110,3,3,3,2900,2150,5050,45.909092
225,Tatuapé,80,2,1,0,1390,280,1670,20.875
226,Vila Mascote,120,2,4,3,3500,2200,5700,47.5
227,Morumbi,100,2,2,2,3000,1200,4200,42.0
228,Outro,45,2,1,1,700,0,700,15.555555
229,Tatuapé,20,1,1,0,950,0,950,47.5
230,Vila Mariana,104,3,2,1,2500,1200,3700,35.576923
231,Vila Mariana,15,1,1,0,1600,0,1600,106.666664
232,Santa Cecília,50,1,1,1,1340,1550,2890,57.8
233,Outro,60,3,1,1,1505,345,1850,30.833334
234,Jardim Prudência,64,2,2,1,2000,600,2600,40.625
235,Vila Gomes Cardim,137,3,4,3,3000,1393,4393,32.065693
236,Vila Andrade,58,2,1,1,1600,550,2150,37.068966
237,Cerqueira César,88,2,2,1,2500,0,2500,28.40909
238,Moema,630,5,7,6,110000,4706,114706,182.07301
239,Morumbi,50,1,1,1,2700,478,3178,63.56
240,Aclimação,115,3,2,1,2390,865,3255,28.304348
241,Alto da Lapa,66,2,2,2,2800,1000,3800,57.575756
242,Jardins,85,2,3,1,3950,1319,5269,61.988235
243,Santo Amaro,51,2,1,1,1370,430,1800,35.294117
244,Campo Belo,50,1,1,1,3500,420,3920,78.4
245,Vila Mariana,53,2,2,1,2899,950,3849,72.62264
246,Butantã,84,3,2,2,1900,1120,3020,35.95238
247,Brooklin,124,3,4,2,7000,1531,8531,68.798386
248,Outro,52,2,1,1,1700,483,2183,41.98077
249,Chácara Santo Antônio,70,2,2,1,2200,800,3000,42.857143
250,Pinheiros,84,2,2,2,3500,1050,4550,54.166668
251,Campo Belo,80,2,2,2,3000,729,3729,46.6125
252,Perdizes,70,2,1,1,2500,880,3380,48.285713
253,Bela Vista,42,1,1,1,1750,375,2125,50.595238
254,Bela Vista,42,1,1,0,2200,415,2615,62.261906
255,Vila Mascote,55,2,1,1,2000,615,2615,47.545456
256,Ipiranga,68,2,2,1,2300,708,3008,44.235294
257,Vila Andrade,163,3,5,3,6000,1880,7880,48.34356
258,Brooklin,60,2,2,1,2400,580,2980,49.666668
259,Pinheiros,32,1,1,1,2500,770,3270,102.1875
260,Vila Mariana,80,2,2,1,2300,796,3096,38.7
261,Pinheiros,35,1,1,1,3690,790,4480,128.0
262,Brooklin,94,2,3,2,5700,832,6532,69.489365
263,Perdizes,91,3,3,1,3250,950,4200,46.153847
264,Jardins,140,2,3,2,16300,2400,18700,133.57143
265,Brooklin,116,3,3,2,6000,1300,7300,62.931034
266,Tatuapé,40,1,1,1,1850,400,2250,56.25
267,Moema,62,2,2,1,3000,1150,4150,66.935486
268,Campo Belo,211,3,4,2,7000,2100,9100,43.12796
269,Brooklin,60,2,2,1,2700,830,3530,58.833332
270,Outro,57,2,1,0,1500,300,1800,31.578947
271,Outro,79,2,2,2,5500,656,6156,77.92405
272,Vila Mariana,40,1,1,1,2200,650,2850,71.25
273,Outro,36,2,2,0,1200,190,1390,38.61111
274,Consolação,33,1,1,1,2500,383,2883,87.36364
275,Moema,125,3,4,2,8000,1200,9200,73.6
276,Butantã,85,3,2,1,1500,620,2120,24.941177
277,Pompeia,63,2,2,1,3200,550,3750,59.52381
278,Outro,50,1,1,0,690,589,1279,25.58
279,Consolação,53,1,1,1,2000,1700,3700,69.81132
280,Brás,55,2,1,1,1450,405,1855,33.727272
281,Moema,74,2,3,1,4100,1250,5350,72.297295
282,Bela Vista,75,1,2,0,2100,511,2611,34.81333
283,Bom Retiro,100,3,2,0,1500,720,2220,22.2
284,Brooklin,67,2,1,1,3800,860,4660,69.55224
285,Outro,55,2,2,1,1500,388,1888,34.327274
286,Móoca,62,4,2,1,2500,400,2900,46.774193
287,Moema,157,3,4,2,6000,2287,8287,52.78344
288,Vila Olímpia,48,1,1,1,3300,900,4200,87.5
289,Tatuapé,29,1,1,0,1430,142,1572,54.206898
290,Perdizes,104,3,3,2,7300,989,8289,79.70192
291,Brooklin,30,1,1,1,2200,480,2680,89.333336
292,Itaim Bibi,110,2,3,2,6490,2105,8595,78.13636
293,Vila Buarque,31,1,1,1,1700,557,2257,72.80645
294,Vila Mariana,84,2,2,1,2100,302,2402,28.595238
295,Pinheiros,31,1,1,1,2300,965,3265,105.32258
296,Santana,40,2,1,1,2000,0,2000,50.0
297,Outro,47,2,1,0,1400,0,1400,29.787233
298,Jardim Paulista,45,2,1,1,2400,879,3279,72.86667
299,Vila Leopoldina,114,3,4,2,4990,1300,6290,55.175438
300,Outro,57,2,1,1,1200,509,1709,29.982456
301,Higienópolis,280,4,6,4,8000,3625,11625,41.517857
302,Higienópolis,93,3,2,1,3000,934,3934,42.301075
303,Itaim Bibi,105,2,2,1,4300,993,5293,50.409523
304,Consolação,68,2,1,1,2200,950,3150,46.32353
305,Itaim Bibi,37,1,1,1,2500,920,3420,92.432434
306,Brooklin,85,3,4,2,7300,901,8201,96.48235
307,Jardim Europa,250,4,3,3,12500,6100,18600,74.4
308,Outro,70,1,1,2,2400,599,2999,42.842857
309,Paraíso,70,2,1,0,2000,509,2509,35.842857
310,Outro,97,3,2,2,3500,0,3500,36.082474
311,Cerqueira César,58,2,2,1,2200,763,2963,51.08621
312,Centro,20,1,1,0,1300,354,1654,82.7
313,Outro,57,2,1,1,1700,640,2340,41.05263
314,Perdizes,80,3,3,1,2300,1330,3630,45.375
315,Pinheiros,60,2,2,2,2400,1300,3700,61.666668
316,Móoca,60,3,2,1,2000,550,2550,42.5
317,Santa Cecília,72,2,1,0,2000,600,2600,36.11111
318,Jabaquara,55,2,1,1,1000,1021,2021,36.745453
319,Pinheiros,34,1,1,1,3650,450,4100,120.588234
320,Campo Belo,85,2,2,2,3500,1400,4900,57.64706
321,Outro,85,1,2,1,4080,1200,5280,62.117645
322,Outro,18,1,1,0,1050,40,1090,60.555557
323,Brooklin,34,1,1,1,2800,350,3150,92.64706
324,Vila Prudente,55,2,2,1,1700,278,1978,35.963634
325,Pinheiros,45,2,1,1,2600,750,3350,74.44444
326,Chácara Santo Antônio,104,3,3,2,4500,865,5365,51.58654
327,Outro,753,5,7,7,75000,14,75014,99.620186
328,Vila Romana,60,2,1,0,1800,140,1940,32.333332
329,Outro,50,2,1,1,1850,540,2390,47.8
330,Brooklin,85,2,2,1,2800,700,3500,41.17647
331,Outro,95,2,1,0,2300,100,2400,25.263159
332,Bela Vista,30,1,1,1,1800,514,2314,77.13333
333,Vila Andrade,65,3,2,2,1900,960,2860,44.0
334,Outro,56,2,1,1,2000,550,2550,45.535713
335,Campo Belo,170,4,4,2,3900,1530,5430,31.941177
336,Vila Olímpia,50,1,1,1,2620,1095,3715,74.3
337,Ipiranga,35,1,1,1,2450,407,2857,81.62857
338,Vila Madalena,90,3,2,1,3100,527,3627,40.3
339,Pinheiros,108,3,2,1,2340,1138,3478,32.203705
340,Outro,74,2,2,2,3200,688,3888,52.54054
341,Santo Amaro,45,1,1,1,2000,528,2528,56.177776
342,Bela Vista,45,1,1,1,3000,544,3544,78.755554
343,Consolação,159,4,5,2,8500,1300,9800,61.63522
344,Alto da Lapa,93,3,2,2,4500,1065,5565,59.83871
345,Moema,70,2,2,1,3000,880,3880,55.42857
346,Butantã,55,2,1,1,1800,700,2500,45.454544
347,Campo Belo,73,2,2,1,2900,850,3750,51.36986
348,Higienópolis,33,1,1,1,1400,600,2000,60.60606
349,Vila Andrade,68,2,2,1,1850,528,2378,34.97059
350,Água Branca,65,2,2,1,2300,420,2720,41.846153
351,Vila Madalena,55,2,2,0,4800,700,5500,100.0
352,Pompeia,80,3,3,2,2800,750,3550,44.375
353,Campo Belo,161,3,5,3,8990,1716,10706,66.496895
354,Tatuapé,45,1,1,1,2100,500,2600,57.77778
355,Cerqueira César,40,1,1,1,1600,1300,2900,72.5
356,Jardim Marajoara,50,2,1,1,1500,500,2000,40.0
357,Perdizes,173,4,5,3,11500,2800,14300,82.65896
358,Pinheiros,45,1,1,1,2500,750,3250,72.22222
359,Aclimação,50,2,1,1,1550,550,2100,42.0
360,Chácara Klabin,40,1,1,1,3400,560,3960,99.0
361,Vila Mariana,90,2,2,2,4899,950,5849,64.98889
362,Jardins,41,1,1,1,2600,700,3300,80.48781
363,Jardim Paulista,57,1,2,1,2000,610,2610,45.789474
364,Perdizes,84,2,2,2,4000,850,4850,57.738094
365,Campo Belo,34,1,1,1,2000,500,2500,73.52941
366,Moema,48,1,1,1,2400,982,3382,70.458336
367,Mirandópolis,70,3,2,1,1900,807,2707,38.67143
368,Pinheiros,74,2,1,2,6219,1643,7862,106.24324
369,Cambuci,64,3,2,1,2100,490,2590,40.46875
370,Chácara Santo Antônio,90,2,3,2,6500,700,7200,80.0
371,Outro,78,2,2,1,5000,0,5000,64.10256
372,Vila Olímpia,78,2,3,1,2200,1190,3390,43.46154
373,Consolação,29,1,1,0,1300,443,1743,60.103447
374,Campo Belo,60,2,2,1,2999,918,3917,65.28333
375,Outro,90,2,2,1,2000,1051,3051,33.9
376,Móoca,90,3,2,2,2500,550,3050,33.88889
377,Pinheiros,60,1,2,0,2200,421,2621,43.683334
378,Vila Clementino,65,2,2,2,2500,1032,3532,54.338463
379,Perdizes,170,4,3,3,8490,2200,10690,62.882355
380,Vila Buarque,33,1,1,1,1200,737,1937,58.696968
381,Vila Andrade,58,2,1,2,1300,815,2115,36.46552
382,Campo Belo,96,3,2,1,3600,1080,4680,48.75
383,Brooklin,70,2,2,1,3000,790,3790,54.142857
384,Brooklin,70,2,2,1,4000,724,4724,67.48572
385,Chácara Santo Antônio,106,2,3,2,5500,1200,6700,63.207546
386,Barra Funda,65,1,2,1,2600,510,3110,47.846153
387,Consolação,35,1,1,1,1600,425,2025,57.857143
388,Bela Vista,23,1,1,0,1200,220,1420,61.739132
389,Ipiranga,60,2,2,1,2500,750,3250,54.166668
390,Outro,73,3,2,2,2950,700,3650,50.0
391,Pinheiros,73,2,3,2,3500,1200,4700,64.38356
392,Itaim Bibi,45,1,1,0,1900,625,2525,56.11111
393,Vila Leopoldina,35,1,1,0,1650,305,1955,55.857143
394,Outro,50,2,1,1,1400,500,1900,38.0
395,Outro,85,4,3,1,2100,900,3000,35.294117
396,Aclimação,170,3,1,2,5500,2288,7788,45.811764
397,Ipiranga,62,1,2,1,3600,560,4160,67.09677
398,Bela Vista,52,2,1,1,4500,475,4975,95.67308
399,Outro,40,1,1,0,950,0,950,23.75
400,Barra Funda,35,2,1,0,1820,290,2110,60.285713
401,Moema,60,2,2,1,2550,890,3440,57.333332
402,Perdizes,223,4,6,6,12000,3705,15705,70.42601
403,Vila Nova Conceição,332,4,5,4,38000,0,38000,114.45783
404,Móoca,44,1,1,0,1150,280,1430,32.5
405,Vila Andrade,106,3,3,2,6500,0,6500,61.320755
406,Campo Belo,268,2,4,4,20000,2730,22730,84.81343
407,Saúde,69,2,1,1,1600,447,2047,29.666666
408,Tatuapé,66,2,2,1,1800,600,2400,36.363636
409,Vila Mariana,77,3,1,2,3500,770,4270,55.454544
410,Saúde,56,2,2,1,2999,551,3550,63.392857
411,Moema,115,3,2,2,3300,2600,5900,51.304348
412,Moema,70,2,3,1,3800,832,4632,66.171425
413,Santa Cecília,38,1,1,1,2000,528,2528,66.52631
414,Vila Olímpia,273,4,6,5,34000,4776,38776,142.03664
415,Vila Leopoldina,172,3,5,3,6800,1700,8500,49.418606
416,Moema,75,2,2,1,2400,1027,3427,45.693333
417,Vila Nova Conceição,80,2,2,2,10000,1656,11656,145.7
418,Cerqueira César,107,3,3,1,4000,1382,5382,50.299065
419,Vila Olímpia,48,1,2,1,2500,605,3105,64.6875
420,Santana,42,2,1,1,2200,0,2200,52.38095
421,Outro,52,2,1,1,1150,370,1520,29.23077
422,Moema,27,1,1,0,2200,314,2514,93.111115
423,Outro,75,3,2,1,1400,750,2150,28.666666
424,Cerqueira César,88,4,2,0,2800,824,3624,41.18182
425,Barra Funda,68,2,2,1,2400,600,3000,44.117645
426,Mirandópolis,40,1,1,1,1500,645,2145,53.625
427,Morumbi,79,2,2,2,3200,769,3969,50.240505
428,Vila Mariana,81,2,2,2,3100,0,3100,38.271606
429,Jardim América,100,2,3,1,5000,1050,6050,60.5
430,Santa Cecília,43,1,1,1,2290,800,3090,71.860466
431,Freguesia do Ó,65,3,1,1,1500,545,2045,31.461538
432,República,28,1,1,0,1700,250,1950,69.64286
433,Outro,183,3,5,4,10200,1800,12000,65.57377
434,Barra Funda,62,2,1,1,2800,730,3530,56.935482
435,Brooklin,45,1,1,1,2500,750,3250,72.22222
436,Saúde,41,1,1,1,1800,723,2523,61.536587
437,Outro,120,2,2,2,11990,1400,13390,111.583336
438,Perdizes,43,1,1,0,1500,410,1910,44.418606
439,Jardim Marajoara,72,3,2,1,2200,660,2860,39.72222
440,Outro,64,2,2,1,2600,500,3100,48.4375
441,Jardim Marajoara,68,2,2,2,2000,700,2700,39.705883
442,Cidade Monções,38,1,1,1,2900,600,3500,92.10526
443,Pinheiros,332,4,5,4,30000,4150,34150,102.86144
444,Outro,74,3,1,1,2077,760,2837,38.337837
445,Brooklin,69,2,2,1,5300,520,5820,84.347824
446,Itaim Bibi,118,2,2,1,3500,1043,4543,38.5
447,Perdizes,90,2,1,0,2400,500,2900,32.22222
448,Moema,74,2,1,1,1800,620,2420,32.7027
449,Outro,60,2,1,1,1200,570,1770,29.5
450,Saúde,58,2,2,1,2000,763,2763,47.63793
451,Outro,40,1,1,0,1300,0,1300,32.5
452,Pinheiros,173,4,4,2,6000,2300,8300,47.97688
453,Pinheiros,37,1,1,1,2600,700,3300,89.189186
454,Jardim Paulista,80,2,2,0,2800,380,3180,39.75
455,Brooklin,130,3,4,2,5000,1480,6480,49.846153
456,Outro,50,1,1,0,690,589,1279,25.58
457,Itaim Bibi,46,1,2,1,2200,1000,3200,69.565216
458,Brooklin,111,3,3,2,6500,980,7480,67.38739
459,Paraíso,109,3,3,1,3100,1152,4252,39.009174
460,Santa Cecília,67,1,1,0,1200,620,1820,27.164179
461,Outro,73,3,2,1,2500,750,3250,44.52055
462,Moema,100,3,3,1,5500,950,6450,64.5
463,Vila Romana,121,3,5,2,6500,1100,7600,62.809917
464,Pinheiros,60,2,1,0,1950,430,2380,39.666668
465,Vila Mascote,87,3,3,2,2500,1100,3600,41.37931
466,Cidade Monções,125,3,3,2,4750,1300,6050,48.4
467,Pinheiros,87,2,3,1,3500,1080,4580,52.643677
468,Outro,63,3,2,1,2000,676,2676,42.47619
469,Outro,90,2,2,1,1200,380,1580,17.555555
470,Consolação,51,2,1,1,3100,870,3970,77.84314
471,Vila Mariana,59,2,2,2,2700,1349,4049,68.62712
472,Pompeia,41,1,1,1,2300,593,2893,70.560974
473,Brooklin,37,1,1,1,3300,400,3700,100.0
474,Pinheiros,66,1,1,1,2500,785,3285,49.772728
475,Campo Belo,70,2,3,1,2550,950,3500,50.0
476,Vila Mariana,65,2,2,1,4499,550,5049,77.676926
477,Aclimação,68,2,2,2,5000,750,5750,84.55882
478,Pinheiros,75,2,2,2,3300,890,4190,55.866665
479,Vila Sônia,64,2,2,1,3300,0,3300,51.5625
480,Santo Amaro,75,3,2,1,1950,580,2530,33.733334
481,Brooklin,75,2,3,2,3300,910,4210,56.133335
482,Outro,82,3,2,2,2400,800,3200,39.02439
483,Moema,80,2,2,1,2500,978,3478,43.475
484,Brooklin,163,3,4,3,14000,1500,15500,95.092026
485,Jardim Paulista,120,3,3,1,4000,893,4893,40.775
486,Moema,102,3,3,2,6900,1050,7950,77.94118
487,Outro,48,1,1,1,800,480,1280,26.666666
488,Ipiranga,45,1,1,1,1800,556,2356,52.355556
489,Outro,148,2,2,2,7900,1269,9169,61.9527
490,Brooklin,90,3,2,2,3500,1103,4603,51.144444
491,Campo Belo,80,2,2,3,5200,900,6100,76.25
492,Campo Belo,60,1,2,0,3100,700,3800,63.333332
493,Moema,125,3,5,2,8499,1250,9749,77.992
494,Brooklin,41,1,1,1,3450,650,4100,100.0
495,Outro,56,2,1,1,1400,574,1974,35.25
496,Chácara Santo Antônio,106,3,4,2,5500,1100,6600,62.264153
497,Barra Funda,67,1,2,2,3100,450,3550,52.985073
498,Moema,68,2,2,2,4000,1222,5222,76.79412
499,Outro,67,3,2,2,1500,456,1956,29.19403
500,Campo Belo,43,1,2,1,2800,580,3380,78.60465
501,Vila Madalena,42,1,1,1,2200,830,3030,72.14286
502,Brooklin,105,2,3,2,9197,980,10177,96.92381
503,Liberdade,65,2,2,1,3400,550,3950,60.76923
504,Vila Madalena,57,1,2,1,3400,1320,4720,82.807014
505,Moema,205,4,6,3,16000,3130,19130,93.31707
506,Moema,73,2,3,2,3900,1400,5300,72.60274
507,Barra Funda,65,2,2,1,3000,510,3510,54.0
508,Tatuapé,212,2,4,3,6500,0,6500,30.660378
509,Aclimação,120,3,4,3,4500,1800,6300,52.5
510,Liberdade,50,1,1,0,1200,497,1697,33.94
511,Itaim Bibi,80,2,2,1,6200,1220,7420,92.75
512,Vila Mariana,37,1,1,1,1700,576,2276,61.51351
513,Campo Belo,194,4,4,4,13500,1900,15400,79.38145
514,Vila Nova Conceição,40,1,1,1,2100,955,3055,76.375
515,Pinheiros,72,2,2,1,6500,633,7133,99.06944
516,Brooklin,98,2,3,2,8000,1600,9600,97.95918
517,Pinheiros,40,1,1,2,3900,910,4810,120.25
518,Cambuci,64,2,2,1,1900,570,2470,38.59375
519,Outro,44,2,1,1,1100,320,1420,32.272728
520,Pinheiros,100,3,2,1,2800,1159,3959,39.59
521,Vila Madalena,90,2,4,1,2700,1100,3800,42.22222
522,Outro,72,2,2,2,2700,900,3600,50.0
523,Moema,52,1,1,1,3800,1350,5150,99.03846
524,Vila Olímpia,72,2,1,1,3940,860,4800,66.666664
525,Butantã,17,1,1,0,1350,0,1350,79.411766
526,Butantã,50,2,1,1,2200,320,2520,50.4
527,Vila Mariana,83,2,2,0,2500,230,2730,32.891567
528,Pinheiros,57,1,1,1,4200,750,4950,86.8421
529,Santo Amaro,160,4,5,2,6890,1300,8190,51.1875
530,Vila Prudente,44,1,1,1,1000,300,1300,29.545454
531,Outro,640,4,5,4,9000,6990,15990,24.984375
532,Vila Clementino,60,2,1,0,2000,550,2550,42.5
533,Móoca,100,3,3,2,4500,510,5010,50.1
534,Vila Nova Conceição,136,3,3,2,11000,1934,12934,95.10294
535,Itaim Bibi,48,1,1,2,5000,1800,6800,141.66667
536,Paraíso,98,2,2,0,2500,1105,3605,36.785713
537,Itaim Bibi,40,1,1,1,1578,1009,2587,64.675
538,Moema,40,1,1,1,1790,787,2577,64.425
539,Paraíso,80,2,2,2,6100,2931,9031,112.8875
540,Chácara Santo Antônio,106,3,2,2,5485,1100,6585,62.122643
541,Outro,51,1,1,1,3300,545,3845,75.39216
542,Itaim Bibi,75,2,1,0,1800,776,2576,34.34667
543,Vila Guarani,53,2,1,1,1700,600,2300,43.396225
544,Higienópolis,68,2,1,0,2300,1150,3450,50.735294
545,Butantã,38,1,1,0,1900,219,2119,55.763157
546,Morumbi,160,3,2,4,6500,1873,8373,52.33125
547,Moema,117,4,4,2,5000,1400,6400,54.700855
548,Campos Eliseos,24,1,1,0,1100,220,1320,55.0
549,Vila Olímpia,56,2,1,1,6500,541,7041,125.73214
550,Brooklin,52,2,1,1,3500,948,4448,85.53846
551,Paraíso,72,2,2,1,1900,779,2679,37.208332
552,Brooklin,94,3,2,2,3600,1000,4600,48.93617
553,Campo Belo,50,1,1,1,2950,700,3650,73.0
554,Brooklin,178,3,5,3,12500,1500,14000,78.65169
555,Pinheiros,110,3,2,0,4500,120,4620,42.0
556,Perdizes,62,3,2,1,2600,810,3410,55.0
557,Moema,72,2,2,2,4150,950,5100,70.833336
558,Bela Vista,52,2,1,1,4500,476,4976,95.69231
559,Perdizes,67,2,2,1,5000,649,5649,84.31343
560,Outro,20,1,1,0,1180,40,1220,61.0
561,Pinheiros,90,3,3,2,5200,1298,6498,72.2
562,Santa Cecília,81,2,2,0,2600,400,3000,37.037037
563,Alto de Pinheiros,317,4,5,4,18000,4969,22969,72.45741
564,Jaguaré,67,2,2,1,1200,592,1792,26.74627
565,Alto da Lapa,235,3,6,4,22000,2980,24980,106.297874
566,República,39,1,1,1,1500,850,2350,60.25641
567,Vila Andrade,70,3,2,2,2000,650,2650,37.857143
568,Vila Mariana,55,2,1,1,1500,770,2270,41.272728
569,Água Branca,178,4,5,4,8500,2150,10650,59.83146
570,Moema,45,1,2,1,2200,500,2700,60.0
571,Vila Madalena,50,1,1,1,6000,750,6750,135.0
572,Cerqueira César,54,2,1,1,3950,540,4490,83.14815
573,Brooklin,176,4,5,2,4200,2400,6600,37.5
574,Vila Madalena,35,1,1,1,2900,450,3350,95.71429
575,Alto Da Boa Vista,152,3,3,3,10500,1350,11850,77.960526
576,Móoca,52,2,1,1,1950,450,2400,46.153847
577,Outro,95,3,2,2,3800,851,4651,48.957893
578,Vila Guarani,52,1,1,0,1000,0,1000,19.23077
579,Vila Cruzeiro,66,1,1,1,3800,600,4400,66.666664
580,Itaim Bibi,50,1,1,1,2500,771,3271,65.42
581,Moema,44,1,2,1,3100,600,3700,84.09091
582,Brooklin,41,1,1,1,3500,620,4120,100.48781
583,Santana,90,2,2,1,1700,250,1950,21.666666
584,Vila Anastácio,79,2,3,2,4300,660,4960,62.78481
585,Vila Gomes Cardim,45,1,1,1,1600,495,2095,46.555557
586,Butantã,29,1,1,0,1350,170,1520,52.41379
587,Paraíso,120,2,2,0,2500,850,3350,27.916666
588,Pinheiros,64,2,1,1,2500,710,3210,50.15625
589,Butantã,17,1,1,0,1350,0,1350,79.411766
590,Outro,62,3,1,1,1800,630,2430,39.19355
591,Ipiranga,45,1,1,1,2100,431,2531,56.244446
592,Jardim Prudência,72,2,2,1,3100,700,3800,52.77778
593,Bela Vista,29,1,1,1,1300,440,1740,60.0
594,Brooklin,44,1,1,1,2600,655,3255,73.97727
595,Aclimação,40,1,1,1,2100,558,2658,66.45
596,Morumbi,131,4,4,3,1598,1527,3125,23.854961
597,Brooklin,70,2,1,1,2000,950,2950,42.142857
598,Bom Retiro,85,2,1,1,1700,750,2450,28.82353
599,Vila Mariana,80,2,2,1,2500,550,3050,38.125
600,Perdizes,117,3,4,1,6500,1570,8070,68.97436
601,Bela Vista,34,1,1,0,2500,403,2903,85.382355
602,Outro,68,3,2,1,2250,525,2775,40.808823
603,Santana,109,3,3,2,2500,1292,3792,34.78899
604,Campos Eliseos,85,2,2,1,1700,680,2380,28.0
605,Vila Mariana,82,3,2,2,3500,1200,4700,57.317074
606,Jabaquara,55,2,1,1,1600,450,2050,37.272728
607,Paraíso,33,1,1,0,2000,380,2380,72.121216
608,Chácara Santo Antônio,130,3,4,2,6700,900,7600,58.46154
609,Vila Leopoldina,48,2,1,2,2300,495,2795,58.229168
610,Perdizes,40,1,1,1,1850,890,2740,68.5
611,Perdizes,92,3,2,2,3300,1205,4505,48.967392
612,Pinheiros,65,2,1,2,5432,1458,6890,106.0
613,Vila Leopoldina,83,3,3,2,3300,950,4250,51.20482
614,Paraíso,160,3,2,1,4900,980,5880,36.75
615,Vila Andrade,60,2,1,1,1800,300,2100,35.0
616,Vila Clementino,55,2,1,1,2200,710,2910,52.909092
617,Paraíso,85,2,1,1,3000,939,3939,46.341175
618,Higienópolis,150,3,2,2,6500,1380,7880,52.533333
619,Vila Olímpia,52,1,1,1,7250,900,8150,156.73077
620,Itaim Bibi,93,2,2,2,9700,2156,11856,127.48387
621,Pinheiros,87,2,2,1,3500,1028,4528,52.04598
622,Outro,80,3,2,2,2350,925,3275,40.9375
623,Pinheiros,160,3,3,2,5000,1705,6705,41.90625
624,Brooklin,66,2,2,1,4999,900,5899,89.378784
625,Bom Retiro,135,3,2,0,2500,1250,3750,27.777779
626,Centro,63,2,2,1,1900,350,2250,35.714287
627,Vila Madalena,70,2,2,1,3050,797,3847,54.95714
628,Itaim Bibi,80,2,2,1,3000,939,3939,49.2375
629,Higienópolis,26,1,1,0,1550,201,1751,67.34615
630,Vila Romana,60,2,2,1,3200,584,3784,63.066666
631,Outro,76,2,2,1,2700,679,3379,44.460526
632,Outro,59,2,1,1,1257,0,1257,21.305084
633,Brooklin,42,1,1,1,1700,675,2375,56.54762
634,Vila Mariana,75,3,3,2,3200,1021,4221,56.28
635,Outro,45,1,1,0,1050,0,1050,23.333334
636,Outro,86,3,3,2,3000,1083,4083,47.476746
637,Pinheiros,60,2,1,0,2000,485,2485,41.416668
638,Consolação,30,1,1,1,1900,649,2549,84.96667
639,Sumaré,100,3,2,1,3500,1000,4500,45.0
640,Ipiranga,72,2,1,0,1700,163,1863,25.875
641,Bela Vista,130,3,2,1,4000,1090,5090,39.153847
642,Moema,98,3,5,2,4500,1200,5700,58.163265
643,Outro,83,2,2,1,2600,516,3116,37.542168
644,Jardim Paulista,90,2,3,1,3500,1346,4846,53.844444
645,Bela Vista,52,2,1,1,2700,398,3098,59.576923
646,Outro,78,3,1,1,3000,1125,4125,52.884617
647,Brooklin,60,2,2,1,3985,900,4885,81.416664
648,Higienópolis,330,4,4,2,8000,5000,13000,39.39394
649,Chácara Santo Antônio,70,2,2,2,3800,887,4687,66.957146
650,Outro,40,2,1,0,1500,106,1606,40.15
651,Aclimação,115,3,2,1,2390,865,3255,28.304348
652,Vila Nova Conceição,100,3,2,1,1950,749,2699,26.99
653,Pinheiros,60,2,1,1,2300,1200,3500,58.333332
654,Itaim Bibi,48,1,1,1,2300,696,2996,62.416668
655,Outro,193,3,6,4,8300,3300,11600,60.103626
656,Perdizes,41,1,1,1,1700,773,2473,60.317074
657,Itaim Bibi,49,1,1,1,2500,901,3401,69.408165
658,Vila Nova Conceição,69,1,2,1,5600,1100,6700,97.10145
659,Jardim Paulista,225,3,3,3,8900,1850,10750,47.77778
660,Vila Olímpia,73,2,2,1,11000,840,11840,162.19179
661,Vila Mariana,67,2,2,1,2200,1050,3250,48.50746
662,Ipiranga,142,3,5,2,5600,1200,6800,47.887325
663,Vila Nova Conceição,136,3,3,2,11000,1934,12934,95.10294
664,Cerqueira César,40,1,1,1,1850,487,2337,58.425
665,Jardim Paulista,79,2,4,2,8000,1100,9100,115.18987
666,Pinheiros,53,2,1,1,3300,643,3943,74.396225
667,Vila Nova Conceição,85,2,2,1,4000,834,4834,56.870586
668,Outro,49,2,1,1,700,280,980,20.0
669,Outro,89,3,2,1,1900,760,2660,29.88764
670,Liberdade,60,2,2,1,1200,700,1900,31.666666
671,Outro,45,2,1,1,1100,330,1430,31.777779
672,Tatuapé,106,3,4,2,4500,747,5247,49.5
673,Jabaquara,40,1,1,1,1300,0,1300,32.5
674,Vila Mascote,87,2,3,2,3000,750,3750,43.103447
675,Pinheiros,46,1,1,1,3500,794,4294,93.347824
676,Vila Leopoldina,142,4,5,2,6500,1089,7589,53.44366
677,Outro,73,2,1,1,1500,880,2380,32.60274
678,Morumbi,84,3,2,1,3500,730,4230,50.357143
679,Vila Mariana,60,2,2,1,3500,931,4431,73.85
680,Morumbi,59,1,2,1,2900,937,3837,65.0339
681,Moema,143,2,4,3,9000,2992,11992,83.86014
682,Vila Leopoldina,141,3,5,2,5300,1100,6400,45.39007
683,Campo Belo,60,2,3,1,2300,963,3263,54.383335
684,Vila Olímpia,72,2,2,1,4500,986,5486,76.19444
685,Ipiranga,111,3,4,2,5500,1000,6500,58.55856
686,Pinheiros,51,2,1,1,2970,800,3770,73.92157
687,Vila Sônia,40,2,1,0,1450,80,1530,38.25
688,Vila Formosa,65,3,2,1,1515,927,2442,37.56923
689,Brooklin,229,4,6,4,21500,2300,23800,103.93013
690,Bela Vista,46,1,1,1,2700,316,3016,65.565216
691,Moema,57,2,1,1,2300,960,3260,57.19298
692,Pompeia,78,3,1,2,2500,1111,3611,46.294872
693,Jardins,51,1,1,1,2800,2300,5100,100.0
694,Aclimação,39,1,1,1,2260,530,2790,71.53846
695,Jardim Prudência,65,2,2,1,2800,386,3186,49.015385
696,Vila Gomes Cardim,87,3,3,1,1600,900,2500,28.735632
697,Vila Nova Conceição,49,1,1,1,890,2110,3000,61.22449
698,Vila Andrade,51,2,1,1,2750,350,3100,60.784313
699,Moema,45,1,1,1,1766,684,2450,54.444443
700,Pinheiros,74,2,1,2,5100,1643,6743,91.12162
701,Outro,45,2,1,0,950,150,1100,24.444445
702,Pinheiros,39,1,1,1,5000,607,5607,143.76923
703,Chácara Santo Antônio,57,2,1,1,4200,550,4750,83.333336
704,Vila Mariana,50,1,2,1,3499,448,3947,78.94
705,Vila Leopoldina,53,2,1,1,2500,700,3200,60.377357
706,Cambuci,50,2,1,1,1450,520,1970,39.4
707,Jardim Paulista,115,4,4,2,6200,981,7181,62.443478
708,Saúde,35,1,1,1,2000,450,2450,70.0
709,Bela Vista,40,1,1,1,2400,508,2908,72.7
710,Perdizes,62,2,2,1,3000,798,3798,61.258064
711,Bom Retiro,200,3,2,1,2200,2000,4200,21.0
712,Vila Guarani,106,3,3,2,4300,955,5255,49.57547
713,Outro,270,3,3,3,16000,3100,19100,70.74074
714,Indianópolis,200,3,3,3,7500,3100,10600,53.0
715,Vila Leopoldina,68,2,1,1,2200,648,2848,41.882355
716,Butantã,67,3,2,1,2900,450,3350,50.0
717,Barra Funda,65,2,2,0,2100,680,2780,42.76923
718,Outro,69,3,2,2,2250,747,2997,43.434784
719,Itaim Bibi,85,3,2,1,4000,834,4834,56.870586
720,Outro,57,2,1,1,1000,0,1000,17.54386
721,Campos Eliseos,50,1,1,0,1300,350,1650,33.0
722,Perdizes,63,2,2,1,4500,850,5350,84.92063
723,Brás,32,1,1,0,1350,300,1650,51.5625
724,Vila Mariana,48,1,1,0,1350,530,1880,39.166668
725,Outro,58,2,2,1,2300,507,2807,48.396553
726,Pirituba,70,2,2,1,1300,600,1900,27.142857
727,Jardim Paulista,536,3,4,5,30000,8200,38200,71.268654
728,Itaim Bibi,60,1,2,1,3500,1750,5250,87.5
729,Campo Belo,74,2,2,2,4500,960,5460,73.78378
730,Brooklin,87,2,2,1,3000,611,3611,41.50575
731,Vila Mascote,85,3,4,2,2400,1090,3490,41.058823
732,Outro,45,2,1,1,1450,267,1717,38.155556
733,Campo Belo,45,1,2,1,3000,352,3352,74.48889
734,Outro,60,1,1,0,1200,0,1200,20.0
735,Vila Mariana,80,3,1,3,3500,1205,4705,58.8125
736,Morumbi,69,2,3,1,1900,1003,2903,42.072464
737,Brooklin,132,3,4,3,11000,1000,12000,90.90909
738,Pinheiros,86,2,2,1,3100,1264,4364,50.744186
739,Chácara Santo Antônio,74,2,3,2,3300,1080,4380,59.18919
740,Pinheiros,84,2,2,2,7000,1400,8400,100.0
741,Moema,110,3,5,1,5000,1470,6470,58.81818
742,Jardins,130,3,2,1,5200,1200,6400,49.23077
743,Móoca,56,2,1,1,1690,495,2185,39.017857
744,Outro,50,2,1,1,1400,290,1690,33.8
745,Santo Amaro,112,3,3,2,3800,1250,5050,45.089287
746,Vila Sônia,50,2,1,1,1400,465,1865,37.3
747,República,32,1,1,0,1699,435,2134,66.6875
748,Aclimação,86,3,3,2,3500,882,4382,50.953487
749,Itaim Bibi,130,3,3,2,6500,2250,8750,67.30769
750,Perdizes,34,1,2,1,1700,797,2497,73.44118
751,Chácara Santo Antônio,60,2,2,1,2950,630,3580,59.666668
752,Jardim Paulista,110,3,3,1,4000,1263,5263,47.845455
753,Vila Clementino,38,1,1,1,1750,550,2300,60.526318
754,Itaim Bibi,134,2,3,2,17000,1300,18300,136.56717
755,Consolação,83,2,2,1,2100,1073,3173,38.228916
756,Jardim Prudência,65,2,2,1,2100,700,2800,43.076923
757,Pinheiros,50,2,1,0,2600,0,2600,52.0
758,Vila Mariana,77,3,1,2,3100,750,3850,50.0
759,Vila Formosa,66,2,2,1,2257,650,2907,44.045456
760,Móoca,62,3,2,1,2200,400,2600,41.935482
761,Vila Olímpia,150,3,3,2,7900,2213,10113,67.42
762,Outro,69,2,2,1,4000,0,4000,57.971016
763,Outro,83,2,2,2,4200,847,5047,60.807228
764,Vila Andrade,140,3,4,3,4000,1700,5700,40.714287
765,Vila Mariana,31,1,1,1,2420,528,2948,95.09677
766,Outro,69,2,2,1,2424,526,2950,42.753624
767,Outro,80,2,2,1,2200,651,2851,35.6375
768,Outro,90,3,3,1,1950,1098,3048,33.866665
769,Consolação,30,1,1,0,1841,334,2175,72.5
770,Consolação,69,2,2,1,3500,890,4390,63.623188
771,Vila Mariana,18,1,1,0,1375,403,1778,98.77778
772,Vila Mariana,65,2,1,0,2000,401,2401,36.93846
773,Vila Leopoldina,36,1,1,1,1900,758,2658,73.833336
774,Consolação,41,1,1,1,2350,600,2950,71.95122
775,Outro,42,2,1,0,1220,280,1500,35.714287
776,Pinheiros,72,2,2,1,5000,900,5900,81.94444
777,Perdizes,170,3,3,2,2800,3000,5800,34.117645
778,Higienópolis,15,1,1,0,1300,450,1750,116.666664
779,Vila Mascote,63,3,1,1,2050,735,2785,44.20635
780,Vila Nova Conceição,262,4,4,3,18000,3315,21315,81.354965
781,Brooklin,116,3,2,2,6000,1300,7300,62.931034
782,Vila Mariana,60,2,2,1,2000,978,2978,49.633335
783,Campo Belo,43,1,2,1,2700,580,3280,76.27907
784,Vila Buarque,57,1,1,0,1450,0,1450,25.438597
785,Bela Vista,60,2,2,2,2500,700,3200,53.333332
786,Outro,52,2,1,1,1400,460,1860,35.76923
787,Água Branca,60,1,2,1,2000,430,2430,40.5
788,Itaim Bibi,45,1,2,1,2550,983,3533,78.51111
789,Bela Vista,37,1,1,1,2000,450,2450,66.21622
790,Pinheiros,70,2,3,2,9500,972,10472,149.6
791,Outro,76,3,1,2,2800,684,3484,45.842106
792,Outro,52,2,1,1,1600,270,1870,35.96154
793,Saúde,90,3,2,2,2900,968,3868,42.97778
794,Vila Mariana,86,2,2,1,2600,944,3544,41.2093
795,Outro,44,1,2,2,1800,510,2310,52.5
796,Chácara Klabin,118,3,4,2,4700,1455,6155,52.16102
797,Alto de Pinheiros,364,3,5,5,28000,5200,33200,91.20879
798,Lapa,138,3,5,3,6500,812,7312,52.985508
799,Cidade Monções,31,1,1,1,2200,525,2725,87.90323
800,Higienópolis,42,1,1,1,2990,700,3690,87.85714
801,Cerqueira César,69,2,1,0,2900,565,3465,50.217392
802,Santana,158,3,3,3,3500,1400,4900,31.01266
803,Itaim Bibi,65,2,2,1,2600,867,3467,53.338463
804,Moema,144,4,4,2,5700,1640,7340,50.97222
805,Pinheiros,90,3,3,1,2800,1200,4000,44.444443
806,Vila Madalena,280,2,3,3,12500,2362,14862,53.07857
807,Jardim Anália Franco,55,1,1,2,3990,770,4760,86.545456
808,Pinheiros,35,1,1,1,3500,900,4400,125.71429
809,Cerqueira César,29,1,1,1,2800,337,3137,108.17242
810,Moema,140,4,3,2,7000,1764,8764,62.6
811,Cambuci,39,1,1,1,2260,530,2790,71.53846
812,Jardim Prudência,69,3,1,1,1800,688,2488,36.057972
813,Jardim Paulista,33,1,1,1,800,2110,2910,88.181816
814,Vila Mariana,86,3,3,2,3200,750,3950,45.930233
815,Vila Gomes Cardim,93,3,4,2,2500,992,3492,37.548386
816,Cerqueira César,76,2,2,2,4500,550,5050,66.447365
817,Panamby,607,5,8,6,50000,7926,57926,95.429985
818,Saúde,37,1,1,1,2500,506,3006,81.24324
819,Perdizes,76,3,3,2,2650,1000,3650,48.026318
820,Outro,77,3,2,2,3000,703,3703,48.090908
821,Outro,135,3,3,2,3500,2150,5650,41.851852
822,Perdizes,45,1,1,1,1900,564,2464,54.755554
823,Vila Olímpia,55,2,1,1,3000,733,3733,67.87273
824,Paraíso,100,3,1,0,2800,675,3475,34.75
825,Perdizes,82,3,3,2,2400,1290,3690,45.0
826,Brooklin,67,2,1,1,5000,925,5925,88.43284
827,Vila Andrade,47,1,1,1,3500,0,3500,74.46809
828,Jabaquara,49,2,1,1,1500,500,2000,40.816326
829,Vila Nova Conceição,262,4,4,2,12000,3200,15200,58.015266
830,Chácara Klabin,250,4,5,4,15000,1761,16761,67.044
831,Tatuapé,142,3,5,3,3000,1770,4770,33.59155
832,Outro,75,2,2,2,2050,750,2800,37.333332
833,Itaim Bibi,97,2,3,1,3600,1240,4840,49.896908
834,Outro,62,2,2,1,2600,720,3320,53.548386
835,Pinheiros,64,2,2,2,2500,1290,3790,59.21875
836,Vila Madalena,36,1,1,1,3200,561,3761,104.47222
837,Vila Olímpia,65,2,2,1,2700,938,3638,55.96923
838,Moema,27,1,1,0,3500,0,3500,129.62962
839,Saúde,35,1,1,1,1700,700,2400,68.57143
840,Jardim Paulista,53,2,2,1,3450,846,4296,81.0566
841,Santa Cecília,30,1,1,1,1500,424,1924,64.13333
842,Itaim Bibi,170,3,4,3,20000,1865,21865,128.61765
843,Chácara Inglesa,57,2,2,1,2000,683,2683,47.070175
844,Pinheiros,65,2,1,1,2250,760,3010,46.307693
845,Vila Mascote,91,3,3,2,4900,1020,5920,65.05495
846,Santo Amaro,54,1,2,1,2300,630,2930,54.25926
847,Vila Mariana,95,3,2,2,3880,747,4627,48.705265
848,Perdizes,130,4,6,3,5500,1700,7200,55.384617
849,Vila Gomes Cardim,72,1,2,2,2700,700,3400,47.22222
850,Outro,70,3,1,1,1800,312,2112,30.171429
851,Vila Leopoldina,230,4,6,3,12000,1700,13700,59.565216
852,Aclimação,170,3,5,3,9000,1300,10300,60.588234
853,Jardim Paulista,120,3,3,2,4300,1250,5550,46.25
854,Pinheiros,48,1,1,1,3500,680,4180,87.083336
855,Santana,120,3,2,2,2850,911,3761,31.341667
856,Barra Funda,43,2,1,0,1500,320,1820,42.32558
857,Pinheiros,53,1,2,1,2900,920,3820,72.07547
858,Ipiranga,135,4,5,2,4200,1450,5650,41.851852
859,Móoca,142,3,3,2,5800,921,6721,47.330986
860,Liberdade,54,2,1,1,1600,671,2271,42.055557
861,Móoca,86,3,2,1,3000,932,3932,45.720932
862,Vila Cruzeiro,82,3,3,2,3500,1003,4503,54.914635
863,Bela Vista,113,2,2,1,2100,690,2790,24.690266
864,Consolação,30,1,1,1,1800,550,2350,78.333336
865,Butantã,55,2,2,1,1700,705,2405,43.727272
866,Bela Vista,46,1,1,1,3100,381,3481,75.67391
867,Brooklin,36,1,1,1,2150,470,2620,72.77778
868,Bela Vista,75,2,2,1,3700,865,4565,60.866665
869,Brooklin,111,2,4,2,6800,1000,7800,70.27027
870,Santana,66,3,2,2,1950,700,2650,40.151516
871,Outro,58,3,1,1,1000,500,1500,25.862068
872,Brooklin,68,2,2,2,8000,900,8900,130.88235
873,Lapa,93,3,2,2,3250,1100,4350,46.774193
874,Moema,74,2,3,2,7000,832,7832,105.83784
875,Ipiranga,68,2,2,1,2300,700,3000,44.117645
876,Santo Amaro,96,3,3,2,3500,920,4420,46.041668
877,Vila Mariana,170,3,5,2,6000,2000,8000,47.058823
878,Água Branca,53,1,1,1,1520,400,1920,36.226414
879,Vila Anastácio,70,2,2,2,3100,600,3700,52.857143
880,Jardim Paulista,100,2,3,2,8500,1270,9770,97.7
881,Pinheiros,65,2,2,1,4000,975,4975,76.53846
882,Paraíso,110,2,1,1,2950,1200,4150,37.727272
883,Paraíso,124,3,3,2,6000,1100,7100,57.258064
884,Bela Vista,30,1,1,1,1300,514,1814,60.466667
885,Bela Vista,44,1,1,0,2899,475,3374,76.681816
886,Chácara Klabin,60,2,1,2,2500,1090,3590,59.833332
887,Aclimação,40,1,1,1,1900,558,2458,61.45
888,Tatuapé,27,1,1,0,1500,220,1720,63.703705
889,Outro,65,3,1,1,1750,380,2130,32.76923
890,Outro,53,2,1,1,1310,390,1700,32.07547
891,Outro,110,3,3,2,2800,1128,3928,35.70909
892,Pinheiros,105,3,2,2,10000,1400,11400,108.57143
893,Perdizes,118,3,3,2,3500,1265,4765,40.381355
894,Campo Belo,155,3,5,3,10500,1760,12260,79.09677
895,Pinheiros,120,3,4,2,5600,1980,7580,63.166668
896,Jaguaré,62,2,2,1,2300,555,2855,46.048386
897,Moema,67,2,3,2,4000,1300,5300,79.10448
898,Vila Olímpia,32,1,1,1,2340,1010,3350,104.6875
899,Paraíso,130,3,4,3,10500,1860,12360,95.07692
900,Jardim Paulista,107,3,2,1,3500,950,4450,41.588783
901,Moema,40,1,1,1,1899,710,2609,65.225
902,Itaim Bibi,75,1,1,1,2500,1800,4300,57.333332
903,Freguesia do Ó,89,3,2,1,1400,721,2121,23.83146
904,Tatuapé,24,1,1,0,1400,250,1650,68.75
905,Saúde,35,1,1,1,2250,445,2695,77.0
906,Brooklin,72,2,2,1,5500,1000,6500,90.27778
907,Vila Cruzeiro,36,1,1,1,2200,360,2560,71.111115
908,Vila Nova Conceição,70,2,1,0,2900,809,3709,52.985714
909,Outro,61,3,2,1,2300,540,2840,46.557377
910,Santana,52,2,1,1,1300,383,1683,32.365383
911,Ipiranga,60,2,1,0,1700,150,1850,30.833334
912,Brooklin,43,1,1,1,3200,650,3850,89.53488
913,Moema,115,3,3,2,5000,1160,6160,53.565216
914,Campo Belo,78,2,2,1,2200,826,3026,38.794872
915,Indianópolis,72,3,2,2,3200,1035,4235,58.819443
916,Vila Clementino,65,2,2,1,2500,1196,3696,56.861538
917,Jardim Paulista,56,1,1,1,2400,655,3055,54.55357
918,Aclimação,70,2,2,3,2200,1212,3412,48.74286
919,Lapa,63,3,2,1,2400,465,2865,45.47619
920,Outro,40,2,1,0,1150,0,1150,28.75
921,Higienópolis,240,3,2,2,4500,2000,6500,27.083334
922,Vila Olímpia,40,1,1,1,2800,410,3210,80.25
923,Outro,65,3,2,1,2000,550,2550,39.23077
924,Mirandópolis,65,2,2,2,2500,1000,3500,53.846153
925,Pompeia,120,2,4,2,7500,1000,8500,70.833336
926,Vila Nova Conceição,41,1,1,1,2890,1091,3981,97.097565
927,Outro,27,1,1,0,1200,50,1250,46.296295
928,Butantã,14,1,1,0,1200,0,1200,85.71429
929,Perdizes,60,2,1,2,2800,800,3600,60.0
930,Vila Mariana,36,1,1,1,2050,600,2650,73.611115
931,Perdizes,129,3,1,2,3250,1670,4920,38.139534
932,Consolação,24,1,1,0,3200,150,3350,139.58333
933,Cidade Monções,38,1,1,1,3300,560,3860,101.57895
934,Moema,60,2,2,1,2400,865,3265,54.416668
935,Bela Vista,43,1,1,1,3000,0,3000,69.76744
936,Brooklin,72,2,3,2,3500,1120,4620,64.166664
937,Moema,38,1,1,1,550,2700,3250,85.52631
938,Outro,70,2,2,1,1900,594,2494,35.62857
939,Vila Mascote,74,3,2,1,1900,635,2535,34.256756
940,Vila Mariana,70,2,2,1,2500,731,3231,46.157143
941,Pinheiros,93,3,1,2,5300,943,6243,67.129036
942,Cerqueira César,95,2,2,1,3000,998,3998,42.08421
943,Casa Verde,60,2,1,1,1100,470,1570,26.166666
944,Perdizes,130,4,5,3,5500,1700,7200,55.384617
945,Brooklin,96,1,2,2,7800,1600,9400,97.916664
946,Vila Mariana,65,2,2,1,2400,1180,3580,55.076923
947,Pinheiros,71,2,2,2,6000,970,6970,98.169014
948,Outro,82,2,2,2,3000,966,3966,48.365852
949,Vila Clementino,45,1,1,1,2700,645,3345,74.333336
950,Saúde,107,3,1,2,4500,680,5180,48.411217
951,Bela Vista,42,1,1,1,2600,900,3500,83.333336
952,Vila Guarani,57,2,1,1,1900,661,2561,44.929825
953,Vila Mascote,100,3,3,3,1900,1802,3702,37.02
954,Saúde,69,2,2,1,2200,680,2880,41.739132
955,Outro,44,2,1,0,1500,200,1700,38.636364
956,Jardim Paulista,44,1,1,1,2200,491,2691,61.159092
957,Vila Olímpia,62,2,1,1,1900,849,2749,44.33871
958,Brás,30,1,1,0,800,272,1072,35.733334
959,Cambuci,100,3,2,1,1200,1600,2800,28.0
960,Aclimação,43,1,1,1,2000,547,2547,59.23256
961,Vila Olímpia,65,2,2,1,2950,1013,3963,60.96923
962,Perdizes,45,1,1,1,2250,554,2804,62.31111
963,Brooklin,105,3,3,1,7000,1386,8386,79.86667
964,Vila Madalena,80,2,2,1,3350,780,4130,51.625
965,Brooklin,46,1,2,1,1450,825,2275,49.45652
966,Consolação,35,1,1,1,2300,369,2669,76.25714
967,Vila Andrade,67,3,2,1,2000,652,2652,39.58209
968,Vila Olímpia,65,2,2,1,4300,899,5199,79.98462
969,Cambuci,39,1,1,1,2260,530,2790,71.53846
970,Jardim Paulista,158,4,6,3,12830,1950,14780,93.544304
971,Vila Sônia,80,3,3,1,2800,632,3432,42.9
972,Brooklin,156,4,5,3,9700,1800,11500,73.71795
973,Pinheiros,30,1,1,1,2200,720,2920,97.333336
974,Vila Nova Conceição,50,1,2,2,2200,1150,3350,67.0
975,Vila Mariana,157,4,5,3,6500,2550,9050,57.64331
976,Ipiranga,80,3,3,2,2700,1050,3750,46.875
977,Vila Buarque,75,2,1,0,2100,622,2722,36.293335
978,Pinheiros,50,1,1,1,3500,565,4065,81.3
979,Pinheiros,106,3,3,1,6185,1400,7585,71.5566
980,Outro,100,2,2,0,3000,1161,4161,41.61
981,Pinheiros,83,2,1,1,3000,925,3925,47.289158
982,Tatuapé,90,2,1,1,1100,600,1700,18.88889
983,Pompeia,72,3,2,2,3100,799,3899,54.15278
984,Vila Mariana,57,2,1,1,3900,653,4553,79.87719
985,Outro,58,3,1,1,2000,650,2650,45.689655
986,Bela Vista,40,1,1,1,2200,435,2635,65.875
987,Vila Madalena,130,3,3,3,5985,1890,7875,60.576923
988,Centro,140,2,2,0,2800,633,3433,24.52143
989,Pinheiros,93,2,2,0,2900,243,3143,33.7957
990,Outro,63,2,2,1,2800,460,3260,51.746033
991,Moema,35,1,1,1,2100,850,2950,84.28571
992,Moema,72,3,2,1,3100,974,4074,56.583332
993,Outro,45,2,1,1,1500,450,1950,43.333332
994,Vila Nova Conceição,50,1,1,1,4500,1150,5650,113.0
995,Santa Cecília,40,1,1,0,2500,77,2577,64.425
996,Vila Madalena,72,2,2,1,2840,797,3637,50.51389
997,Vila Olímpia,115,3,4,2,12000,1681,13681,118.96522
998,Jardins,287,3,4,2,35000,4700,39700,138.32753
999,Brooklin,37,1,1,1,2900,690,3590,97.02702
1000,Saúde,57,2,2,1,2200,405,2605,45.701756
1001,Jardim Paulista,41,1,1,1,1800,875,2675,65.243904
1002,Vila Mariana,53,2,2,1,3100,970,4070,76.79245
1003,Outro,85,2,1,0,2200,630,2830,33.294117
1004,Brooklin,55,2,2,1,2500,590,3090,56.18182
1005,Brooklin,96,3,3,1,3200,789,3989,41.552082
1006,Vila Mariana,42,1,1,1,1800,690,2490,59.285713
1007,Moema,80,2,3,1,4000,935,4935,61.6875
1008,Outro,35,1,1,1,600,579,1179,33.685715
1009,Bela Vista,28,1,1,1,1300,521,1821,65.03571
1010,Pinheiros,55,1,1,0,1800,750,2550,46.363636
1011,Higienópolis,95,2,2,1,2500,968,3468,36.505264
1012,Aclimação,55,1,1,0,1500,132,1632,29.672728
1013,Brás,65,2,1,1,1700,487,2187,33.646152
1014,Itaim Bibi,100,2,2,2,14000,2149,16149,161.49
1015,Itaim Bibi,265,4,5,0,20000,3217,23217,87.61132
1016,Perdizes,184,4,4,3,4500,2800,7300,39.673912
1017,Consolação,120,2,1,0,2600,771,3371,28.091667
1018,Outro,63,3,2,2,1800,674,2474,39.26984
1019,Vila Nova Conceição,70,2,2,1,3000,1200,4200,60.0
1020,Brooklin,70,2,2,1,2100,1000,3100,44.285713
1021,Outro,64,2,1,1,2450,0,2450,38.28125
1022,Consolação,35,1,1,1,2676,304,2980,85.14286
1023,Outro,33,1,1,1,1350,70,1420,43.030304
1024,Liberdade,38,1,1,0,2200,809,3009,79.18421
1025,Vila Olímpia,125,3,4,3,13000,1500,14500,116.0
1026,Tatuapé,74,2,2,2,3300,1040,4340,58.648647
1027,Moema,45,1,1,1,2550,750,3300,73.333336
1028,Jardim Paulista,50,2,1,1,2600,837,3437,68.74
1029,Vila Mariana,115,3,3,3,5100,1897,6997,60.84348
1030,Vila Sônia,28,1,1,0,1600,0,1600,57.142857
1031,Vila Mariana,90,3,3,1,4800,0,4800,53.333332
1032,Pinheiros,140,3,3,1,5000,1245,6245,44.607143
1033,Panamby,607,4,7,6,29000,7926,36926,60.833607
1034,Vila Olímpia,65,2,2,1,4900,880,5780,88.92308
1035,Higienópolis,125,3,2,1,4000,0,4000,32.0
1036,Bela Vista,42,1,1,1,2500,415,2915,69.40476
1037,Santa Cecília,45,1,1,1,1600,622,2222,49.377777
1038,Outro,126,3,2,1,3000,2033,5033,39.944443
1039,Outro,77,2,3,1,2806,700,3506,45.532467
1040,Jardim Marajoara,63,3,2,1,1700,678,2378,37.746033
1041,Tatuapé,157,3,5,4,5600,1837,7437,47.369427
1042,Vila Guarani,80,2,1,1,1500,700,2200,27.5
1043,Jabaquara,56,2,1,1,1300,880,2180,38.92857
1044,Pinheiros,45,1,1,1,2000,788,2788,61.955555
1045,Ipiranga,50,2,1,1,1700,460,2160,43.2
1046,Pinheiros,45,1,1,1,2700,770,3470,77.111115
1047,Outro,62,2,1,1,1250,0,1250,20.161291
1048,Bela Vista,43,1,1,0,1750,557,2307,53.65116
1049,Perdizes,106,3,4,2,3100,1339,4439,41.877357
1050,Outro,47,2,1,1,1100,520,1620,34.468086
1051,Santo Amaro,160,3,4,2,4800,1270,6070,37.9375
1052,Itaim Bibi,100,2,3,2,5500,1345,6845,68.45
1053,Vila Nova Conceição,212,3,3,4,17000,4500,21500,101.41509
1054,Panamby,430,4,6,6,15000,3999,18999,44.18372
1055,Vila Leopoldina,50,2,1,2,2200,630,2830,56.6
1056,Consolação,42,1,1,0,1400,300,1700,40.47619
1057,Saúde,37,1,1,1,1800,490,2290,61.89189
1058,Jardim Paulista,257,4,6,4,25000,2338,27338,106.37354
1059,Chácara Santo Antônio,112,3,3,2,5500,840,6340,56.607143
1060,Vila Leopoldina,63,2,2,2,2900,810,3710,58.88889
1061,Pinheiros,58,2,2,1,2200,882,3082,53.13793
1062,Sumaré,70,2,1,1,2200,738,2938,41.971428
1063,Vila Santa Catarina,73,2,2,1,3600,550,4150,56.849316
1064,Outro,86,3,3,2,2800,892,3692,42.930233
1065,Centro,42,1,1,1,1600,551,2151,51.214287
1066,Outro,38,2,1,1,800,300,1100,28.947369
1067,Itaim Bibi,98,3,2,1,4200,1800,6000,61.22449
1068,Outro,60,2,1,1,1450,0,1450,24.166666
1069,Freguesia do Ó,45,2,1,1,1700,400,2100,46.666668
1070,Jardim Paulista,59,1,1,1,2600,590,3190,54.067795
1071,Vila Olímpia,87,3,3,2,6000,910,6910,79.425285
1072,Brás,50,2,1,0,2500,500,3000,60.0
1073,Vila Olímpia,38,1,1,1,3970,800,4770,125.52631
1074,Consolação,38,1,1,1,1900,450,2350,61.842106
1075,Itaim Bibi,54,1,2,1,6500,964,7464,138.22223
1076,Outro,40,1,1,1,2321,0,2321,58.025
1077,Jardim Paulista,50,2,1,1,2600,837,3437,68.74
1078,Ipiranga,140,4,4,2,3900,1300,5200,37.142857
1079,Brás,32,1,1,0,1400,190,1590,49.6875
1080,Chácara Santo Antônio,51,2,2,1,2950,620,3570,70.0
1081,Consolação,35,1,1,1,2800,650,3450,98.57143
1082,Vila Guarani,60,2,2,2,1300,910,2210,36.833332
1083,Vila Nova Conceição,62,2,2,1,4800,873,5673,91.5
1084,Jardim América,77,2,2,1,3200,1500,4700,61.03896
1085,Móoca,85,2,2,2,3200,685,3885,45.705883
1086,Outro,45,2,1,1,1200,450,1650,36.666668
1087,Móoca,80,3,2,2,2600,760,3360,42.0
1088,Outro,34,1,1,1,1600,544,2144,63.058823
1089,Cerqueira César,91,2,2,1,2200,1550,3750,41.20879
1090,Vila Sônia,82,3,2,2,2470,800,3270,39.878048
1091,Pinheiros,160,4,4,3,10000,956,10956,68.475
1092,Outro,174,3,5,3,15000,0,15000,86.206894
1093,Saúde,59,2,1,1,1600,400,2000,33.898304
1094,Vila Leopoldina,85,3,2,2,4500,980,5480,64.47059
1095,Bela Vista,83,2,2,1,3200,1045,4245,51.144577
1096,Vila Mariana,122,3,4,2,2800,2130,4930,40.409836
1097,Consolação,40,1,1,1,1800,624,2424,60.6
1098,Jaguaré,70,3,2,1,2300,500,2800,40.0
1099,Vila Madalena,24,1,1,0,1900,550,2450,102.083336
1100,Consolação,40,1,1,1,3000,480,3480,87.0
1101,Vila Olímpia,54,1,1,1,3400,660,4060,75.18519
1102,Vila Andrade,95,2,1,2,3300,802,4102,43.178947
1103,Moema,45,1,1,1,3500,1000,4500,100.0
1104,Tatuapé,180,3,5,3,15000,1200,16200,90.0
1105,Vila Mariana,120,2,3,2,3700,724,4424,36.866665
1106,Cambuci,56,2,1,1,2800,773,3573,63.80357
1107,Jardim Paulista,85,2,2,1,3500,1006,4506,53.011765
1108,Jardim Anália Franco,125,3,3,2,4000,1140,5140,41.12
1109,Pinheiros,35,1,1,1,3350,444,3794,108.4
1110,Campo Belo,65,2,2,1,2700,980,3680,56.615383
1111,Jaguaré,70,3,1,1,2800,442,3242,46.314285
1112,Jardins,190,4,5,4,18000,2480,20480,107.789474
1113,Outro,51,2,1,1,1300,417,1717,33.666668
1114,Jardim América,312,3,4,2,12500,3006,15506,49.69872
1115,Barra Funda,93,3,3,2,3000,1000,4000,43.010754
1116,Butantã,57,2,2,1,1800,825,2625,46.05263
1117,Alto da Lapa,64,2,2,1,1700,1200,2900,45.3125
1118,Saúde,60,2,2,1,1500,806,2306,38.433334
1119,Vila Romana,62,2,2,1,2800,628,3428,55.29032
1120,Aclimação,35,1,1,1,2100,455,2555,73.0
1121,Vila Prudente,61,3,2,1,1980,357,2337,38.311474
1122,Tatuapé,160,4,5,3,3415,1560,4975,31.09375
1123,Vila Mariana,222,4,6,3,23000,3377,26377,118.815315
1124,Vila Mariana,84,2,1,1,1700,1250,2950,35.11905
1125,Vila Madalena,30,1,1,1,2500,615,3115,103.833336
1126,Pinheiros,30,1,1,1,4010,910,4920,164.0
1127,Higienópolis,145,3,4,1,5000,1888,6888,47.50345
1128,Vila Olímpia,89,3,2,2,5800,912,6712,75.41573
1129,Vila Olímpia,70,2,2,1,2600,920,3520,50.285713
1130,Brooklin,51,1,1,1,2900,573,3473,68.09804
1131,Campo Belo,220,4,6,5,10500,3500,14000,63.636364
1132,Centro,32,1,1,1,1600,483,2083,65.09375
1133,Vila Olímpia,49,1,1,2,7800,1950,9750,198.9796
1134,Morumbi,65,2,2,1,3300,580,3880,59.692307
1135,Brooklin,174,2,2,3,21000,1260,22260,127.93104
1136,Brooklin,87,1,1,2,5870,1070,6940,79.77012
1137,Jardim Paulista,106,3,3,1,3200,1000,4200,39.622643
1138,Campos Eliseos,45,1,1,0,1300,340,1640,36.444443
1139,Vila Madalena,150,3,5,2,11000,2000,13000,86.666664
1140,Brooklin,170,3,5,2,12000,2400,14400,84.70588
1141,Outro,70,3,2,2,2000,851,2851,40.728573
1142,Outro,50,2,1,1,1800,450,2250,45.0
1143,Lapa,54,2,2,1,2300,780,3080,57.037037
1144,Saúde,63,2,2,1,2200,980,3180,50.47619
1145,Outro,67,2,2,1,2200,780,2980,44.47761
1146,Moema,72,3,1,1,2300,960,3260,45.27778
1147,Vila Mariana,45,1,1,1,2190,660,2850,63.333332
1148,Jardim Paulista,110,3,3,2,3900,1223,5123,46.572727
1149,Chácara Santo Antônio,37,1,1,1,2300,512,2812,76.0
1150,Vila Olímpia,83,2,2,1,2500,1572,4072,49.06024
1151,Moema,134,3,4,2,6500,1905,8405,62.72388
1152,Bela Vista,28,1,1,0,1200,380,1580,56.42857
1153,Santo Amaro,55,2,2,1,2600,900,3500,63.636364
1154,Tatuapé,54,2,2,1,1800,730,2530,46.851852
1155,Vila Nova Conceição,166,3,4,3,17000,2300,19300,116.26506
1156,Campos Eliseos,42,1,1,1,1400,506,1906,45.38095
1157,Outro,45,1,1,1,2200,617,2817,62.6
1158,Vila Nova Conceição,237,3,4,4,27000,2050,29050,122.57384
1159,Pinheiros,85,2,3,1,4500,900,5400,63.52941
1160,Perdizes,42,1,1,1,2400,561,2961,70.5
1161,Chácara Santo Antônio,241,4,5,4,20000,0,20000,82.98755
1162,Vila Mariana,85,2,1,1,3300,798,4098,48.211765
1163,Tatuapé,100,3,3,2,3500,660,4160,41.6
1164,Outro,84,3,3,2,3600,619,4219,50.22619
1165,Ipiranga,32,1,1,1,1500,478,1978,61.8125
1166,Bela Vista,26,1,1,0,2000,0,2000,76.92308
1167,Outro,98,3,2,2,4100,750,4850,49.489796
1168,Consolação,35,1,1,1,1800,800,2600,74.28571
1169,Outro,55,2,1,0,1200,350,1550,28.181818
1170,Campos Eliseos,70,2,2,0,1600,359,1959,27.985714
1171,Bela Vista,99,1,1,1,1300,480,1780,17.979797
1172,Moema,100,3,3,2,2700,1207,3907,39.07
1173,Santo Amaro,58,1,2,0,3300,500,3800,65.51724
1174,Moema,44,1,1,1,2450,610,3060,69.545456
1175,Vila Mascote,74,3,2,1,2200,635,2835,38.31081
1176,Consolação,127,3,3,2,6500,1050,7550,59.44882
1177,Jardins,46,2,1,1,2300,880,3180,69.13043
1178,Pinheiros,45,1,2,1,2650,651,3301,73.35555
1179,Paraíso,110,3,3,2,2700,1220,3920,35.636364
1180,Pompeia,50,1,1,0,1500,150,1650,33.0
1181,Outro,38,2,1,0,1100,210,1310,34.473682
1182,Aclimação,60,1,1,0,1480,480,1960,32.666668
1183,Paraíso,100,3,3,2,5500,1455,6955,69.55
1184,Tatuapé,47,1,1,1,2100,686,2786,59.276596
1185,Paraíso,105,3,3,1,5500,1250,6750,64.28571
1186,Liberdade,38,2,1,0,1950,330,2280,60.0
1187,Outro,75,3,2,1,2200,0,2200,29.333334
1188,Saúde,60,2,2,1,2000,780,2780,46.333332
1189,Tatuapé,164,4,5,3,5500,1800,7300,44.512196
1190,Vila Mariana,110,3,2,1,3200,1150,4350,39.545456
1191,Jardim Paulista,36,1,1,1,2500,1800,4300,119.44444
1192,Outro,73,3,2,2,3100,500,3600,49.315067
1193,Jardins,60,2,2,2,4000,870,4870,81.166664
1194,Vila Mascote,113,2,4,2,4300,1100,5400,47.78761
1195,Higienópolis,38,1,1,1,2350,1252,3602,94.789474
1196,Aclimação,56,1,1,0,1500,340,1840,32.857143
1197,Bela Vista,37,1,1,1,1300,553,1853,50.08108
1198,Paraíso,102,3,3,2,12320,1400,13720,134.50981
1199,Vila Mariana,28,2,2,0,2550,635,3185,113.75
1200,Moema,120,4,4,2,5600,1156,6756,56.3
1201,Campo Belo,43,1,1,1,2400,654,3054,71.023254
1202,Vila Mariana,90,3,2,1,2800,515,3315,36.833332
1203,Liberdade,25,1,1,0,1900,447,2347,93.88
1204,Moema,80,3,3,1,3700,935,4635,57.9375
1205,Outro,97,3,2,2,2600,912,3512,36.206184
1206,Bela Vista,61,1,1,1,1400,340,1740,28.52459
1207,Outro,70,3,2,1,1400,600,2000,28.571428
1208,Moema,50,1,1,1,1650,1057,2707,54.14
1209,Ipiranga,111,3,2,2,5500,950,6450,58.10811
1210,Jardim Paulista,70,1,1,1,6500,1600,8100,115.71429
1211,Vila Mariana,100,3,2,0,2300,500,2800,28.0
1212,Higienópolis,303,4,3,4,9490,4915,14405,47.541256
1213,Moema,95,3,3,2,5200,1500,6700,70.52631
1214,Perdizes,213,4,5,4,9900,3800,13700,64.31925
1215,Morumbi,65,2,2,2,1800,646,2446,37.630768
1216,Vila Mariana,44,2,1,0,2000,564,2564,58.272728
1217,República,48,1,1,1,2990,406,3396,70.75
1218,Outro,30,1,1,0,1000,0,1000,33.333332
1219,Outro,294,2,4,3,9900,2500,12400,42.176872
1220,Itaim Bibi,129,3,3,2,9500,2200,11700,90.69768
1221,Santo Amaro,35,2,1,0,1900,200,2100,60.0
1222,Vila Madalena,57,2,2,2,2500,1420,3920,68.77193
1223,Tatuapé,70,3,2,2,2700,617,3317,47.385715
1224,Itaim Bibi,137,3,3,1,4500,1361,5861,42.78102
1225,Pinheiros,83,2,2,1,3000,1220,4220,50.843372
1226,Outro,35,1,1,1,1600,566,2166,61.885715
1227,Ipiranga,34,1,1,1,1800,340,2140,62.941177
1228,Jardins,130,2,3,1,5000,1200,6200,47.692307
1229,Pompeia,123,3,1,2,5000,1617,6617,53.79675
1230,Vila Nova Conceição,294,4,6,5,35000,5500,40500,137.7551
1231,Vila Mascote,165,3,5,3,6500,887,7387,44.769695
1232,Vila Sônia,38,2,1,1,950,623,1573,41.394737
1233,Morumbi,71,2,2,2,2200,606,2806,39.521126
1234,Moema,126,2,4,2,10500,1350,11850,94.04762
1235,Outro,40,1,1,0,950,0,950,23.75
1236,Outro,50,2,1,0,1100,0,1100,22.0
1237,Tatuapé,50,1,1,1,2350,391,2741,54.82
1238,Brooklin,37,1,1,1,3500,780,4280,115.675674
1239,Sumaré,127,3,4,4,7000,1450,8450,66.53543
1240,Santa Ifigênia,48,1,1,1,3000,665,3665,76.354164
1241,Jardim Paulista,55,1,2,1,3700,980,4680,85.09091
1242,Jardim Anália Franco,125,3,4,3,3800,0,3800,30.4
1243,Outro,30,1,1,0,900,0,900,30.0
1244,Tatuapé,75,2,1,1,1100,300,1400,18.666666
1245,Móoca,52,2,1,1,2400,397,2797,53.78846
1246,Jardim Marajoara,58,2,1,1,1866,634,2500,43.103447
1247,Vila Olímpia,45,1,1,1,2900,776,3676,81.68889
1248,Pinheiros,90,2,1,2,6500,989,7489,83.21111
1249,Outro,87,3,2,2,2700,880,3580,41.149426
1250,Perdizes,45,1,1,1,2400,560,2960,65.77778
1251,Campo Belo,35,1,1,1,2300,750,3050,87.14286
1252,Pinheiros,64,2,2,2,4800,841,5641,88.140625
1253,Bela Vista,40,1,1,2,2000,600,2600,65.0
1254,Vila Madalena,82,2,2,2,7300,1950,9250,112.80488
1255,Moema,27,1,1,0,2500,590,3090,114.44444
1256,Pinheiros,85,2,2,1,3000,1200,4200,49.411766
1257,Morumbi,64,2,2,2,3000,580,3580,55.9375
1258,Jardim Paulista,107,2,4,2,9500,1842,11342,106.0
1259,Outro,58,3,1,1,1500,400,1900,32.75862
1260,Alto da Lapa,90,3,2,2,3500,1450,4950,55.0
1261,Pinheiros,24,1,1,0,2400,300,2700,112.5
1262,Vila Mariana,100,3,1,2,5000,600,5600,56.0
1263,Brooklin,98,3,3,2,4500,1168,5668,57.836735
1264,Alto Da Boa Vista,180,3,3,2,4700,1660,6360,35.333332
1265,Vila Leopoldina,70,1,1,1,2800,710,3510,50.142857
1266,Vila Nova Conceição,70,2,1,1,2200,783,2983,42.614285
1267,Higienópolis,44,1,1,1,3000,1165,4165,94.65909
1268,Higienópolis,65,2,1,1,1800,950,2750,42.307693
1269,Vila Olímpia,124,3,2,2,4350,1350,5700,45.967743
1270,Moema,65,2,2,2,3000,994,3994,61.446156
1271,Jardim Marajoara,233,4,5,2,9000,1900,10900,46.781116
1272,Bela Vista,84,2,3,0,6300,1300,7600,90.47619
1273,Vila Olímpia,66,1,1,2,10000,2400,12400,187.87878
1274,Vila Leopoldina,56,2,2,1,1900,688,2588,46.214287
1275,Campos Eliseos,78,2,1,1,1680,0,1680,21.538462
1276,Bela Vista,56,2,2,1,2950,820,3770,67.32143
1277,Vila Mascote,64,2,1,2,2800,667,3467,54.171875
1278,Brooklin,218,4,5,4,12000,2800,14800,67.88991
1279,Outro,63,2,2,1,1500,650,2150,34.126984
1280,Cidade Monções,98,2,1,2,9000,2000,11000,112.244896
1281,Campos Eliseos,75,3,2,1,1800,607,2407,32.093334
1282,Higienópolis,113,3,2,1,3600,1450,5050,44.690266
1283,Moema,61,2,2,1,2800,890,3690,60.491802
1284,Jardins,257,4,5,4,20000,3950,23950,93.19066
1285,Barra Funda,60,2,1,0,1600,240,1840,30.666666
1286,Itaim Bibi,93,2,2,2,9700,2156,11856,127.48387
1287,Consolação,38,1,1,1,1300,1200,2500,65.789474
1288,Vila Olímpia,90,1,2,2,8500,2200,10700,118.888885
1289,Barra Funda,31,1,1,0,1500,330,1830,59.032257
1290,Vila Nova Conceição,311,4,4,4,30500,5500,36000,115.75563
1291,Morumbi,135,3,4,2,2600,1700,4300,31.851852
1292,Outro,85,3,2,2,3700,690,4390,51.64706
1293,Butantã,47,2,1,1,1100,699,1799,38.276596
1294,Outro,49,1,2,1,3100,570,3670,74.89796
1295,Chácara Santo Antônio,137,3,1,3,11000,1550,12550,91.60584
1296,Outro,55,2,1,1,1550,1,1551,28.2
1297,Outro,55,2,1,1,1250,347,1597,29.036364
1298,Jardim Anália Franco,77,2,2,2,6200,980,7180,93.24675
1299,Pinheiros,159,3,3,2,5000,1704,6704,42.16352
1300,Itaim Bibi,360,4,4,5,60000,5800,65800,182.77777
1301,Brooklin,192,3,5,3,18250,2610,20860,108.645836
1302,Outro,54,2,1,1,1600,545,2145,39.72222
1303,Liberdade,50,1,1,1,1400,470,1870,37.4
1304,Bela Vista,63,2,1,2,3950,1263,5213,82.74603
1305,Chácara Santo Antônio,65,2,2,1,2650,615,3265,50.23077
1306,Jardim Paulista,50,1,1,1,2300,700,3000,60.0
1307,Alto Da Boa Vista,187,3,4,2,5350,2070,7420,39.679146
1308,Pinheiros,60,2,1,1,2800,800,3600,60.0
1309,Jardim Paulista,35,1,1,1,1680,584,2264,64.685715
1310,Perdizes,63,2,1,1,5000,850,5850,92.85714
1311,Jabaquara,55,2,1,1,1000,700,1700,30.90909
1312,Outro,55,2,1,1,1150,450,1600,29.09091
1313,Pinheiros,40,1,1,1,3410,856,4266,106.65
1314,Aclimação,45,2,1,0,1700,550,2250,50.0
1315,Vila Clementino,87,3,3,2,5000,1300,6300,72.413795
1316,Pinheiros,25,1,1,1,2900,700,3600,144.0
1317,Outro,108,3,3,1,2800,1300,4100,37.962963
1318,Vila Guarani,94,2,2,2,4200,650,4850,51.595745
1319,Pompeia,80,3,3,2,3000,906,3906,48.825
1320,Brás,90,2,2,0,1300,290,1590,17.666666
1321,Moema,68,2,2,1,5000,0,5000,73.52941
1322,Outro,57,2,1,1,1200,425,1625,28.508772
1323,Itaim Bibi,106,2,4,2,15000,1455,16455,155.23586
1324,Outro,48,2,1,1,1600,267,1867,38.895832
1325,Brooklin,51,1,1,1,3100,590,3690,72.35294
1326,Vila Clementino,90,3,2,1,2500,617,3117,34.633335
1327,Vila Leopoldina,151,3,5,3,7500,1690,9190,60.860928
1328,Alto da Lapa,127,3,3,2,4200,880,5080,40.0
1329,Outro,50,2,1,1,1470,508,1978,39.56
1330,Vila Mariana,78,3,3,2,2600,820,3420,43.846153
1331,Brás,64,2,2,1,2200,509,2709,42.328125
1332,Vila Buarque,39,1,1,1,1699,645,2344,60.102566
1333,Brás,36,1,1,0,1000,227,1227,34.083332
1334,Cambuci,50,1,1,0,1700,380,2080,41.6
1335,Morumbi,90,2,3,2,2350,898,3248,36.08889
1336,Itaim Bibi,75,1,1,1,2700,1800,4500,60.0
1337,Vila Mariana,53,2,2,1,2500,990,3490,65.84906
1338,Móoca,38,1,1,0,2500,350,2850,75.0
1339,Outro,77,2,2,1,2699,640,3339,43.363636
1340,Outro,142,3,4,2,6000,1150,7150,50.35211
1341,Saúde,42,1,1,1,1800,723,2523,60.07143
1342,Vila Mariana,179,4,5,3,8500,2455,10955,61.20112
1343,Aclimação,88,3,3,1,3000,830,3830,43.522728
1344,Itaim Bibi,178,3,3,2,5619,3981,9600,53.932583
1345,Campo Belo,39,1,1,1,1700,716,2416,61.94872
1346,Paraíso,70,2,2,2,4900,640,5540,79.14286
1347,Outro,60,2,2,1,2700,600,3300,55.0
1348,Barra Funda,105,3,3,2,4000,1100,5100,48.57143
1349,Campo Belo,43,1,1,1,1600,670,2270,52.7907
1350,Tatuapé,106,3,1,2,3900,740,4640,43.773586
1351,Barra Funda,47,1,1,1,2000,700,2700,57.446808
1352,Vila Andrade,181,3,2,2,3800,663,4463,24.65746
1353,Outro,83,3,2,1,2800,680,3480,41.92771
1354,Butantã,67,2,2,1,3000,600,3600,53.731342
1355,Santana,32,1,1,1,805,1715,2520,78.75
1356,Bela Vista,75,1,2,1,4300,1500,5800,77.333336
1357,Móoca,60,2,1,1,1600,200,1800,30.0
1358,Outro,48,2,1,1,649,351,1000,20.833334
1359,Vila Olímpia,125,4,5,3,14000,1554,15554,124.432
1360,Perdizes,86,3,3,1,3000,850,3850,44.76744
1361,Outro,64,2,2,2,1800,628,2428,37.9375
1362,Pinheiros,20,1,1,0,2999,200,3199,159.95
1363,Vila Gomes Cardim,92,3,2,2,2700,833,3533,38.402172
1364,Outro,50,2,1,1,1500,500,2000,40.0
1365,Vila Nova Conceição,72,3,2,2,4200,955,5155,71.59722
1366,Vila Mariana,43,1,1,1,1650,460,2110,49.069767
1367,Chácara Klabin,68,3,2,1,2700,943,3643,53.57353
1368,Outro,45,1,1,1,1550,900,2450,54.444443
1369,Vila Clementino,94,3,4,2,5000,1300,6300,67.02128
1370,Jardim Paulista,90,1,2,1,3200,1500,4700,52.22222
1371,Itaim Bibi,100,2,2,1,3100,799,3899,38.99
1372,Vila Olímpia,45,1,1,1,6000,0,6000,133.33333
1373,Vila Mariana,49,1,1,1,1650,940,2590,52.857143
1374,Vila Mariana,55,2,2,1,3500,790,4290,78.0
1375,Vila Mascote,60,2,1,1,2450,550,3000,50.0
1376,Tatuapé,117,3,2,3,2900,1318,4218,36.05128
1377,Outro,50,2,1,1,920,380,1300,26.0
1378,Campo Belo,71,2,2,2,4501,1360,5861,82.54929
1379,Outro,84,3,2,2,3000,867,3867,46.035713
1380,Vila Olímpia,70,1,2,1,5240,1000,6240,89.14286
1381,República,40,1,1,1,2000,550,2550,63.75
1382,Vila Mariana,33,1,1,0,1400,450,1850,56.060608
1383,Jardim Paulista,435,4,6,2,30000,7263,37263,85.66207
1384,Outro,65,3,3,1,1900,460,2360,36.307693
1385,Itaim Bibi,45,1,1,1,2550,983,3533,78.51111
1386,Ipiranga,64,2,1,1,2600,700,3300,51.5625
1387,Vila Buarque,55,2,1,1,2400,702,3102,56.4
1388,Cerqueira César,78,2,2,1,2500,1600,4100,52.564102
1389,Higienópolis,55,2,2,1,2490,904,3394,61.70909
1390,Outro,102,3,4,2,3800,950,4750,46.568626
1391,Outro,58,2,1,1,1290,580,1870,32.24138
1392,Higienópolis,193,3,2,1,6000,1701,7701,39.901554
1393,Brooklin,90,3,3,2,3500,1103,4603,51.144444
1394,Outro,75,2,1,0,1800,625,2425,32.333332
1395,Outro,55,2,1,1,1500,500,2000,36.363636
1396,Morumbi,210,3,5,3,4500,2388,6888,32.8
1397,Vila Mariana,120,3,3,2,2950,1344,4294,35.783333
1398,Brooklin,78,2,2,1,4500,790,5290,67.82051
1399,Jardim Europa,241,3,3,2,9900,3950,13850,57.46888
1400,Vila Mariana,222,4,6,4,20000,2369,22369,100.76126
1401,Jabaquara,55,2,1,1,1380,600,1980,36.0
1402,Vila Andrade,85,3,2,2,2700,680,3380,39.764706
1403,Outro,48,2,1,1,1255,465,1720,35.833332
1404,Vila Guarani,84,2,2,1,1999,613,2612,31.095238
1405,Barra Funda,71,2,2,2,3100,350,3450,48.59155
1406,Campo Belo,69,1,2,2,10000,1000,11000,159.42029
1407,Perdizes,35,1,1,1,2500,650,3150,90.0
1408,Outro,74,2,2,1,3400,900,4300,58.10811
1409,Granja Julieta,38,1,1,1,1900,512,2412,63.473682
1410,Centro,40,1,1,0,900,300,1200,30.0
1411,Brooklin,84,2,3,2,8500,900,9400,111.90476
1412,Sumaré,65,3,2,1,1800,814,2614,40.215385
1413,Água Branca,22,1,1,0,1100,300,1400,63.636364
1414,Aclimação,82,3,3,2,2400,1087,3487,42.52439
1415,Campos Eliseos,28,1,1,0,650,392,1042,37.214287
1416,Brooklin,96,3,2,2,5300,1150,6450,67.1875
1417,Vila Nova Conceição,62,2,2,1,5000,873,5873,94.72581
1418,Santana,145,3,4,3,4000,1500,5500,37.931034
1419,Pinheiros,120,3,3,2,5000,1300,6300,52.5
1420,Brooklin,63,2,2,2,3000,950,3950,62.698414
1421,Vila Andrade,85,3,2,1,3196,582,3778,44.44706
1422,Outro,45,1,1,0,1100,280,1380,30.666666
1423,Outro,70,2,1,0,1460,220,1680,24.0
1424,Outro,126,2,2,2,3800,950,4750,37.698414
1425,Vila Mariana,20,1,1,1,2500,400,2900,145.0
1426,Pinheiros,110,3,2,0,2000,396,2396,21.781818
1427,Pinheiros,50,1,1,0,1500,208,1708,34.16
1428,Aclimação,35,1,1,0,1200,290,1490,42.57143
1429,Outro,192,4,6,4,8000,3254,11254,58.614582
1430,Bela Vista,53,1,1,0,1350,392,1742,32.867924
1431,Mirandópolis,70,2,2,1,2000,950,2950,42.142857
1432,Jardins,120,3,3,2,20000,2617,22617,188.475
1433,Bela Vista,38,1,1,0,900,285,1185,31.18421
1434,Jardim Paulista,100,2,1,1,2600,950,3550,35.5
1435,Jardim Anália Franco,156,4,5,3,4300,1490,5790,37.115383
1436,Santa Cecília,95,2,1,1,3400,0,3400,35.789474
1437,Vila Andrade,33,1,1,1,1400,500,1900,57.575756
1438,Outro,42,2,1,1,750,300,1050,25.0
1439,Vila Olímpia,79,2,1,1,2200,530,2730,34.55696
1440,Vila Olímpia,30,1,1,1,2800,600,3400,113.333336
1441,Vila Carrão,60,1,2,1,1750,616,2366,39.433334
1442,Moema,45,1,1,1,1766,684,2450,54.444443
1443,Vila Mariana,50,1,2,1,2800,856,3656,73.12
1444,Outro,182,3,5,0,3900,2220,6120,33.626373
1445,Consolação,40,1,1,1,2800,340,3140,78.5
1446,Paraíso,63,2,1,1,1900,844,2744,43.555557
1447,Vila Nova Conceição,45,1,1,1,3600,1000,4600,102.22222
1448,Moema,210,3,4,0,5000,0,5000,23.809525
1449,Vila Olímpia,74,2,1,3,6350,850,7200,97.297295
1450,Liberdade,65,2,2,1,3400,550,3950,60.76923
1451,Saúde,40,1,2,1,2450,490,2940,73.5
1452,Campo Belo,60,2,2,1,4650,680,5330,88.833336
1453,Jardim Paulista,100,2,2,1,3500,1000,4500,45.0
1454,Brooklin,100,3,3,2,4500,1080,5580,55.8
1455,Vila Madalena,58,2,1,1,4400,798,5198,89.62069
1456,Jardins,184,2,2,1,14000,2100,16100,87.5
1457,Vila Clementino,27,1,1,0,2200,398,2598,96.22222
1458,Jardins,180,3,4,1,8000,2800,10800,60.0
1459,Outro,130,3,4,2,4800,1300,6100,46.923077
1460,Campo Belo,220,4,5,3,7254,3518,10772,48.963634
1461,Perdizes,103,3,2,1,2000,1290,3290,31.941748
1462,Itaim Bibi,223,3,5,4,30000,3065,33065,148.27354
1463,Indianópolis,50,1,2,1,4500,570,5070,101.4
1464,Vila Olímpia,100,3,3,1,3150,690,3840,38.4
1465,Vila Madalena,31,1,1,0,3000,450,3450,111.29032
1466,Brooklin,67,1,1,1,4000,1000,5000,74.62687
1467,Pinheiros,65,2,1,1,2100,760,2860,44.0
1468,Mirandópolis,68,2,2,2,3900,895,4795,70.51471
1469,Aclimação,199,3,4,3,2999,2000,4999,25.120604
1470,Consolação,30,1,1,0,1900,415,2315,77.166664
1471,Bela Vista,66,3,2,1,3500,750,4250,64.393936
1472,Pinheiros,63,1,2,1,4500,795,5295,84.04762
1473,Butantã,156,4,4,2,6300,1300,7600,48.71795
1474,Consolação,36,1,1,1,2300,404,2704,75.111115
1475,Outro,85,2,1,0,1700,251,1951,22.952942
1476,Tatuapé,66,2,2,2,2600,600,3200,48.484848
1477,Liberdade,28,1,1,0,3000,270,3270,116.78571
1478,Outro,50,2,2,1,1400,550,1950,39.0
1479,Jardim Marajoara,92,2,1,2,3800,772,4572,49.695652
1480,Vila Olímpia,66,1,2,1,2300,500,2800,42.424244
1481,Consolação,42,1,1,1,1500,807,2307,54.92857
1482,Vila Clementino,65,2,2,1,3400,720,4120,63.384617
1483,Jardim América,31,1,1,1,2700,587,3287,106.03226
1484,Outro,63,2,2,1,5100,800,5900,93.650795
1485,Brás,50,2,1,1,1500,380,1880,37.6
1486,Outro,47,2,1,1,1200,550,1750,37.234043
1487,Vila Nova Conceição,127,3,4,3,6800,2228,9028,71.08662
1488,Moema,130,3,3,1,4500,1370,5870,45.153847
1489,Brás,60,2,1,1,1300,490,1790,29.833334
1490,Campo Belo,70,2,2,1,5000,860,5860,83.71429
1491,Vila Madalena,75,2,1,1,3200,0,3200,42.666668
1492,Lapa,48,2,1,1,2200,365,2565,53.4375
1493,Bela Vista,36,1,1,1,2500,410,2910,80.833336
1494,Outro,100,3,3,3,3900,0,3900,39.0
1495,Cerqueira César,55,1,1,1,3000,900,3900,70.90909
1496,Santa Cecília,50,1,1,1,2000,606,2606,52.12
1497,Jardim Paulista,141,2,3,1,2800,1870,4670,33.120567
1498,Bela Vista,210,2,2,3,17000,1205,18205,86.690475
1499,Vila Mascote,50,2,1,1,1300,636,1936,38.72
1500,Mirandópolis,85,2,3,2,2800,827,3627,42.67059
1501,Aclimação,118,3,3,2,3500,1360,4860,41.18644
1502,Itaim Bibi,40,1,1,1,3600,579,4179,104.475
1503,Moema,60,2,2,1,2885,787,3672,61.2
1504,Pinheiros,130,3,2,0,2500,607,3107,23.9
1505,Moema,94,3,3,1,5400,1084,6484,68.97872
1506,Outro,52,2,1,1,1200,340,1540,29.615385
1507,Vila Mariana,67,2,2,1,3000,935,3935,58.731342
1508,Outro,64,2,1,0,1490,160,1650,25.78125
1509,Perdizes,70,2,1,0,1680,333,2013,28.757143
1510,Jardim Paulista,40,1,1,0,1600,130,1730,43.25
1511,Bela Vista,80,2,2,0,3000,536,3536,44.2
1512,Bela Vista,46,1,1,0,1200,319,1519,33.02174
1513,Butantã,17,1,1,0,1350,0,1350,79.411766
1514,Alto Da Boa Vista,100,2,2,1,1900,850,2750,27.5
1515,Jardim Paulista,250,3,5,2,9000,3800,12800,51.2
1516,Brooklin,75,2,2,1,2600,1061,3661,48.81333
1517,Jardins,180,3,3,1,10500,1580,12080,67.111115
1518,Moema,44,1,1,1,3500,962,4462,101.40909
1519,Brooklin,41,1,1,1,3200,580,3780,92.19512
1520,Brooklin,96,3,3,2,4500,1320,5820,60.625
1521,Outro,64,3,2,0,1900,815,2715,42.421875
1522,Vila Santa Catarina,63,3,1,1,2300,731,3031,48.11111
1523,Pinheiros,75,2,1,1,3000,842,3842,51.226665
1524,Vila Formosa,60,2,1,1,1600,200,1800,30.0
1525,Pinheiros,73,3,3,2,3400,1132,4532,62.08219
1526,Outro,47,2,1,1,1350,350,1700,36.17021
1527,Cidade Monções,43,1,1,1,1990,607,2597,60.395348
1528,Butantã,60,4,2,0,2090,0,2090,34.833332
1529,Outro,35,1,1,0,1000,0,1000,28.571428
1530,Jardim Europa,750,4,6,5,180000,24000,204000,272.0
1531,Moema,84,2,2,1,9000,1300,10300,122.61905
1532,Pinheiros,35,1,1,1,1700,446,2146,61.314285
1533,Outro,72,2,2,1,920,480,1400,19.444445
1534,Vila Leopoldina,53,2,1,1,2400,540,2940,55.4717
1535,Vila Guarani,56,2,1,1,1690,565,2255,40.267857
1536,Bela Vista,34,1,1,1,2780,850,3630,106.76471
1537,Higienópolis,115,3,2,1,3590,1451,5041,43.83478
1538,Liberdade,92,1,1,0,1300,465,1765,19.184782
1539,Itaim Bibi,70,1,2,1,4500,1172,5672,81.02857
1540,Vila Mascote,85,2,3,2,4500,545,5045,59.35294
1541,Perdizes,80,2,1,1,2300,960,3260,40.75
1542,Santo Amaro,68,2,1,1,2600,0,2600,38.235294
1543,Outro,39,1,1,2,2250,595,2845,72.948715
1544,Paraíso,33,1,1,1,1650,1150,2800,84.84849
1545,Pinheiros,80,3,2,1,3200,820,4020,50.25
1546,Outro,45,1,1,2,1500,900,2400,53.333332
1547,República,28,1,1,0,2600,450,3050,108.92857
1548,Outro,60,2,2,1,2000,880,2880,48.0
1549,Consolação,40,1,1,1,1400,635,2035,50.875
1550,Outro,85,2,2,2,2000,1038,3038,35.741177
1551,Alto da Lapa,43,1,1,1,2200,568,2768,64.37209
1552,Vila Mariana,40,1,2,1,2200,490,2690,67.25
1553,Tatuapé,73,2,2,2,3000,650,3650,50.0
1554,Paraíso,165,3,3,1,3300,1340,4640,28.121212
1555,Vila Mariana,68,2,2,2,2500,800,3300,48.52941
1556,Vila Madalena,126,3,2,2,7950,922,8872,70.4127
1557,Outro,52,2,1,1,1500,780,2280,43.846153
1558,Pinheiros,128,2,3,1,4000,600,4600,35.9375
1559,Pinheiros,40,1,1,1,3410,856,4266,106.65
1560,Campos Eliseos,33,1,1,0,1401,0,1401,42.454544
1561,Vila Leopoldina,55,2,2,1,2500,900,3400,61.81818
1562,Outro,50,2,2,1,1000,800,1800,36.0
1563,Moema,95,2,2,2,3500,690,4190,44.105263
1564,Brooklin,67,2,2,2,4200,800,5000,74.62687
1565,Pinheiros,98,2,2,1,5000,980,5980,61.02041
1566,Outro,64,2,2,1,1400,805,2205,34.453125
1567,Brás,20,1,1,0,1100,240,1340,67.0
1568,Cerqueira César,32,1,1,0,3300,500,3800,118.75
1569,Saúde,34,1,1,1,1700,560,2260,66.47059
1570,Jardim Paulista,84,2,3,1,4750,1490,6240,74.28571
1571,Itaim Bibi,118,1,2,2,6200,2206,8406,71.23729
1572,Outro,38,2,1,0,1000,160,1160,30.526316
1573,Panamby,330,4,4,5,19000,4800,23800,72.121216
1574,Vila Olímpia,92,3,1,1,2300,620,2920,31.73913
1575,Vila Olímpia,73,2,3,2,5699,0,5699,78.0685
1576,Outro,38,2,1,1,1600,100,1700,44.736843
1577,Outro,55,1,1,0,1170,340,1510,27.454546
1578,Pinheiros,24,1,1,1,2900,400,3300,137.5
1579,Vila Andrade,66,2,2,1,2750,800,3550,53.78788
1580,Vila Nova Conceição,57,1,1,1,6900,950,7850,137.7193
1581,Campo Belo,143,2,3,2,4500,2100,6600,46.153847
1582,Outro,16,1,1,0,1100,0,1100,68.75
1583,Vila Mariana,150,3,4,3,5000,1412,6412,42.746666
1584,Vila Nova Conceição,41,1,1,1,890,1860,2750,67.07317
1585,Pinheiros,90,3,3,1,3800,948,4748,52.755554
1586,Campo Belo,221,4,5,3,22000,3086,25086,113.511314
1587,Vila Olímpia,70,2,2,1,7270,950,8220,117.42857
1588,Água Branca,70,3,2,1,2400,446,2846,40.657143
1589,Vila Mariana,51,2,1,1,3399,450,3849,75.47059
1590,Vila Buarque,35,1,1,0,1200,360,1560,44.57143
1591,Itaim Bibi,43,1,2,1,2560,960,3520,81.860466
1592,Vila Clementino,110,3,2,1,2800,1150,3950,35.909092
1593,Outro,51,2,1,1,850,150,1000,19.607843
1594,Itaim Bibi,107,3,3,1,4700,1300,6000,56.074768
1595,Cerqueira César,40,1,1,1,2200,501,2701,67.525
1596,Outro,30,1,1,0,1200,110,1310,43.666668
1597,Outro,45,1,1,0,1800,450,2250,50.0
1598,Campo Belo,75,2,2,2,3400,1400,4800,64.0
1599,Moema,87,2,3,2,4300,1573,5873,67.505745
1600,Outro,76,3,2,2,2900,950,3850,50.657894
1601,Brooklin,42,1,1,1,1700,612,2312,55.04762
1602,Bela Vista,100,3,2,0,2400,660,3060,30.6
1603,Higienópolis,110,2,1,1,3600,1063,4663,42.390907
1604,Vila Andrade,168,3,4,3,8000,1285,9285,55.267857
1605,Bela Vista,50,2,1,0,2200,705,2905,58.1
1606,Moema,172,3,4,2,5500,2080,7580,44.069767
1607,Outro,62,3,2,1,1700,484,2184,35.225807
1608,Móoca,102,3,3,2,5000,905,5905,57.89216
1609,Vila Leopoldina,61,2,2,1,2900,650,3550,58.19672
1610,Jardim Paulista,35,1,1,1,1750,680,2430,69.42857
1611,Brooklin,44,1,1,1,3450,490,3940,89.545456
1612,Vila Mascote,107,3,5,3,5000,800,5800,54.20561
1613,Jardim Paulista,100,1,2,2,6000,1350,7350,73.5
1614,Tatuapé,75,2,1,0,2000,467,2467,32.893333
1615,Vila Nova Conceição,226,4,4,4,25000,2959,27959,123.71239
1616,Consolação,145,2,1,1,6500,1390,7890,54.41379
1617,Vila Olímpia,63,2,2,1,5500,998,6498,103.14286
1618,Paraíso,89,3,1,1,3000,1218,4218,47.393257
1619,Outro,68,2,2,1,2000,800,2800,41.17647
1620,Outro,38,2,1,0,950,150,1100,28.947369
1621,Vila Prudente,85,2,2,1,1800,0,1800,21.17647
1622,Santo Amaro,72,3,3,2,3200,785,3985,55.34722
1623,Outro,76,3,3,2,1850,816,2666,35.07895
1624,Itaim Bibi,170,2,2,1,16000,1800,17800,104.70588
1625,Vila Nova Conceição,60,2,2,1,2200,721,2921,48.683334
1626,Itaim Bibi,135,3,5,1,14000,0,14000,103.703705
1627,Outro,68,2,1,0,1080,580,1660,24.411764
1628,Aclimação,41,1,1,1,1700,590,2290,55.853657
1629,Vila Madalena,96,2,3,1,3500,1300,4800,50.0
1630,Brooklin,41,1,1,1,3500,675,4175,101.82927
1631,Santo Amaro,125,3,4,2,5800,1667,7467,59.736
1632,Campo Belo,185,3,3,3,22000,2011,24011,129.78918
1633,Outro,62,2,1,1,2600,615,3215,51.85484
1634,Vila Madalena,90,2,2,2,2995,895,3890,43.22222
1635,Pinheiros,145,3,4,2,7500,1450,8950,61.724136
1636,Moema,42,1,1,1,2200,1200,3400,80.95238
1637,Cambuci,55,2,1,1,1500,600,2100,38.18182
1638,Outro,50,1,1,1,1500,408,1908,38.16
1639,Outro,43,2,1,1,1000,500,1500,34.88372
1640,Vila Anastácio,58,2,1,1,2650,450,3100,53.448277
1641,Vila Andrade,500,5,5,4,6000,3000,9000,18.0
1642,Brás,48,1,1,1,2500,0,2500,52.083332
1643,Outro,60,2,1,1,1900,460,2360,39.333332
1644,Itaim Bibi,54,1,2,1,7500,960,8460,156.66667
1645,Saúde,28,1,1,0,1600,120,1720,61.42857
1646,Vila Nova Conceição,154,3,5,3,13500,1750,15250,99.02597
1647,Chácara Santo Antônio,55,1,2,1,3300,1150,4450,80.90909
1648,Brooklin,220,3,5,3,25000,2500,27500,125.0
1649,Itaim Bibi,130,1,2,3,10000,1850,11850,91.15385
1650,Móoca,82,3,3,2,2500,1000,3500,42.682926
1651,Jardim Paulista,45,1,1,1,3000,0,3000,66.666664
1652,Vila Olímpia,25,1,1,1,2100,950,3050,122.0
1653,Moema,53,1,2,1,2650,618,3268,61.660378
1654,Vila Mascote,70,2,2,1,2200,800,3000,42.857143
1655,Moema,75,2,3,1,3900,1000,4900,65.333336
1656,Outro,68,2,1,1,1600,600,2200,32.35294
1657,Vila Mariana,50,1,2,1,2300,730,3030,60.6
1658,Outro,86,3,3,2,2800,914,3714,43.186047
1659,Jardins,204,3,3,1,11000,2500,13500,66.17647
1660,Outro,67,2,1,1,1150,322,1472,21.97015
1661,Brooklin,120,3,3,2,4000,1680,5680,47.333332
1662,Outro,98,3,1,2,4500,800,5300,54.081635
1663,Outro,57,2,2,2,1800,1017,2817,49.42105
1664,Ipiranga,68,2,2,1,2300,708,3008,44.235294
1665,Chácara Santo Antônio,95,2,3,2,6100,725,6825,71.8421
1666,Vila Prudente,56,2,1,1,1491,400,1891,33.767857
1667,Jabaquara,49,2,2,1,1300,389,1689,34.469387
1668,Outro,55,2,1,1,1900,800,2700,49.090908
1669,Outro,52,2,1,1,1499,450,1949,37.48077
1670,Itaim Bibi,47,1,1,1,2500,720,3220,68.510635
1671,Morumbi,181,3,2,2,3800,664,4464,24.662983
1672,Campo Belo,48,1,1,1,1600,390,1990,41.458332
1673,Itaim Bibi,130,2,2,3,17300,1875,19175,147.5
1674,Brooklin,132,3,5,2,11000,700,11700,88.63636
1675,Vila Olímpia,90,1,2,2,8000,1900,9900,110.0
1676,Butantã,20,1,1,0,1590,0,1590,79.5
1677,Outro,107,2,3,2,15000,3100,18100,169.15887
1678,Bela Vista,62,2,2,1,3500,649,4149,66.91936
1679,Moema,70,2,3,1,3380,880,4260,60.857143
1680,Outro,77,2,2,1,1700,900,2600,33.766235
1681,Jardim Marajoara,92,3,3,2,3400,800,4200,45.652172
1682,Moema,200,4,5,4,4500,3700,8200,41.0
1683,Pirituba,54,2,2,1,1350,404,1754,32.48148
1684,República,48,1,1,1,2990,406,3396,70.75
1685,Vila Prudente,53,2,1,1,1400,517,1917,36.16981
1686,Paraíso,160,3,3,2,3000,1350,4350,27.1875
1687,Brooklin,80,2,2,2,5650,800,6450,80.625
1688,Vila Nova Conceição,160,3,3,3,10500,2402,12902,80.6375
1689,Vila Prudente,62,2,2,1,1900,593,2493,40.20968
1690,Vila Leopoldina,53,2,1,1,2300,700,3000,56.603775
1691,Outro,275,3,4,3,8500,3188,11688,42.50182
1692,Pinheiros,24,1,1,1,2900,600,3500,145.83333
1693,Ipiranga,130,3,5,3,4000,1300,5300,40.76923
1694,Vila Mariana,93,3,2,1,3400,575,3975,42.741936
1695,Pinheiros,72,2,2,2,4750,1080,5830,80.97222
1696,Perdizes,60,2,2,1,2600,660,3260,54.333332
1697,Brooklin,38,1,1,1,2800,570,3370,88.68421
1698,Pompeia,60,2,2,1,2500,889,3389,56.483334
1699,Vila Nova Conceição,105,2,2,1,5000,1100,6100,58.095238
1700,Tatuapé,71,3,2,2,2700,617,3317,46.71831
1701,Vila Madalena,70,2,2,2,5300,1340,6640,94.85714
1702,Vila Olímpia,59,1,2,1,3000,903,3903,66.15254
1703,Moema,74,2,2,1,1500,638,2138,28.891891
1704,Tatuapé,64,3,1,1,1500,670,2170,33.90625
1705,Santa Cecília,42,1,1,1,2600,870,3470,82.61905
1706,Vila Mascote,55,2,1,1,1350,750,2100,38.18182
1707,Jardim América,180,2,4,3,17000,2080,19080,106.0
1708,Campo Belo,428,4,7,3,29000,3400,32400,75.700935
1709,Perdizes,70,1,1,0,2000,0,2000,28.571428
1710,Santo Amaro,115,3,3,2,4998,900,5898,51.286957
1711,Pinheiros,34,1,1,1,3300,483,3783,111.26471
1712,Saúde,116,3,3,2,3400,1514,4914,42.36207
1713,Outro,55,2,1,1,1100,675,1775,32.272728
1714,Morumbi,65,3,1,1,1700,450,2150,33.076923
1715,Outro,55,2,1,1,1250,350,1600,29.09091
1716,Pompeia,108,3,2,2,3800,920,4720,43.703705
1717,Santa Ifigênia,36,1,1,1,1800,450,2250,62.5
1718,Vila Mariana,33,1,1,0,1500,100,1600,48.484848
1719,Santa Cecília,110,2,2,1,1900,1000,2900,26.363636
1720,Moema,110,3,4,2,4100,1356,5456,49.6
1721,Vila Olímpia,156,3,4,4,14000,1572,15572,99.82051
1722,Cerqueira César,65,2,1,0,2500,700,3200,49.23077
1723,Outro,52,2,1,1,1100,605,1705,32.78846
1724,Outro,80,2,2,1,1700,651,2351,29.3875
1725,Saúde,38,1,2,1,1800,497,2297,60.44737
1726,Higienópolis,104,2,3,1,3000,705,3705,35.625
1727,Moema,80,2,3,2,3300,1040,4340,54.25
1728,Bela Vista,60,2,1,1,2600,780,3380,56.333332
1729,Outro,82,3,2,1,3150,515,3665,44.69512
1730,Centro,40,1,1,0,900,300,1200,30.0
1731,Bela Vista,50,1,1,0,1300,450,1750,35.0
1732,Saúde,68,3,1,1,1700,828,2528,37.17647
1733,Saúde,95,2,3,2,3000,672,3672,38.65263
1734,Vila Madalena,25,1,1,0,2100,700,2800,112.0
1735,Paraíso,47,2,1,0,2600,600,3200,68.085106
1736,Pinheiros,67,2,1,1,2800,670,3470,51.791046
1737,Jardim Paulista,45,1,1,1,1575,1200,2775,61.666668
1738,Liberdade,58,2,2,1,1800,555,2355,40.603447
1739,Vila Buarque,45,1,1,1,1500,606,2106,46.8
1740,Jardim Paulista,110,3,2,1,6203,1500,7703,70.027275
1741,Jardim Anália Franco,40,1,1,1,2500,460,2960,74.0
1742,Vila Leopoldina,35,1,1,0,2200,300,2500,71.42857
1743,Pinheiros,55,2,1,2,2600,869,3469,63.072727
1744,Pinheiros,30,1,1,1,1800,1447,3247,108.23333
1745,Alto Da Boa Vista,31,1,1,1,1900,450,2350,75.80645
1746,Água Branca,45,2,1,0,1390,380,1770,39.333332
1747,Perdizes,86,3,4,2,3500,1089,4589,53.360466
1748,Jardim Paulista,225,3,4,2,15000,2300,17300,76.888885
1749,Tatuapé,28,1,1,0,1200,50,1250,44.642857
1750,Aclimação,45,1,1,1,1500,589,2089,46.422222
1751,Brooklin,84,2,3,2,6500,910,7410,88.21429
1752,Jardim Marajoara,70,3,2,2,1945,595,2540,36.285713
1753,Outro,35,1,1,0,1200,289,1489,42.54286
1754,Outro,52,2,1,1,1300,420,1720,33.076923
1755,Pirituba,64,2,1,0,1000,310,1310,20.46875
1756,República,153,2,2,0,2800,650,3450,22.549019
1757,Barra Funda,93,3,2,2,6000,1100,7100,76.344086
1758,Vila Olímpia,111,3,3,2,7500,1170,8670,78.10811
1759,Vila Andrade,96,2,2,2,3490,700,4190,43.645832
1760,Outro,50,2,1,0,700,0,700,14.0
1761,Vila Buarque,105,2,1,1,2700,664,3364,32.038094
1762,Tatuapé,55,2,1,1,1800,730,2530,46.0
1763,Outro,50,2,1,1,1480,496,1976,39.52
1764,Aclimação,34,1,1,1,2190,481,2671,78.55882
1765,Cambuci,29,1,1,0,1300,230,1530,52.75862
1766,Bela Vista,50,2,1,0,1400,683,2083,41.66
1767,Vila Nova Conceição,48,2,1,1,1900,560,2460,51.25
1768,Pinheiros,57,2,1,1,2000,556,2556,44.842106
1769,Brooklin,68,2,2,1,2664,1031,3695,54.338234
1770,Barra Funda,50,2,1,1,2000,527,2527,50.54
1771,Jabaquara,42,1,1,2,1200,347,1547,36.833332
1772,Vila Mariana,67,2,2,1,2200,1050,3250,48.50746
1773,Saúde,61,2,2,2,2100,730,2830,46.393444
1774,Pinheiros,80,2,1,0,2900,240,3140,39.25
1775,Moema,60,1,2,1,4300,843,5143,85.71667
1776,Pinheiros,32,1,1,1,2000,750,2750,85.9375
1777,Barra Funda,65,2,2,2,2950,785,3735,57.46154
1778,Indianópolis,90,3,3,1,3000,1301,4301,47.788887
1779,Vila Olímpia,60,2,1,1,2700,831,3531,58.85
1780,Jardim Paulista,96,2,3,1,3000,1300,4300,44.791668
1781,Vila Mariana,42,1,1,1,2500,410,2910,69.28571
1782,Vila Nova Conceição,154,4,2,3,9500,2000,11500,74.67532
1783,Outro,56,2,2,1,2600,780,3380,60.357143
1784,Brooklin,49,1,1,1,2600,558,3158,64.44898
1785,Vila Mariana,80,2,2,1,2300,760,3060,38.25
1786,Brooklin,50,1,1,1,4000,550,4550,91.0
1787,Outro,65,1,2,2,3500,957,4457,68.56923
1788,Pinheiros,24,1,1,1,2800,700,3500,145.83333
1789,Brooklin,38,1,1,1,3000,0,3000,78.947365
1790,Chácara Santo Antônio,53,2,2,1,3500,650,4150,78.30189
1791,Vila Olímpia,81,2,2,1,3300,800,4100,50.617283
1792,Outro,70,2,1,2,2500,800,3300,47.142857
1793,Bela Vista,32,1,1,1,1600,395,1995,62.34375
1794,Móoca,50,2,1,1,2150,0,2150,43.0
1795,Barra Funda,86,2,2,1,3600,550,4150,48.255814
1796,Jardim Paulista,98,2,3,1,4500,1100,5600,57.142857
1797,Morumbi,72,2,1,2,1600,781,2381,33.069443
1798,Brooklin,55,2,2,1,2800,548,3348,60.872726
1799,Vila Clementino,110,3,4,2,5800,1713,7513,68.3
1800,Vila Olímpia,55,2,2,1,2500,1149,3649,66.34545
1801,Jardim Paulista,110,3,2,1,3500,1834,5334,48.49091
1802,Moema,73,2,3,2,4650,1240,5890,80.68493
1803,Itaim Bibi,120,3,2,1,4600,0,4600,38.333332
1804,Liberdade,68,2,1,1,2400,640,3040,44.705883
1805,Pinheiros,40,1,1,1,4500,950,5450,136.25
1806,Morumbi,342,4,5,2,2500,3450,5950,17.397661
1807,Pinheiros,51,2,1,1,2970,800,3770,73.92157
1808,Aclimação,37,1,1,1,2160,530,2690,72.702705
1809,Outro,65,2,1,1,1530,566,2096,32.246155
1810,Bela Vista,86,2,2,1,4300,846,5146,59.837208
1811,Tatuapé,36,1,1,1,1400,336,1736,48.22222
1812,Bela Vista,42,1,1,1,3550,513,4063,96.7381
1813,Outro,60,2,2,1,1690,506,2196,36.6
1814,Outro,32,2,1,1,1400,200,1600,50.0
1815,República,49,1,1,1,2850,550,3400,69.38776
1816,Jardim Paulista,138,3,2,1,4500,1718,6218,45.057972
1817,Perdizes,170,4,5,3,9000,2200,11200,65.882355
1818,Chácara Santo Antônio,138,4,4,2,6800,1000,7800,56.52174
1819,Pompeia,84,2,2,1,2200,636,2836,33.761906
1820,Lapa,64,2,1,1,1450,368,1818,28.40625
1821,Jardim Paulista,280,3,2,2,15000,4000,19000,67.85714
1822,Jardim Marajoara,78,2,2,2,2035,910,2945,37.75641
1823,Pinheiros,49,2,1,1,2900,657,3557,72.591835
1824,Centro,55,2,1,0,1800,550,2350,42.727272
1825,Consolação,42,1,1,0,1270,404,1674,39.857143
1826,Alto de Pinheiros,508,5,5,5,48000,7000,55000,108.267715
1827,Itaim Bibi,41,1,1,1,3300,400,3700,90.243904
1828,Pinheiros,66,2,2,1,4858,1351,6209,94.07576
1829,Itaim Bibi,37,1,1,1,2500,920,3420,92.432434
1830,Itaim Bibi,55,1,1,1,8500,1200,9700,176.36363
1831,Outro,37,2,1,0,1200,0,1200,32.432434
1832,Pinheiros,45,1,1,1,1800,926,2726,60.577778
1833,Vila Prudente,30,1,1,0,1099,100,1199,39.966667
1834,Ipiranga,53,1,1,1,1100,569,1669,31.490566
1835,Pinheiros,110,3,3,1,3800,1125,4925,44.772728
1836,Vila Mariana,110,3,5,2,5600,1320,6920,62.909092
1837,Saúde,60,2,1,1,2050,652,2702,45.033333
1838,Consolação,35,1,1,1,2299,365,2664,76.11429
1839,Jardim América,120,3,3,2,5500,1850,7350,61.25
1840,Tatuapé,63,2,2,1,2000,452,2452,38.920635
1841,Vila Mariana,31,1,1,1,2420,528,2948,95.09677
1842,Vila Leopoldina,117,4,2,2,6000,1300,7300,62.39316
1843,Moema,70,2,3,2,4500,830,5330,76.14286
1844,Pinheiros,49,1,2,1,2500,772,3272,66.77551
1845,Jardim Paulista,296,4,4,3,11000,4372,15372,51.932434
1846,Butantã,68,3,2,1,1300,850,2150,31.617647
1847,Outro,81,3,2,3,2600,1000,3600,44.444443
1848,Outro,28,1,1,0,1100,100,1200,42.857143
1849,Outro,52,2,1,1,1200,317,1517,29.173077
1850,Brooklin,40,1,1,1,2300,500,2800,70.0
1851,Outro,50,2,1,0,1300,0,1300,26.0
1852,Outro,100,3,3,2,3900,1100,5000,50.0
1853,Campo Belo,73,2,2,2,4000,980,4980,68.21918
1854,Consolação,35,1,1,1,2200,650,2850,81.42857
1855,Pinheiros,62,2,2,1,4500,950,5450,87.90323
1856,Outro,68,3,2,1,1600,500,2100,30.882353
1857,Vila Anastácio,103,3,3,2,4800,1076,5876,57.048542
1858,Alto Da Boa Vista,35,1,1,1,1850,695,2545,72.71429
1859,Vila Romana,101,2,3,2,4990,868,5858,58.0
1860,Vila Clementino,75,2,2,1,2700,990,3690,49.2
1861,Vila Sônia,82,3,2,2,2450,850,3300,40.243904
1862,Vila Clementino,90,3,2,1,2900,1355,4255,47.27778
1863,Moema,70,2,2,1,2400,700,3100,44.285713
1864,Vila Olímpia,100,2,4,2,5500,1340,6840,68.4
1865,Vila Nova Conceição,93,2,2,1,2300,980,3280,35.268818
1866,Outro,44,2,1,1,1600,225,1825,41.477272
1867,Jardim Marajoara,50,2,1,1,1670,550,2220,44.4
1868,Campo Belo,216,4,4,4,18000,2800,20800,96.296295
1869,Tatuapé,55,2,1,1,1200,659,1859,33.8
1870,Itaim Bibi,71,2,2,2,4950,1053,6003,84.54929
1871,Mirandópolis,55,1,1,0,1900,0,1900,34.545456
1872,Bela Vista,47,1,1,1,2300,567,2867,61.0
1873,Santa Cecília,67,2,2,1,2700,730,3430,51.19403
1874,Outro,70,2,2,1,2000,760,2760,39.42857
1875,Brás,60,2,1,0,1400,400,1800,30.0
1876,Saúde,60,2,2,2,2300,871,3171,52.85
1877,Alto de Pinheiros,130,4,3,1,4500,1500,6000,46.153847
1878,Outro,20,1,1,0,1220,40,1260,63.0
1879,Jardim Paulista,105,2,3,1,2800,1911,4711,44.866665
1880,Pinheiros,86,3,2,1,3000,1264,4264,49.581394
1881,Outro,48,2,1,1,1650,350,2000,41.666668
1882,Vila Olímpia,43,1,1,2,2000,800,2800,65.11628
1883,Pinheiros,110,3,3,1,3400,1610,5010,45.545456
1884,Vila Buarque,37,1,1,1,2145,305,2450,66.21622
1885,Santo Amaro,65,2,1,1,2790,490,3280,50.46154
1886,Outro,65,2,1,1,1850,0,1850,28.461538
1887,Jardim Paulista,225,3,4,3,10000,2050,12050,53.555557
1888,Aclimação,74,2,2,1,2350,750,3100,41.89189
1889,Jardins,98,3,3,1,3500,995,4495,45.867348
1890,Alto da Lapa,68,2,2,2,2800,1120,3920,57.64706
1891,Ipiranga,83,2,2,1,2500,863,3363,40.518074
1892,Outro,68,3,2,2,1600,840,2440,35.882355
1893,Campo Belo,51,1,1,1,3500,0,3500,68.62745
1894,Chácara Inglesa,84,3,2,2,2900,800,3700,44.04762
1895,Butantã,44,2,1,1,3500,500,4000,90.90909
1896,Chácara Klabin,75,3,2,1,2000,925,2925,39.0
1897,Moema,70,2,2,1,2500,700,3200,45.714287
1898,Água Branca,128,3,4,2,7300,1200,8500,66.40625
1899,Outro,57,2,2,1,1841,659,2500,43.85965
1900,Barra Funda,90,3,2,1,2600,750,3350,37.22222
1901,Vila Nova Conceição,104,1,2,2,10900,1400,12300,118.26923
1902,Outro,127,3,5,3,2540,1400,3940,31.023623
1903,Perdizes,56,1,2,2,2300,917,3217,57.44643
1904,Outro,47,2,1,0,1000,25,1025,21.80851
1905,Bela Vista,67,2,2,1,2500,727,3227,48.16418
1906,Cambuci,50,1,1,1,1100,316,1416,28.32
1907,Chácara Santo Antônio,100,2,2,2,3800,952,4752,47.52
1908,Moema,94,2,4,2,3000,1977,4977,52.946808
1909,Bela Vista,51,2,2,1,2950,800,3750,73.52941
1910,Saúde,58,2,2,1,1650,780,2430,41.896553
1911,Bela Vista,103,3,2,1,3500,1085,4585,44.514565
1912,Saúde,28,1,1,1,1300,330,1630,58.214287
1913,Vila Olímpia,76,2,1,1,2900,0,2900,38.157894
1914,Moema,110,3,4,2,6300,1200,7500,68.181816
1915,Aclimação,142,3,5,3,7000,1650,8650,60.915493
1916,Jardim América,143,3,2,1,5000,2143,7143,49.95105
1917,Jardins,35,1,1,1,1800,1200,3000,85.71429
1918,Vila Clementino,60,2,2,1,1600,1193,2793,46.55
1919,Bela Vista,28,1,1,1,1300,1000,2300,82.14286
1920,Santa Cecília,40,1,1,1,1850,545,2395,59.875
1921,Liberdade,44,1,1,1,1850,660,2510,57.045456
1922,Vila Mariana,43,1,1,1,1680,551,2231,51.88372
1923,Barra Funda,70,3,2,1,2600,542,3142,44.885715
1924,Água Branca,90,2,1,0,2300,450,2750,30.555555
1925,Outro,72,2,1,2,1300,100,1400,19.444445
1926,Outro,72,3,2,1,2000,670,2670,37.083332
1927,Moema,65,2,2,2,3400,850,4250,65.38461
1928,Outro,141,4,2,2,1400,1794,3194,22.652483
1929,Santana,80,2,2,1,1700,405,2105,26.3125
1930,Pompeia,60,2,2,1,2200,896,3096,51.6
1931,Vila Madalena,153,3,6,3,6000,2256,8256,53.960785
1932,Outro,60,2,1,1,2000,433,2433,40.55
1933,Jardins,65,2,2,2,5800,1100,6900,106.15385
1934,Freguesia do Ó,83,2,2,2,2500,550,3050,36.746986
1935,Moema,107,3,3,1,4500,1030,5530,51.682243
1936,Vila Mariana,40,1,1,1,1900,447,2347,58.675
1937,Outro,38,2,1,1,1650,332,1982,52.157894
1938,Morumbi,70,3,2,1,1751,823,2574,36.771427
1939,Tatuapé,90,3,2,2,3800,839,4639,51.544445
1940,Vila Leopoldina,60,2,2,1,2700,540,3240,54.0
1941,Saúde,100,3,3,2,3000,1129,4129,41.29
1942,Santana,25,1,1,0,1000,0,1000,40.0
1943,Butantã,13,1,1,0,1220,1000,2220,170.76923
1944,Cerqueira César,125,3,4,1,6000,2706,8706,69.648
1945,Moema,200,3,5,3,12000,3000,15000,75.0
1946,Itaim Bibi,130,3,3,0,7500,2249,9749,74.99231
1947,Vila Clementino,56,2,2,2,3800,1099,4899,87.48214
1948,Campo Belo,75,2,3,1,3790,964,4754,63.386665
1949,Consolação,80,2,2,1,2490,879,3369,42.1125
1950,Móoca,80,3,2,1,2000,550,2550,31.875
1951,Vila Mascote,58,2,1,1,1800,700,2500,43.103447
1952,Perdizes,65,2,2,1,2000,695,2695,41.46154
1953,Itaim Bibi,87,2,2,1,4000,730,4730,54.367817
1954,Pinheiros,35,1,1,1,4500,494,4994,142.68571
1955,Pinheiros,44,1,1,1,2900,780,3680,83.63636
1956,Itaim Bibi,115,3,3,1,4300,1116,5416,47.095654
1957,Vila Mariana,53,2,1,1,3599,451,4050,76.41509
1958,Jardins,41,1,1,1,2100,900,3000,73.17073
1959,Outro,50,2,1,1,1200,600,1800,36.0
1960,Vila Nova Conceição,465,5,7,6,50100,8344,58444,125.68602
1961,Outro,58,2,1,1,1287,206,1493,25.741379
1962,Outro,69,3,2,1,2200,490,2690,38.985508
1963,Jardim Prudência,63,2,2,1,2900,630,3530,56.031746
1964,Brás,50,2,1,1,1380,450,1830,36.6
1965,Campo Belo,161,4,3,3,10000,1593,11593,72.00621
1966,Outro,71,3,2,2,2400,945,3345,47.112675
1967,Higienópolis,41,1,1,1,2600,788,3388,82.63415
1968,Centro,30,1,1,0,2000,0,2000,66.666664
1969,Moema,90,3,2,1,3900,895,4795,53.27778
1970,Perdizes,62,2,2,2,3000,720,3720,60.0
1971,Cerqueira César,60,2,1,1,3200,0,3200,53.333332
1972,Campo Belo,160,3,5,3,4300,2225,6525,40.78125
1973,Vila Clementino,53,1,1,1,1900,630,2530,47.735847
1974,Alto de Pinheiros,128,4,5,2,5100,1280,6380,49.84375
1975,Vila Nova Conceição,80,3,3,2,3500,1467,4967,62.0875
1976,Moema,220,3,5,4,13990,2975,16965,77.11364
1977,Vila Olímpia,52,2,1,1,2800,850,3650,70.19231
1978,Moema,40,1,1,1,3100,850,3950,98.75
1979,Outro,50,2,1,1,1600,500,2100,42.0
1980,Jardim Paulista,50,2,1,1,2600,837,3437,68.74
1981,Pirituba,45,2,1,0,850,302,1152,25.6
1982,Brooklin,44,1,1,1,3585,585,4170,94.77273
1983,Jardim Paulista,48,1,1,1,3500,0,3500,72.916664
1984,Brooklin,80,2,2,2,5650,800,6450,80.625
1985,Pinheiros,40,1,1,0,2100,202,2302,57.55
1986,Bela Vista,57,2,2,1,3500,552,4052,71.08772
1987,Outro,136,3,4,2,4200,2450,6650,48.89706
1988,Pinheiros,72,2,2,1,2700,960,3660,50.833332
1989,Vila Nova Conceição,212,3,6,4,12500,4568,17068,80.50944
1990,Jardins,151,3,4,3,12000,3000,15000,99.337746
1991,Moema,205,4,5,3,10000,4563,14563,71.039024
1992,Itaim Bibi,38,1,1,1,4114,821,4935,129.86842
1993,Outro,70,2,1,1,1350,550,1900,27.142857
1994,Pinheiros,95,3,3,2,3500,1214,4714,49.62105
1995,Jardim Paulista,200,4,5,2,6900,1489,8389,41.945
1996,Bela Vista,150,3,3,1,5000,1200,6200,41.333332
1997,Bela Vista,50,1,1,1,3500,850,4350,87.0
1998,Pinheiros,100,2,3,0,2800,510,3310,33.1
1999,Bela Vista,34,1,1,1,1300,1100,2400,70.588234
2000,Outro,62,3,2,1,1700,480,2180,35.16129
2001,Outro,30,1,1,0,550,334,884,29.466667
2002,Outro,80,2,2,1,2000,1071,3071,38.3875
2003,Vila Buarque,32,1,1,0,2100,338,2438,76.1875
2004,Centro,70,1,1,0,1000,571,1571,22.442858
2005,Moema,67,1,2,2,5000,830,5830,87.01492
2006,Consolação,40,1,1,1,2000,620,2620,65.5
2007,Liberdade,61,2,1,1,1100,900,2000,32.786884
2008,Ipiranga,153,3,4,3,5500,1250,6750,44.117645
2009,Vila Clementino,66,2,2,1,3500,973,4473,67.77273
2010,Brooklin,200,4,4,3,5900,2100,8000,40.0
2011,Outro,74,2,2,1,3900,469,4369,59.04054
2012,Aclimação,170,3,5,3,8500,1545,10045,59.088234
2013,Vila Mariana,34,1,1,1,2513,1500,4013,118.02941
2014,Pompeia,96,2,2,2,4000,1331,5331,55.53125
2015,Jaguaré,70,3,2,2,2400,600,3000,42.857143
2016,Outro,65,2,1,1,1950,733,2683,41.276924
2017,Outro,52,2,1,1,900,600,1500,28.846153
2018,Jardim Paulista,86,2,1,0,1800,886,2686,31.232557
2019,Vila Uberabinha,66,2,1,1,2100,936,3036,46.0
2020,Brooklin,127,3,5,4,7500,1250,8750,68.89764
2021,Moema,140,4,4,2,5500,1672,7172,51.228573
2022,Vila Madalena,70,2,2,1,4200,900,5100,72.85714
2023,Brooklin,111,2,4,2,7000,1200,8200,73.87387
2024,Brooklin,94,3,2,2,3500,1020,4520,48.085106
2025,Outro,40,2,1,0,1350,80,1430,35.75
2026,Santa Cecília,160,3,3,3,7200,1650,8850,55.3125
2027,Vila Olímpia,25,1,1,1,2600,520,3120,124.8
2028,Higienópolis,40,1,1,1,2500,750,3250,81.25
2029,Vila Andrade,79,2,3,2,3650,700,4350,55.06329
2030,Santana,70,3,2,1,1700,700,2400,34.285713
2031,Outro,42,2,1,0,1450,0,1450,34.52381
2032,Chácara Santo Antônio,95,3,4,2,6200,680,6880,72.42105
2033,Morumbi,34,1,1,1,1300,500,1800,52.941177
2034,Tatuapé,52,2,1,1,2400,0,2400,46.153847
2035,Pinheiros,80,2,2,2,4500,885,5385,67.3125
2036,Consolação,75,2,1,0,1850,740,2590,34.533333
2037,Vila Formosa,66,2,2,1,2257,650,2907,44.045456
2038,Consolação,70,2,2,1,6500,800,7300,104.28571
2039,Vila Madalena,68,2,2,1,4500,600,5100,75.0
2040,Outro,160,3,5,3,12000,2040,14040,87.75
2041,Chácara Santo Antônio,38,1,1,1,2100,380,2480,65.26316
2042,Vila Olímpia,95,2,3,2,8000,1088,9088,95.663155
2043,Bom Retiro,58,2,2,1,2000,437,2437,42.017242
2044,Bela Vista,35,1,1,1,1700,400,2100,60.0
2045,Vila Mariana,86,2,2,1,2000,956,2956,34.372093
2046,Outro,67,3,1,1,1500,364,1864,27.820896
2047,Santa Ifigênia,60,1,1,0,1200,697,1897,31.616667
2048,Moema,42,1,1,1,1720,580,2300,54.761906
2049,Vila Mascote,64,2,2,2,2800,645,3445,53.828125
2050,Outro,49,2,1,1,1500,430,1930,39.387756
2051,Alto Da Boa Vista,233,4,4,3,8000,1894,9894,42.46352
2052,Barra Funda,65,2,2,1,2100,680,2780,42.76923
2053,Outro,69,3,2,1,1450,450,1900,27.536232
2054,Móoca,74,2,1,0,1400,760,2160,29.18919
2055,Bela Vista,70,2,1,0,2600,400,3000,42.857143
2056,Vila Uberabinha,80,3,3,2,5200,890,6090,76.125
2057,Campo Belo,110,2,4,3,4500,1700,6200,56.363636
2058,Vila Clementino,58,2,1,1,3800,740,4540,78.27586
2059,Vila Olímpia,70,2,2,1,2200,950,3150,45.0
2060,Vila Olímpia,46,1,1,1,3500,800,4300,93.478264
2061,Pinheiros,50,1,2,1,2300,1043,3343,66.86
2062,Moema,45,1,2,1,2600,540,3140,69.77778
2063,Lapa,63,3,2,1,2000,465,2465,39.126984
2064,Indianópolis,199,3,4,3,6550,1700,8250,41.457287
2065,Outro,51,2,1,1,1600,0,1600,31.37255
2066,Vila Clementino,60,2,2,1,2000,498,2498,41.633335
2067,Campo Belo,220,4,6,3,12000,1801,13801,62.73182
2068,Outro,72,2,2,2,4000,750,4750,65.97222
2069,Outro,97,3,2,2,2300,1018,3318,34.206184
2070,Vila Mariana,62,2,1,1,2500,817,3317,53.5
2071,Consolação,35,1,1,1,1600,509,2109,60.25714
2072,Móoca,300,5,6,4,8000,2711,10711,35.703335
2073,Outro,250,3,4,3,6000,3796,9796,39.184
2074,Santa Cecília,40,2,2,1,2000,502,2502,62.55
2075,Brooklin,45,1,1,1,2000,870,2870,63.77778
2076,Pinheiros,52,1,1,0,1750,685,2435,46.826923
2077,Itaim Bibi,90,2,1,1,3400,1138,4538,50.422222
2078,Vila Andrade,48,2,1,1,2200,430,2630,54.791668
2079,Outro,50,2,1,1,1400,150,1550,31.0
2080,Outro,35,1,1,0,1200,0,1200,34.285713
2081,Aclimação,39,1,1,1,2260,530,2790,71.53846
2082,Outro,70,2,2,1,2500,723,3223,46.04286
2083,Outro,75,2,2,1,3200,650,3850,51.333332
2084,Jardim América,160,2,4,2,8000,2000,10000,62.5
2085,Mirandópolis,67,2,2,0,1700,1050,2750,41.044777
2086,Vila Andrade,58,2,1,1,2495,735,3230,55.689655
2087,Jardim Paulista,89,1,2,2,7000,600,7600,85.39326
2088,Jardim Anália Franco,125,3,4,3,4500,1300,5800,46.4
2089,Jardim Anália Franco,168,3,3,3,2600,1539,4139,24.636906
2090,Vila Madalena,96,3,2,1,2700,1194,3894,40.5625
2091,Itaim Bibi,130,4,4,3,5500,2300,7800,60.0
2092,Bela Vista,40,1,1,1,2400,440,2840,71.0
2093,Vila Mascote,92,3,3,2,4900,1020,5920,64.347824
2094,Cidade Monções,64,2,2,1,1680,650,2330,36.40625
2095,Brooklin,38,1,1,1,3400,560,3960,104.210526
2096,Outro,45,1,1,0,999,100,1099,24.422222
2097,Barra Funda,34,1,1,1,1900,400,2300,67.64706
2098,Aclimação,85,3,3,0,3000,830,3830,45.058823
2099,Vila Nova Conceição,234,3,3,4,28000,2025,30025,128.31197
2100,Bela Vista,65,2,1,0,1800,100,1900,29.23077
2101,Móoca,44,1,1,0,1150,280,1430,32.5
2102,Pinheiros,90,2,2,1,3300,1000,4300,47.77778
2103,Pinheiros,90,3,3,2,5200,1300,6500,72.22222
2104,Vila Olímpia,80,2,2,2,2600,1009,3609,45.1125
2105,Higienópolis,32,1,1,1,1200,780,1980,61.875
2106,Vila Andrade,38,1,1,1,2400,0,2400,63.157894
2107,Outro,66,3,1,1,1300,502,1802,27.30303
2108,Vila Prudente,69,3,2,1,2500,460,2960,42.898552
2109,Vila Olímpia,216,3,5,4,27000,4345,31345,145.11574
2110,Brooklin,80,2,2,1,4450,1590,6040,75.5
2111,Campo Belo,40,1,1,1,2100,600,2700,67.5
2112,Itaim Bibi,100,2,2,2,12000,2400,14400,144.0
2113,Butantã,65,2,2,1,1900,700,2600,40.0
2114,Campo Belo,216,4,4,4,17000,2650,19650,90.97222
2115,Vila Sônia,80,3,3,1,3000,475,3475,43.4375
2116,Móoca,61,3,1,1,2100,400,2500,40.98361
2117,Moema,92,2,2,2,4700,1042,5742,62.413044
2118,Sumaré,100,2,2,1,2600,1150,3750,37.5
2119,Vila Prudente,30,1,1,0,1400,410,1810,60.333332
2120,Higienópolis,45,1,1,1,1900,720,2620,58.22222
2121,Saúde,51,2,1,1,1200,907,2107,41.313725
2122,Vila Olímpia,95,1,1,2,9500,2176,11676,122.905266
2123,Vila Romana,30,1,1,1,2200,320,2520,84.0
2124,Pinheiros,35,1,1,1,3400,460,3860,110.28571
2125,Saúde,167,4,4,2,4500,1600,6100,36.526947
2126,Brooklin,125,3,4,4,2500,1914,4414,35.312
2127,Outro,65,2,2,1,1000,800,1800,27.692308
2128,Alto da Lapa,138,3,2,3,5400,900,6300,45.652172
2129,Cambuci,45,2,1,0,1750,275,2025,45.0
2130,Moema,44,1,1,1,2200,582,2782,63.227272
2131,Jardim Paulista,60,1,1,1,2500,694,3194,53.233334
2132,Bela Vista,45,1,1,1,1700,602,2302,51.155556
2133,Bela Vista,40,1,1,1,1500,675,2175,54.375
2134,Itaim Bibi,160,2,2,2,27247,1836,29083,181.76875
2135,Vila Gomes Cardim,84,3,2,1,2500,800,3300,39.285713
2136,Bom Retiro,60,2,2,1,2600,432,3032,50.533333
2137,Santa Cecília,80,2,2,0,2300,1288,3588,44.85
2138,Jardim Paulista,127,2,2,1,2700,1900,4600,36.220474
2139,Outro,45,2,1,0,1200,50,1250,27.777779
2140,Bela Vista,25,1,1,0,1100,257,1357,54.28
2141,Aclimação,75,3,2,2,3700,980,4680,62.4
2142,Cambuci,39,1,1,1,2260,530,2790,71.53846
2143,Aclimação,40,1,1,1,1800,758,2558,63.95
2144,Pinheiros,57,1,1,1,4800,781,5581,97.91228
2145,Vila Leopoldina,172,3,4,3,6500,1850,8350,48.546513
2146,Chácara Santo Antônio,64,2,2,1,2500,1100,3600,56.25
2147,Higienópolis,32,1,1,0,3300,500,3800,118.75
2148,Vila Romana,30,1,1,1,2250,320,2570,85.666664
2149,Vila Leopoldina,87,3,2,2,3500,458,3958,45.49425
2150,Moema,35,1,1,1,1700,642,2342,66.91428
2151,Moema,42,1,1,1,2000,800,2800,66.666664
2152,Santa Cecília,70,2,1,1,2300,616,2916,41.657143
2153,Bela Vista,70,2,2,1,2300,772,3072,43.885715
2154,Vila Nova Conceição,50,1,2,2,3639,1400,5039,100.78
2155,Campo Belo,50,1,1,1,1500,650,2150,43.0
2156,Brooklin,126,3,5,2,5550,1044,6594,52.333332
2157,Tatuapé,30,1,1,0,1100,100,1200,40.0
2158,Perdizes,221,4,6,4,11000,2510,13510,61.13122
2159,Bela Vista,55,1,1,1,3500,586,4086,74.29091
2160,Bela Vista,36,1,1,0,2000,800,2800,77.77778
2161,Vila Mariana,45,1,1,1,2808,621,3429,76.2
2162,Outro,97,3,4,1,2800,750,3550,36.59794
2163,Brooklin,80,2,2,2,5650,800,6450,80.625
2164,Saúde,58,2,2,1,1600,970,2570,44.310345
2165,Pinheiros,60,2,2,1,1800,1145,2945,49.083332
2166,Jardim Prudência,69,3,1,1,2000,688,2688,38.95652
2167,Moema,50,2,1,1,2500,0,2500,50.0
2168,Cerqueira César,55,2,2,1,2100,630,2730,49.636364
2169,Vila Olímpia,40,1,1,1,2300,600,2900,72.5
2170,Jardim Paulista,58,2,1,0,2000,116,2116,36.482758
2171,Outro,96,3,1,1,1600,740,2340,24.375
2172,Consolação,38,1,1,1,2500,537,3037,79.92105
2173,Água Branca,176,3,5,4,8500,2030,10530,59.829544
2174,Outro,47,2,1,1,1200,0,1200,25.531916
2175,Vila Olímpia,66,2,3,1,2200,1190,3390,51.363636
2176,Outro,55,2,2,1,2000,430,2430,44.18182
2177,Itaim Bibi,90,2,3,1,3900,1530,5430,60.333332
2178,Vila Andrade,100,3,2,2,2990,948,3938,39.38
2179,Vila Andrade,50,2,1,1,1950,330,2280,45.6
2180,Outro,40,1,1,0,1300,250,1550,38.75
2181,Pirituba,49,2,1,1,1200,647,1847,37.69388
2182,Itaim Bibi,181,4,5,3,12000,1750,13750,75.96685
2183,Vila Madalena,82,2,2,1,3100,1231,4331,52.817074
2184,Pinheiros,30,1,1,1,2400,940,3340,111.333336
2185,Bela Vista,39,1,1,1,2400,480,2880,73.84615
2186,Brooklin,84,2,3,2,6800,1176,7976,94.95238
2187,Vila Mascote,108,3,2,2,4500,1000,5500,50.925926
2188,Aclimação,46,2,1,1,1799,461,2260,49.130436
2189,Morumbi,87,2,2,2,3300,666,3966,45.58621
2190,Perdizes,153,4,5,3,6500,1700,8200,53.594772
2191,Moema,80,3,2,1,3600,810,4410,55.125
2192,Alto Da Boa Vista,45,1,1,1,2200,450,2650,58.88889
2193,Campos Eliseos,44,1,1,1,1200,740,1940,44.090908
2194,Vila Mascote,147,3,5,2,5000,1150,6150,41.836735
2195,Brooklin,124,2,3,2,7000,1200,8200,66.129036
2196,Campo Belo,160,3,4,3,5300,2115,7415,46.34375
2197,Outro,100,3,2,1,2100,860,2960,29.6
2198,Brooklin,37,1,1,1,2000,800,2800,75.675674
2199,Bela Vista,77,2,1,2,4900,600,5500,71.42857
2200,Vila Clementino,27,1,1,0,2100,740,2840,105.18519
2201,Santa Cecília,70,2,1,0,2000,564,2564,36.62857
2202,Perdizes,40,1,1,1,2500,800,3300,82.5
2203,Tatuapé,74,2,2,1,4500,450,4950,66.89189
2204,Lapa,48,2,1,1,2150,353,2503,52.145832
2205,Outro,58,2,1,2,900,580,1480,25.51724
2206,Outro,74,3,1,1,2500,500,3000,40.54054
2207,Moema,70,1,1,1,3000,836,3836,54.8
2208,Vila Olímpia,40,1,1,1,2500,413,2913,72.825
2209,Moema,64,2,2,1,2400,1410,3810,59.53125
2210,Santo Amaro,65,1,1,1,2700,615,3315,51.0
2211,Pinheiros,92,3,3,2,2990,1050,4040,43.913044
2212,Chácara Santo Antônio,70,2,2,1,2200,800,3000,42.857143
2213,Outro,75,2,2,1,1100,600,1700,22.666666
2214,Panamby,129,2,3,2,3500,1170,4670,36.20155
2215,Santo Amaro,178,3,3,2,4500,1773,6273,35.241573
2216,Chácara Klabin,31,1,1,1,2420,528,2948,95.09677
2217,Jardim Paulista,85,1,1,1,3000,1418,4418,51.97647
2218,Moema,48,1,1,1,2000,765,2765,57.604168
2219,Itaim Bibi,223,3,5,4,30000,3060,33060,148.25111
2220,Pinheiros,24,1,1,1,1800,500,2300,95.833336
2221,Brás,72,3,2,1,2300,707,3007,41.76389
2222,Vila Guarani,102,2,1,1,2000,510,2510,24.607843
2223,Vila Madalena,188,3,4,3,11000,2000,13000,69.14893
2224,Vila Leopoldina,62,2,1,1,2000,800,2800,45.16129
2225,Brooklin,45,1,1,1,2490,750,3240,72.0
2226,Bela Vista,33,1,1,1,2000,395,2395,72.57576
2227,Móoca,206,4,5,4,8900,1714,10614,51.524273
2228,Tatuapé,65,2,1,2,2100,578,2678,41.2
2229,Chácara Inglesa,97,3,4,2,3449,830,4279,44.113403
2230,Pinheiros,83,1,1,2,5500,950,6450,77.710846
2231,Pinheiros,65,2,2,1,4200,832,5032,77.41538
2232,Brooklin,82,1,2,2,6800,600,7400,90.243904
2233,Centro,160,3,2,0,2300,948,3248,20.3
2234,Vila Olímpia,100,3,2,1,1800,1420,3220,32.2
2235,Jardim América,150,3,5,4,15000,3824,18824,125.49333
2236,Higienópolis,90,3,3,2,4100,1338,5438,60.422222
2237,Pinheiros,70,1,2,2,5500,1774,7274,103.91428
2238,Vila Olímpia,30,1,1,1,2700,700,3400,113.333336
2239,Bom Retiro,80,2,1,0,1600,830,2430,30.375
2240,Paraíso,56,2,1,1,2900,1129,4029,71.94643
2241,Pinheiros,100,2,1,1,2100,950,3050,30.5
2242,Santana,76,2,2,1,2000,960,2960,38.94737
2243,Itaim Bibi,87,3,2,0,3000,656,3656,42.022987
2244,Perdizes,43,1,1,1,1500,665,2165,50.34884
2245,Jardim Prudência,70,2,2,1,1800,620,2420,34.57143
2246,Cidade Monções,75,2,2,1,5600,1100,6700,89.333336
2247,Jardim Prudência,57,2,2,1,2400,580,2980,52.2807
2248,Pinheiros,60,2,2,1,4500,805,5305,88.416664
2249,Perdizes,155,4,5,3,8000,2130,10130,65.354836
2250,Vila Mascote,60,2,2,1,2100,608,2708,45.133335
2251,Vila Mariana,62,2,2,1,2300,629,2929,47.241936
2252,Saúde,28,1,1,0,1600,120,1720,61.42857
2253,Barra Funda,65,2,2,1,3000,580,3580,55.076923
2254,Moema,76,2,2,1,2800,810,3610,47.5
2255,Vila Gomes Cardim,106,4,2,2,2600,1250,3850,36.320755
2256,Vila Nova Conceição,45,1,1,1,2559,1493,4052,90.04444
2257,Moema,190,4,2,2,6300,1800,8100,42.63158
2258,Bela Vista,60,2,2,1,2900,540,3440,57.333332
2259,Perdizes,93,2,3,2,5000,750,5750,61.827957
2260,Vila Mariana,58,2,2,1,1700,867,2567,44.25862
2261,Vila Leopoldina,114,3,3,2,4500,1200,5700,50.0
2262,Pinheiros,90,2,1,0,3500,120,3620,40.22222
2263,Vila Clementino,82,2,3,1,1800,1300,3100,37.80488
2264,Outro,34,2,1,0,1050,180,1230,36.17647
2265,Bela Vista,36,1,1,1,2100,450,2550,70.833336
2266,Panamby,715,4,5,9,50000,8900,58900,82.377625
2267,Brooklin,147,3,5,3,7000,1573,8573,58.31973
2268,Itaim Bibi,55,1,1,1,7400,1100,8500,154.54546
2269,Jardins,48,1,1,1,4500,1200,5700,118.75
2270,Jardim Marajoara,92,3,1,2,3500,772,4272,46.434784
2271,Água Branca,40,1,1,1,2000,354,2354,58.85
2272,Ipiranga,87,1,2,1,2200,1100,3300,37.931034
2273,Perdizes,124,2,4,3,6500,1300,7800,62.903225
2274,Jardins,30,1,1,1,1700,700,2400,80.0
2275,Outro,95,2,3,2,4100,880,4980,52.42105
2276,Vila Prudente,64,2,2,1,1850,480,2330,36.40625
2277,Campo Belo,53,1,1,1,4700,450,5150,97.169815
2278,Vila Mariana,179,3,2,0,2500,479,2979,16.642458
2279,Outro,50,2,1,0,1200,0,1200,24.0
2280,Butantã,65,3,1,1,1700,547,2247,34.56923
2281,Outro,60,2,2,1,1690,557,2247,37.45
2282,Liberdade,18,1,1,0,950,260,1210,67.22222
2283,Perdizes,80,2,2,1,2500,980,3480,43.5
2284,Cambuci,72,2,2,0,2750,800,3550,49.305557
2285,Vila Olímpia,40,1,1,1,3800,400,4200,105.0
2286,Brooklin,108,3,1,1,3250,1491,4741,43.898148
2287,Moema,70,2,1,1,2700,1100,3800,54.285713
2288,Outro,54,1,1,1,1100,117,1217,22.537037
2289,Itaim Bibi,72,3,2,2,4400,1256,5656,78.55556
2290,Vila Olímpia,80,2,2,1,4500,1100,5600,70.0
2291,Outro,95,3,3,1,1800,1590,3390,35.68421
2292,Vila Olímpia,104,3,2,1,3200,960,4160,40.0
2293,Tatuapé,29,1,1,1,1600,385,1985,68.44827
2294,Outro,70,2,2,2,1600,765,2365,33.785713
2295,Chácara Inglesa,55,2,2,1,1850,867,2717,49.4
2296,Outro,22,1,1,0,2100,362,2462,111.90909
2297,Vila Mariana,64,2,2,1,2800,712,3512,54.875
2298,Jardim Paulista,209,4,3,2,11500,3340,14840,71.00478
2299,Outro,72,3,2,2,2300,505,2805,38.958332
2300,Saúde,47,1,1,1,1500,375,1875,39.893616
2301,Jardim Paulista,50,1,1,0,2200,0,2200,44.0
2302,Jaguaré,56,2,1,1,2000,516,2516,44.92857
2303,Vila Sônia,103,3,4,2,3400,870,4270,41.45631
2304,Pinheiros,67,2,2,2,3000,1050,4050,60.44776
2305,Moema,68,1,2,2,5000,958,5958,87.617645
2306,Pinheiros,43,1,1,1,3000,818,3818,88.790695
2307,Outro,10,2,1,0,1520,110,1630,163.0
2308,Moema,120,3,2,2,4500,1638,6138,51.15
2309,Itaim Bibi,98,2,2,2,12000,1800,13800,140.81633
2310,Brooklin,66,2,2,1,2500,835,3335,50.530304
2311,Tatuapé,65,2,2,1,1800,897,2697,41.49231
2312,Vila Sônia,54,2,1,1,2300,550,2850,52.77778
2313,Outro,78,3,2,2,3200,692,3892,49.897434
2314,Vila Clementino,65,2,2,1,2600,980,3580,55.076923
2315,Santa Cecília,208,2,2,2,5000,2100,7100,34.134617
2316,Higienópolis,236,3,4,2,4300,1950,6250,26.483051
2317,Barra Funda,82,2,2,1,4000,685,4685,57.134148
2318,Vila Nova Conceição,42,1,1,1,2300,1300,3600,85.71429
2319,Pinheiros,165,3,4,3,5500,1754,7254,43.963634
2320,Outro,60,2,2,1,3300,620,3920,65.333336
2321,Santana,60,2,1,2,1500,675,2175,36.25
2322,Panamby,130,3,5,2,4500,1500,6000,46.153847
2323,Santa Cecília,58,1,1,0,1200,442,1642,28.310345
2324,Outro,60,2,1,1,2000,700,2700,45.0
2325,Pinheiros,73,2,2,1,4000,740,4740,64.9315
2326,Pinheiros,153,3,3,1,3500,1400,4900,32.026142
2327,Vila Mariana,222,4,6,4,20000,2369,22369,100.76126
2328,Móoca,105,3,4,2,4200,880,5080,48.38095
2329,Vila Olímpia,80,1,2,2,9330,1680,11010,137.625
2330,Vila Clementino,65,2,1,1,2000,650,2650,40.76923
2331,Paraíso,110,2,1,1,2600,1278,3878,35.254547
2332,Centro,48,1,1,0,1090,327,1417,29.520834
2333,Campo Belo,49,1,1,1,2600,575,3175,64.79592
2334,Vila Andrade,91,3,3,3,2300,1425,3725,40.934067
2335,Pompeia,98,3,2,2,3450,900,4350,44.387756
2336,Vila Nova Conceição,86,3,3,2,3500,828,4328,50.32558
2337,Consolação,53,1,1,0,1350,613,1963,37.037735
2338,Outro,65,2,1,1,1500,507,2007,30.876923
2339,Brooklin,98,2,3,2,7800,1500,9300,94.89796
2340,Vila Nova Conceição,166,3,4,3,20000,2300,22300,134.33736
2341,Ipiranga,75,2,1,0,1790,70,1860,24.8
2342,República,36,1,1,0,1500,0,1500,41.666668
2343,Bom Retiro,90,2,1,0,1700,0,1700,18.88889
2344,Vila Mascote,80,3,2,1,4600,700,5300,66.25
2345,Saúde,40,2,2,1,2500,697,3197,79.925
2346,Chácara Santo Antônio,143,3,5,2,8000,988,8988,62.853146
2347,Campo Belo,86,2,2,2,4300,819,5119,59.523254
2348,Santana,115,3,3,2,3200,1383,4583,39.852173
2349,Outro,100,2,2,2,2300,430,2730,27.3
2350,Vila Mariana,72,2,2,2,4500,923,5423,75.31944
2351,Jardins,111,2,2,1,3500,1431,4931,44.423424
2352,Jabaquara,44,1,1,1,1150,275,1425,32.386364
2353,Itaim Bibi,83,2,2,1,4200,933,5133,61.843372
2354,Aclimação,55,1,1,1,1400,412,1812,32.945454
2355,Aclimação,57,2,2,1,1800,1024,2824,49.54386
2356,Vila Buarque,40,1,1,1,2800,400,3200,80.0
2357,República,30,1,1,1,2350,480,2830,94.333336
2358,Brooklin,50,1,1,1,750,2900,3650,73.0
2359,Morumbi,168,3,5,3,5000,1250,6250,37.20238
2360,Vila Nova Conceição,134,2,3,2,16000,1300,17300,129.10448
2361,Panamby,445,5,8,6,16500,7000,23500,52.80899
2362,Jardim Marajoara,310,4,6,4,13000,2947,15947,51.441936
2363,Pinheiros,75,2,3,1,3100,788,3888,51.84
2364,Vila Mascote,42,1,1,1,2200,500,2700,64.28571
2365,Campo Belo,45,1,1,1,2500,540,3040,67.55556
2366,Outro,100,2,3,2,3800,1100,4900,49.0
2367,Aclimação,52,1,1,0,1800,645,2445,47.01923
2368,Santo Amaro,45,1,1,1,2200,380,2580,57.333332
2369,Vila Nova Conceição,173,3,3,3,10500,3607,14107,81.54335
2370,Bom Retiro,30,1,1,1,1500,608,2108,70.26667
2371,Chácara Inglesa,104,3,3,2,3500,1060,4560,43.846153
2372,Jaguaré,70,3,2,2,2499,600,3099,44.271427
2373,Cidade Monções,56,1,1,1,3500,880,4380,78.21429
2374,Itaim Bibi,50,1,1,1,2000,850,2850,57.0
2375,Outro,70,1,1,2,3000,550,3550,50.714287
2376,Jardim Paulista,80,3,4,1,4000,1574,5574,69.675
2377,Outro,49,2,1,1,1350,188,1538,31.387754
2378,Vila Mariana,45,1,1,1,3600,0,3600,80.0
2379,Brooklin,112,2,3,3,7000,2000,9000,80.35714
2380,Santana,51,2,2,1,1950,644,2594,50.862743
2381,Outro,96,3,3,2,3400,900,4300,44.791668
2382,Vila Nova Conceição,70,1,2,2,5500,1200,6700,95.71429
2383,Vila Olímpia,65,2,2,1,3400,874,4274,65.753845
2384,Cidade Monções,70,1,1,1,4500,800,5300,75.71429
2385,Morumbi,46,1,1,1,1400,900,2300,50.0
2386,Campo Belo,82,2,3,1,2700,1150,3850,46.951218
2387,Pompeia,36,1,1,1,2000,530,2530,70.27778
2388,Outro,115,3,2,3,3600,1170,4770,41.47826
2389,Higienópolis,144,3,3,1,4000,1650,5650,39.23611
2390,Moema,50,1,1,1,550,2700,3250,65.0
2391,Cidade Monções,53,1,1,1,3740,640,4380,82.64151
2392,Outro,45,2,1,0,1000,0,1000,22.222221
2393,Consolação,42,1,2,1,2300,603,2903,69.11905
2394,Chácara Santo Antônio,95,3,2,2,4300,720,5020,52.842106
2395,Vila Clementino,62,2,2,1,2500,817,3317,53.5
2396,Vila Prudente,64,2,1,1,2000,480,2480,38.75
2397,Brooklin,111,3,3,2,7500,900,8400,75.675674
2398,Perdizes,117,3,4,2,4190,1625,5815,49.700855
2399,Pinheiros,140,3,3,2,8000,1420,9420,67.28571
2400,Pompeia,45,1,1,1,2000,450,2450,54.444443
2401,Campo Belo,73,2,2,1,2950,850,3800,52.054794
2402,Santa Cecília,40,1,1,1,2400,590,2990,74.75
2403,Moema,250,2,4,5,23000,3800,26800,107.2
2404,Vila Romana,162,3,5,3,10500,1650,12150,75.0
2405,Outro,39,2,1,0,1100,120,1220,31.282051
2406,Vila Gomes Cardim,57,1,1,1,2500,740,3240,56.842106
2407,Vila Cruzeiro,37,1,1,1,2100,512,2612,70.5946
2408,Aclimação,110,3,2,0,3000,490,3490,31.727272
2409,Perdizes,30,1,1,1,2000,620,2620,87.333336
2410,Jardim Paulista,160,3,4,2,5000,1704,6704,41.9
2411,Outro,68,2,2,1,1560,840,2400,35.294117
2412,Sumaré,80,2,2,1,2650,900,3550,44.375
2413,Vila Nova Conceição,65,2,1,1,1390,0,1390,21.384615
2414,Vila Mariana,70,2,2,1,2300,890,3190,45.57143
2415,Outro,260,4,4,4,11500,3192,14692,56.50769
2416,Vila Gomes Cardim,60,2,2,1,3200,650,3850,64.166664
2417,Outro,50,1,1,0,1070,291,1361,27.22
2418,Freguesia do Ó,50,2,1,1,1090,640,1730,34.6
2419,Mirandópolis,33,1,1,1,1600,645,2245,68.030304
2420,Vila Mariana,50,1,1,0,1300,261,1561,31.22
2421,Moema,37,1,1,1,2500,700,3200,86.48649
2422,Jardim América,195,4,4,2,5000,3146,8146,41.77436
2423,Vila Madalena,50,2,1,1,2000,336,2336,46.72
2424,Jardim Paulista,30,1,1,1,1460,1740,3200,106.666664
2425,Consolação,25,1,1,0,2200,287,2487,99.48
2426,Chácara Inglesa,90,2,2,2,4900,950,5850,65.0
2427,Higienópolis,50,2,2,1,2300,442,2742,54.84
2428,Pinheiros,73,2,2,1,5500,400,5900,80.821915
2429,Pinheiros,151,3,5,2,10900,1750,12650,83.77483
2430,Vila Olímpia,67,2,2,1,2900,904,3804,56.77612
2431,Campo Belo,76,1,2,0,4200,1000,5200,68.42105
2432,Barra Funda,70,3,2,1,2500,490,2990,42.714287
2433,Morumbi,72,3,2,2,2200,900,3100,43.055557
2434,Pinheiros,73,2,2,2,3900,1300,5200,71.23288
2435,Bela Vista,49,2,1,0,1600,721,2321,47.367348
2436,Vila Madalena,58,1,1,1,2800,622,3422,59.0
2437,Consolação,43,1,1,1,2300,450,2750,63.953487
2438,Outro,68,3,1,1,1500,431,1931,28.397058
2439,Outro,85,1,1,1,1300,607,1907,22.435293
2440,Outro,80,2,2,2,5650,800,6450,80.625
2441,Aclimação,40,1,1,1,1800,758,2558,63.95
2442,Perdizes,55,1,1,1,1800,577,2377,43.21818
2443,Outro,55,3,1,1,1050,509,1559,28.345455
2444,Outro,50,2,1,1,1700,593,2293,45.86
2445,Pompeia,75,3,3,2,3800,840,4640,61.866665
2446,Vila Mariana,55,2,1,1,3000,600,3600,65.454544
2447,Barra Funda,51,1,1,1,2500,762,3262,63.960785
2448,Cerqueira César,136,3,4,1,3500,1700,5200,38.235294
2449,Morumbi,75,2,2,2,2500,1100,3600,48.0
2450,Panamby,435,4,6,6,16500,6700,23200,53.333332
2451,Alto de Pinheiros,274,4,5,4,19000,4000,23000,83.941605
2452,Moema,67,2,2,1,2300,922,3222,48.089554
2453,Vila Leopoldina,138,3,2,2,6900,1300,8200,59.420288
2454,Pinheiros,105,3,3,2,10000,1400,11400,108.57143
2455,Bela Vista,67,2,3,2,3900,750,4650,69.402985
2456,Vila Olímpia,74,2,2,1,4600,850,5450,73.64865
2457,Morumbi,122,4,4,3,2400,1800,4200,34.42623
2458,Perdizes,45,2,1,1,1680,890,2570,57.11111
2459,Vila Romana,64,2,2,2,3800,650,4450,69.53125
2460,Lapa,94,3,2,2,4700,750,5450,57.97872
2461,Pinheiros,60,3,1,1,2400,383,2783,46.383335
2462,Saúde,57,2,2,1,2600,830,3430,60.175438
2463,Vila Andrade,66,2,2,1,3200,0,3200,48.484848
2464,Vila Olímpia,60,1,2,1,5000,1000,6000,100.0
2465,Outro,68,2,2,1,1300,549,1849,27.191177
2466,Itaim Bibi,40,1,1,1,4256,587,4843,121.075
2467,Cambuci,40,1,1,1,1200,600,1800,45.0
2468,Paraíso,102,3,3,1,3800,1266,5066,49.666668
2469,Brooklin,85,3,3,2,3300,870,4170,49.058823
2470,Granja Julieta,82,2,3,2,3990,605,4595,56.036587
2471,Outro,52,2,1,1,1050,460,1510,29.038462
2472,Pinheiros,105,2,2,2,7500,1400,8900,84.7619
2473,Jardim Paulista,540,4,6,3,29220,7720,36940,68.40741
2474,Paraíso,70,2,1,0,1900,510,2410,34.42857
2475,Brooklin,62,2,2,2,5000,980,5980,96.451614
2476,Brooklin,51,1,1,1,4100,770,4870,95.4902
2477,Moema,39,1,1,1,1900,668,2568,65.84615
2478,Campos Eliseos,70,2,1,1,1600,620,2220,31.714285
2479,Outro,130,3,3,2,5500,1150,6650,51.153847
2480,Chácara Inglesa,67,2,2,1,3400,720,4120,61.49254
2481,Centro,50,1,1,0,1550,500,2050,41.0
2482,Paraíso,102,3,3,2,12320,1400,13720,134.50981
2483,Campo Belo,130,2,4,3,6300,2050,8350,64.23077
2484,Vila Andrade,51,2,1,1,1910,371,2281,44.72549
2485,Vila Gomes Cardim,125,3,5,3,4000,950,4950,39.6
2486,Outro,48,2,1,1,1600,267,1867,38.895832
2487,Consolação,60,2,1,1,2700,723,3423,57.05
2488,Moema,200,4,5,4,10000,5900,15900,79.5
2489,Higienópolis,119,3,1,3,3000,1200,4200,35.294117
2490,Móoca,65,2,1,1,2400,509,2909,44.753845
2491,Campo Belo,41,1,1,1,2550,650,3200,78.04878
2492,Brooklin,51,1,1,1,3400,600,4000,78.43137
2493,Outro,65,3,2,1,2100,700,2800,43.076923
2494,Vila Nova Conceição,295,4,6,4,23000,7550,30550,103.55932
2495,Lapa,48,1,1,1,1900,365,2265,47.1875
2496,Santa Cecília,42,2,1,0,1300,385,1685,40.11905
2497,Vila Mascote,156,4,4,2,4100,1500,5600,35.897434
2498,Pinheiros,145,2,4,2,7500,1450,8950,61.724136
2499,Liberdade,62,1,1,0,1190,375,1565,25.241936
2500,Pinheiros,20,1,1,0,2000,0,2000,100.0
2501,Brooklin,45,1,1,1,3400,650,4050,90.0
2502,Vila Mariana,61,2,1,1,1550,1376,2926,47.967213
2503,Pompeia,77,3,2,1,2800,840,3640,47.272728
2504,Vila Madalena,100,3,3,2,2600,1140,3740,37.4
2505,Jardim Paulista,41,1,1,1,1400,1100,2500,60.97561
2506,Centro,134,2,1,0,2200,557,2757,20.574627
2507,Pirituba,48,2,1,1,1905,500,2405,50.104168
2508,Consolação,35,1,1,0,1500,470,1970,56.285713
2509,Vila Mascote,92,3,4,2,2500,1090,3590,39.02174
2510,Cerqueira César,30,1,1,0,1390,451,1841,61.366665
2511,Outro,79,2,2,1,5500,1000,6500,82.27848
2512,Vila Leopoldina,143,3,4,2,6200,1460,7660,53.566433
2513,Bela Vista,112,3,3,2,6000,1014,7014,62.625
2514,Chácara Santo Antônio,130,3,3,2,5250,1250,6500,50.0
2515,Campo Belo,51,1,1,1,3200,560,3760,73.72549
2516,Outro,52,2,1,1,1400,200,1600,30.76923
2517,Outro,72,3,1,1,1980,640,2620,36.38889
2518,Bela Vista,55,2,2,1,3600,900,4500,81.818184
2519,Jardins,380,4,5,5,70000,8900,78900,207.63158
2520,Vila Olímpia,93,3,3,2,9000,1121,10121,108.82796
2521,Moema,85,2,2,1,2300,1000,3300,38.82353
2522,Pinheiros,93,2,1,0,2500,400,2900,31.182796
2523,Consolação,35,1,1,1,2750,550,3300,94.28571
2524,Consolação,28,1,1,0,1950,450,2400,85.71429
2525,República,261,3,3,1,8540,4100,12640,48.42912
2526,Cerqueira César,32,1,1,0,2000,150,2150,67.1875
2527,Campo Belo,82,2,2,1,2000,1149,3149,38.40244
2528,Jardim América,75,2,1,0,2700,601,3301,44.013332
2529,Jardim Paulista,60,2,2,1,2900,1189,4089,68.15
2530,Pinheiros,95,3,4,2,3500,1219,4719,49.673683
2531,Vila Olímpia,65,2,2,1,2500,1200,3700,56.923077
2532,Sumaré,55,2,1,1,2100,515,2615,47.545456
2533,Vila Nova Conceição,226,4,2,4,22000,2960,24960,110.442474
2534,Outro,51,2,1,1,1127,273,1400,27.450981
2535,Vila Mariana,80,2,2,1,1700,700,2400,30.0
2536,Jardim Marajoara,92,3,1,2,3500,772,4272,46.434784
2537,Pinheiros,94,3,2,2,5000,1080,6080,64.680855
2538,Aclimação,34,1,1,1,1400,887,2287,67.26471
2539,Aclimação,48,1,2,1,3500,1088,4588,95.583336
2540,Indianópolis,108,3,2,1,4000,1080,5080,47.037037
2541,Perdizes,130,3,2,2,3900,1717,5617,43.20769
2542,Alto da Lapa,139,5,5,2,4900,1500,6400,46.043167
2543,Outro,70,2,1,1,2999,750,3749,53.557144
2544,Jardins,122,3,3,1,5000,1550,6550,53.688526
2545,Outro,94,2,3,2,3500,1280,4780,50.851063
2546,Chácara Inglesa,55,2,1,1,2009,907,2916,53.01818
2547,Ipiranga,140,4,3,2,3605,1315,4920,35.142857
2548,Bela Vista,48,1,1,1,2450,780,3230,67.291664
2549,Móoca,65,2,2,1,2100,631,2731,42.015385
2550,Morumbi,69,2,2,2,2000,1007,3007,43.579712
2551,Jabaquara,125,2,3,0,1900,250,2150,17.2
2552,Outro,76,3,2,2,1500,610,2110,27.763159
2553,Ipiranga,75,2,1,1,2220,0,2220,29.6
2554,Vila Leopoldina,52,1,1,1,1800,650,2450,47.115383
2555,Cerqueira César,45,1,1,1,2000,1300,3300,73.333336
2556,Vila Mariana,90,3,3,1,4000,750,4750,52.77778
2557,Moema,36,1,1,1,1600,539,2139,59.416668
2558,Sumaré,55,1,1,2,2600,1085,3685,67.0
2559,Paraíso,39,1,1,1,1700,875,2575,66.02564
2560,Jardim Paulista,113,2,3,2,7000,1395,8395,74.29204
2561,Vila Nova Conceição,226,4,4,4,22000,2962,24962,110.451324
2562,Consolação,70,2,1,1,1400,883,2283,32.614285
2563,Pinheiros,30,1,1,0,1700,856,2556,85.2
2564,Itaim Bibi,215,4,6,3,14000,2800,16800,78.139534
2565,Santana,70,3,2,1,1600,800,2400,34.285713
2566,Tatuapé,40,1,1,1,2800,460,3260,81.5
2567,Vila Nova Conceição,234,3,4,4,28000,2025,30025,128.31197
2568,Vila Leopoldina,35,1,1,0,1800,350,2150,61.42857
2569,Santo Amaro,53,1,1,1,1899,457,2356,44.45283
2570,Itaim Bibi,156,3,4,1,2800,1600,4400,28.205128
2571,Pinheiros,30,1,1,1,3000,550,3550,118.333336
2572,Outro,45,2,1,0,550,122,672,14.933333
2573,Perdizes,98,3,3,2,3600,1200,4800,48.97959
2574,Indianópolis,97,2,2,1,5400,0,5400,55.670105
2575,Barra Funda,95,2,1,0,2300,605,2905,30.578947
2576,Mirandópolis,60,1,1,1,1600,571,2171,36.183334
2577,Outro,51,1,1,1,3380,590,3970,77.84314
2578,Campo Belo,42,1,1,1,2600,546,3146,74.90476
2579,Pirituba,78,3,3,2,2100,730,2830,36.28205
2580,Vila Olímpia,95,3,2,1,2500,1350,3850,40.526318
2581,Bela Vista,104,3,3,0,2200,955,3155,30.336538
2582,Moema,101,3,3,2,3800,1088,4888,48.396038
2583,Chácara Santo Antônio,85,3,2,1,2750,750,3500,41.17647
2584,Vila Mariana,62,2,2,1,2500,817,3317,53.5
2585,Consolação,59,2,1,0,1500,1050,2550,43.22034
2586,Chácara Santo Antônio,38,1,1,1,1800,482,2282,60.05263
2587,Vila Olímpia,44,1,1,1,3000,750,3750,85.22727
2588,Moema,90,2,2,3,4400,1250,5650,62.77778
2589,Moema,60,1,2,1,4100,843,4943,82.38333
2590,Móoca,61,3,1,1,2200,400,2600,42.62295
2591,Pinheiros,40,1,1,1,4500,687,5187,129.675
2592,Ipiranga,68,2,2,2,2700,604,3304,48.588234
2593,Vila Leopoldina,120,3,3,2,3100,1000,4100,34.166668
2594,Barra Funda,69,2,2,1,2900,540,3440,49.855072
2595,Butantã,68,3,2,2,2400,687,3087,45.39706
2596,Brás,60,2,1,1,1300,490,1790,29.833334
2597,Morumbi,77,2,2,2,2300,700,3000,38.96104
2598,Moema,47,1,2,1,4400,550,4950,105.319145
2599,Jardim América,169,2,4,2,16000,1720,17720,104.85207
2600,Granja Julieta,154,3,4,2,6300,1340,7640,49.61039
2601,Vila Clementino,85,2,2,1,3100,980,4080,48.0
2602,Itaim Bibi,180,2,2,1,18000,1740,19740,109.666664
2603,Chácara Santo Antônio,76,2,2,1,3000,872,3872,50.94737
2604,Alto Da Boa Vista,41,1,1,1,1510,735,2245,54.756096
2605,Jardim Paulista,38,1,1,0,1600,130,1730,45.526318
2606,Bela Vista,60,1,1,0,1499,330,1829,30.483334
2607,Pinheiros,26,1,1,1,3200,0,3200,123.07692
2608,Vila Mariana,73,2,2,2,4600,1156,5756,78.84931
2609,Cambuci,176,4,5,3,8500,1260,9760,55.454544
2610,Vila Mariana,94,3,3,2,3190,1314,4504,47.914894
2611,Perdizes,270,4,5,4,22000,3800,25800,95.55556
2612,Outro,172,3,5,3,5300,1350,6650,38.662792
2613,Outro,70,3,3,2,1600,1313,2913,41.614285
2614,Jardim Paulista,80,2,3,1,4500,922,5422,67.775
2615,Outro,40,2,1,1,1140,150,1290,32.25
2616,Ipiranga,125,3,4,2,6000,1030,7030,56.24
2617,Outro,35,1,1,1,920,0,920,26.285715
2618,Vila Olímpia,45,1,1,1,3000,850,3850,85.55556
2619,Vila Olímpia,210,3,6,3,22000,2350,24350,115.95238
2620,Perdizes,42,1,1,1,1900,530,2430,57.857143
2621,Jardim Paulista,140,3,2,1,4500,1794,6294,44.95714
2622,Pinheiros,92,2,2,0,3000,350,3350,36.413044
2623,Brooklin,112,3,3,2,3800,1250,5050,45.089287
2624,Vila Formosa,56,2,1,1,1300,400,1700,30.357143
2625,Vila Romana,60,1,1,0,1500,141,1641,27.35
2626,Outro,177,3,4,2,7000,1400,8400,47.457626
2627,Ipiranga,39,1,1,1,1300,370,1670,42.820515
2628,Vila Olímpia,45,1,1,1,2200,739,2939,65.31111
2629,Jardim América,127,3,3,2,8000,1500,9500,74.80315
2630,Outro,74,3,2,2,3500,590,4090,55.27027
2631,Outro,66,1,2,1,3500,750,4250,64.393936
2632,Perdizes,36,1,1,1,2400,460,2860,79.44444
2633,Outro,34,1,1,1,1150,250,1400,41.17647
2634,Jardim Paulista,100,1,3,2,3700,1500,5200,52.0
2635,Saúde,104,2,3,2,4200,950,5150,49.51923
2636,Jabaquara,60,3,1,1,1400,558,1958,32.633335
2637,Indianópolis,225,3,6,4,15000,3500,18500,82.22222
2638,Jardim América,198,3,5,3,16000,3983,19983,100.92424
2639,Vila Mariana,50,1,1,1,3000,856,3856,77.12
2640,Jardim Marajoara,160,4,4,2,11000,0,11000,68.75
2641,Moema,156,4,5,3,9000,1584,10584,67.84615
2642,Perdizes,70,2,2,1,2800,650,3450,49.285713
2643,Consolação,30,1,1,0,1450,218,1668,55.6
2644,Vila Mariana,41,1,1,1,2200,1415,3615,88.17073
2645,Consolação,45,1,2,1,2416,947,3363,74.73333
2646,Vila Leopoldina,70,2,2,1,4000,710,4710,67.28571
2647,Higienópolis,50,2,1,1,2400,422,2822,56.44
2648,Outro,70,3,2,1,1890,420,2310,33.0
2649,Itaim Bibi,110,2,3,2,7250,2105,9355,85.045456
2650,República,56,1,1,0,1700,380,2080,37.142857
2651,Outro,45,2,1,1,1250,110,1360,30.222221
2652,Campo Belo,50,1,1,1,1700,651,2351,47.02
2653,Bela Vista,100,3,2,1,2300,1100,3400,34.0
2654,Outro,65,3,1,1,1800,409,2209,33.984615
2655,Bela Vista,40,1,1,0,2300,366,2666,66.65
2656,Chácara Santo Antônio,130,3,4,2,6500,855,7355,56.576923
2657,Barra Funda,40,1,1,1,2400,520,2920,73.0
2658,Moema,76,2,3,2,3950,1400,5350,70.39474
2659,Itaim Bibi,35,1,1,1,3970,850,4820,137.71428
2660,Vila Mariana,84,2,2,1,3300,522,3822,45.5
2661,Pinheiros,60,1,1,0,2247,400,2647,44.116665
2662,Campo Belo,180,2,5,3,18412,1800,20212,112.28889
2663,Saúde,57,2,2,1,2000,405,2405,42.19298
2664,Higienópolis,537,4,7,6,52000,8953,60953,113.506516
2665,Morumbi,120,3,4,2,2500,1170,3670,30.583334
2666,Jardim Paulista,150,3,3,2,4500,2350,6850,45.666668
2667,Outro,73,3,1,1,2000,640,2640,36.164383
2668,Higienópolis,42,1,1,1,3500,870,4370,104.04762
2669,Brooklin,132,3,5,3,11000,1200,12200,92.42424
2670,Pinheiros,157,3,4,3,12000,2005,14005,89.20382
2671,Vila Nova Conceição,64,2,2,1,1400,672,2072,32.375
2672,Outro,48,2,1,1,1150,466,1616,33.666668
2673,Ipiranga,40,1,1,1,1400,435,1835,45.875
2674,Aclimação,79,2,1,1,1900,576,2476,31.341772
2675,Outro,134,3,4,2,4500,1000,5500,41.044777
2676,Pinheiros,66,2,2,1,5400,1144,6544,99.15151
2677,Pinheiros,63,2,2,1,11000,1424,12424,197.20634
2678,Vila Prudente,95,3,1,2,2500,950,3450,36.31579
2679,Barra Funda,57,2,1,1,2500,576,3076,53.964912
2680,Barra Funda,58,2,1,1,2650,637,3287,56.672413
2681,Outro,57,2,1,1,1100,575,1675,29.385965
2682,Vila Olímpia,60,2,1,0,2750,882,3632,60.533333
2683,Campo Belo,277,4,6,4,15000,2726,17726,63.99278
2684,Cambuci,70,3,2,1,3500,0,3500,50.0
2685,Outro,74,2,2,1,1600,939,2539,34.31081
2686,Vila Romana,152,3,5,3,8500,1250,9750,64.14474
2687,Brooklin,113,3,2,2,3300,970,4270,37.78761
2688,Tatuapé,70,2,2,2,2400,732,3132,44.74286
2689,Panamby,226,4,5,4,12000,2500,14500,64.159294
2690,Vila Prudente,76,3,2,1,1890,838,2728,35.894737
2691,Vila Olímpia,80,2,2,2,8000,1675,9675,120.9375
2692,Outro,68,3,2,1,2100,640,2740,40.294117
2693,Vila Buarque,63,2,2,1,1850,950,2800,44.444443
2694,Pinheiros,85,2,3,2,3980,1520,5500,64.70588
2695,Perdizes,82,3,3,2,2750,1290,4040,49.26829
2696,Pinheiros,72,3,1,1,3400,755,4155,57.708332
2697,Outro,60,2,2,1,1580,332,1912,31.866667
2698,Aclimação,278,3,5,4,10500,3700,14200,51.079136
2699,Bela Vista,44,1,1,1,1500,480,1980,45.0
2700,Moema,210,3,5,0,5000,5050,10050,47.857143
2701,Bela Vista,84,2,3,2,6300,1300,7600,90.47619
2702,Mirandópolis,64,2,2,0,1500,520,2020,31.5625
2703,Outro,107,3,4,2,4000,750,4750,44.392525
2704,Brooklin,108,3,4,2,4800,1530,6330,58.61111
2705,Vila Mariana,50,2,2,1,2800,845,3645,72.9
2706,Pinheiros,45,1,2,1,2650,825,3475,77.22222
2707,Brooklin,50,1,1,1,3200,600,3800,76.0
2708,Saúde,66,2,2,2,3000,716,3716,56.303032
2709,Outro,60,2,1,1,1400,650,2050,34.166668
2710,Jardim Marajoara,60,2,1,1,1540,706,2246,37.433334
2711,Brooklin,45,1,2,1,2000,701,2701,60.02222
2712,Pinheiros,90,3,3,1,3700,1050,4750,52.77778
2713,Vila Mariana,67,2,2,2,5000,908,5908,88.17911
2714,Bela Vista,65,2,2,1,3300,800,4100,63.076923
2715,Outro,60,2,2,1,1500,864,2364,39.4
2716,Ipiranga,55,2,1,1,1700,696,2396,43.563637
2717,Higienópolis,41,1,1,1,2300,788,3088,75.31707
2718,Tatuapé,130,2,3,2,6200,800,7000,53.846153
2719,Bela Vista,37,1,1,1,1450,350,1800,48.648647
2720,Jardim Paulista,70,2,2,1,5000,1400,6400,91.42857
2721,Pinheiros,45,1,2,1,2600,707,3307,73.48889
2722,Chácara Klabin,73,2,2,1,3000,762,3762,51.53425
2723,Outro,58,2,1,1,1100,553,1653,28.5
2724,Vila Guarani,80,2,2,1,1999,660,2659,33.2375
2725,Campos Eliseos,40,1,1,1,1300,517,1817,45.425
2726,Outro,100,3,4,2,2300,1300,3600,36.0
2727,Pinheiros,88,2,1,2,6500,1561,8061,91.60227
2728,Moema,122,3,4,3,6000,1790,7790,63.85246
2729,Saúde,70,3,2,1,2400,792,3192,45.6
2730,Outro,60,2,1,1,1000,210,1210,20.166666
2731,Brooklin,69,2,2,1,5300,530,5830,84.49275
2732,Saúde,70,2,1,0,1200,450,1650,23.571428
2733,Vila Mariana,63,2,1,1,2000,818,2818,44.73016
2734,República,120,2,2,0,2550,800,3350,27.916666
2735,Perdizes,38,1,1,1,1700,806,2506,65.947365
2736,Granja Julieta,109,3,4,2,5000,860,5860,53.761467
2737,Saúde,85,2,2,1,1900,970,2870,33.764706
2738,Bela Vista,45,1,1,1,1800,686,2486,55.244446
2739,Jardim Europa,240,4,5,2,12000,3000,15000,62.5
2740,Paraíso,52,2,2,1,1800,589,2389,45.942307
2741,Vila Madalena,32,1,1,0,2000,530,2530,79.0625
2742,Perdizes,141,3,2,2,4300,1950,6250,44.32624
2743,Chácara Santo Antônio,93,2,3,3,5000,1790,6790,73.01075
2744,Vila Olímpia,43,1,1,1,2200,668,2868,66.69768
2745,Consolação,63,2,2,1,4500,760,5260,83.492065
2746,Pompeia,55,2,1,2,2100,735,2835,51.545456
2747,Alto Da Boa Vista,87,3,2,1,2900,853,3753,43.13793
2748,Vila Carrão,86,3,2,2,3100,680,3780,43.953487
2749,Moema,45,1,1,1,2000,478,2478,55.066666
2750,Outro,50,2,2,2,2200,490,2690,53.8
2751,Água Branca,70,2,2,1,2500,446,2946,42.085712
2752,Moema,100,3,4,2,6000,980,6980,69.8
2753,Cambuci,28,1,1,0,1000,200,1200,42.857143
2754,Morumbi,120,3,3,2,3500,1100,4600,38.333332
2755,Outro,80,3,2,2,2500,908,3408,42.6
2756,Móoca,93,2,1,0,1200,623,1823,19.60215
2757,Vila Mariana,120,2,4,1,3700,724,4424,36.866665
2758,Vila Olímpia,93,3,3,2,5500,1650,7150,76.88172
2759,Campo Belo,138,3,3,2,5300,2158,7458,54.04348
2760,Vila Mariana,85,3,4,2,4000,1226,5226,61.482353
2761,Outro,65,2,1,2,2900,984,3884,59.753845
2762,Santa Cecília,130,3,1,2,2100,1947,4047,31.13077
2763,Itaim Bibi,98,1,3,2,8500,1750,10250,104.591835
2764,Pinheiros,60,2,1,1,4000,688,4688,78.13333
2765,Tatuapé,148,3,5,3,8000,1150,9150,61.824326
2766,Jardim Paulista,197,3,2,1,4500,2200,6700,34.01015
2767,Jardim Marajoara,78,2,2,2,2035,910,2945,37.75641
2768,Morumbi,262,4,6,4,10500,2600,13100,50.0
2769,Indianópolis,55,2,2,2,2750,810,3560,64.72727
2770,Mirandópolis,32,1,1,0,1380,200,1580,49.375
2771,Cerqueira César,32,1,1,1,1700,599,2299,71.84375
2772,Vila Mascote,74,2,2,1,1600,450,2050,27.702703
2773,Outro,89,2,2,1,1800,1450,3250,36.516853
2774,Outro,96,3,2,1,3300,750,4050,42.1875
2775,Pinheiros,55,2,1,1,1600,460,2060,37.454544
2776,Saúde,17,1,1,0,1000,0,1000,58.82353
2777,Consolação,35,1,1,1,2676,304,2980,85.14286
2778,Itaim Bibi,70,1,1,1,6000,1400,7400,105.71429
2779,Outro,56,2,1,1,1400,0,1400,25.0
2780,Perdizes,26,1,1,0,2250,500,2750,105.76923
2781,Outro,41,2,1,0,1000,300,1300,31.707317
2782,Vila Madalena,78,1,3,1,6485,1160,7645,98.01282
2783,Jardim Paulista,54,2,2,1,5000,1000,6000,111.111115
2784,Vila Leopoldina,88,2,4,2,3200,617,3817,43.375
2785,Jardim Paulista,66,2,2,1,2200,1055,3255,49.31818
2786,Vila Santa Catarina,47,2,1,1,1800,450,2250,47.87234
2787,República,28,1,1,0,3400,300,3700,132.14285
2788,Outro,55,2,1,1,1200,500,1700,30.90909
2789,Vila Mariana,42,1,1,1,2400,410,2810,66.90476
2790,Vila Olímpia,55,1,1,1,2100,562,2662,48.4
2791,Brooklin,64,2,2,2,3900,700,4600,71.875
2792,Vila Leopoldina,95,3,3,2,5200,1068,6268,65.97895
2793,Pinheiros,63,2,2,1,3300,1041,4341,68.90476
2794,Itaim Bibi,92,2,3,1,3500,900,4400,47.826088
2795,Cerqueira César,150,3,4,4,15000,3824,18824,125.49333
2796,Jardim Paulista,135,3,3,1,2500,1600,4100,30.37037
2797,Bela Vista,42,1,1,1,1900,466,2366,56.333332
2798,Outro,157,3,5,2,7200,1001,8201,52.23567
2799,Vila Romana,70,2,1,1,1850,853,2703,38.614285
2800,Chácara Santo Antônio,70,2,1,2,5800,0,5800,82.85714
2801,Brooklin,50,1,1,1,3900,1100,5000,100.0
2802,Chácara Santo Antônio,95,2,2,2,6200,725,6925,72.89474
2803,Vila Olímpia,65,2,2,1,3300,874,4174,64.215385
2804,Pirituba,44,2,1,1,1600,250,1850,42.045456
2805,Morumbi,75,2,2,2,2000,1045,3045,40.6
2806,Butantã,80,3,3,1,2950,1300,4250,53.125
2807,Vila Andrade,42,2,1,0,1000,350,1350,32.142857
2808,Perdizes,75,2,1,0,2000,835,2835,37.8
2809,Vila Nova Conceição,57,1,2,1,5899,1120,7019,123.14035
2810,República,58,1,1,0,1250,490,1740,30.0
2811,Campo Belo,440,4,5,7,24000,4000,28000,63.636364
2812,Outro,53,2,1,1,1650,0,1650,31.132076
2813,Moema,55,1,1,1,1100,980,2080,37.81818
2814,Aclimação,110,3,2,0,3000,490,3490,31.727272
2815,Brooklin,73,2,2,1,4000,845,4845,66.369865
2816,Vila Andrade,60,2,2,1,2300,1210,3510,58.5
2817,Barra Funda,67,2,2,1,2200,540,2740,40.895523
2818,Bela Vista,50,2,2,1,2500,690,3190,63.8
2819,Cerqueira César,24,1,1,0,1500,370,1870,77.916664
2820,Outro,64,2,1,1,2200,415,2615,40.859375
2821,Vila Mariana,80,3,3,2,1800,1450,3250,40.625
2822,Outro,37,1,1,1,1600,570,2170,58.648647
2823,Vila Uberabinha,70,2,2,1,2650,1150,3800,54.285713
2824,Outro,48,2,1,1,1086,214,1300,27.083334
2825,Vila Buarque,35,1,1,0,1800,300,2100,60.0
2826,Morumbi,58,2,2,1,1500,672,2172,37.448277
2827,Vila Olímpia,63,1,2,1,6000,1350,7350,116.666664
2828,Vila Olímpia,70,2,2,1,3000,1480,4480,64.0
2829,Jabaquara,50,2,1,1,1470,630,2100,42.0
2830,Itaim Bibi,98,3,3,1,4700,1700,6400,65.30612
2831,Moema,55,2,2,2,2700,881,3581,65.10909
2832,Itaim Bibi,45,1,1,1,2600,908,3508,77.95556
2833,Chácara Santo Antônio,37,1,1,1,2000,540,2540,68.64865
2834,Bela Vista,81,2,2,0,2500,0,2500,30.864197
2835,Outro,76,3,2,1,2400,777,3177,41.80263
2836,Outro,47,2,1,1,930,420,1350,28.723404
2837,Pinheiros,51,2,1,1,2970,800,3770,73.92157
2838,Vila Clementino,55,2,1,1,2000,800,2800,50.909092
2839,Tatuapé,63,2,2,1,2700,450,3150,50.0
2840,Cerqueira César,30,1,1,0,2300,385,2685,89.5
2841,Vila Mascote,58,2,1,1,2000,696,2696,46.482758
2842,Itaim Bibi,250,4,6,4,15000,3940,18940,75.76
2843,Jardim Paulista,50,1,1,0,2400,603,3003,60.06
2844,Vila Mariana,42,1,1,1,2000,735,2735,65.11905
2845,Vila Mariana,46,1,1,1,4100,0,4100,89.13043
2846,Outro,29,1,1,0,950,100,1050,36.206898
2847,Brooklin,95,3,3,0,4750,1328,6078,63.978947
2848,Outro,34,1,1,1,1600,560,2160,63.52941
2849,Pompeia,70,3,1,1,2200,738,2938,41.971428
2850,Jardim Paulista,156,2,3,1,7800,1900,9700,62.179485
2851,Vila Mariana,90,2,2,1,2200,730,2930,32.555557
2852,Pinheiros,70,2,2,1,4100,805,4905,70.07143
2853,Santa Cecília,120,2,1,0,2350,606,2956,24.633333
2854,Cerqueira César,55,1,1,0,2000,694,2694,48.98182
2855,Indianópolis,108,3,3,2,4500,1356,5856,54.22222
2856,Vila Madalena,32,1,1,0,3300,500,3800,118.75
2857,Saúde,57,2,1,1,1600,698,2298,40.31579
2858,Barra Funda,60,2,1,0,1600,200,1800,30.0
2859,Paraíso,64,2,2,1,2350,751,3101,48.453125
2860,Higienópolis,123,3,2,1,4500,900,5400,43.90244
2861,Outro,45,2,1,1,1600,0,1600,35.555557
2862,Vila Mariana,78,2,2,0,2090,330,2420,31.02564
2863,Santo Amaro,189,3,5,3,17900,1100,19000,100.5291
2864,Perdizes,65,2,2,1,2750,838,3588,55.2
2865,Outro,51,1,1,1,3189,620,3809,74.68627
2866,Vila Nova Conceição,36,1,1,1,2000,948,2948,81.888885
2867,Cidade Monções,70,1,2,1,4300,712,5012,71.6
2868,Moema,55,2,2,2,3300,780,4080,74.181816
2869,Butantã,55,2,1,2,1330,420,1750,31.818182
2870,Outro,45,2,1,1,1500,0,1500,33.333332
2871,Brooklin,66,1,2,1,5700,780,6480,98.181816
2872,Morumbi,142,3,5,2,6000,1150,7150,50.35211
2873,Campo Belo,50,1,1,1,3100,420,3520,70.4
2874,Saúde,70,2,2,2,2600,768,3368,48.114285
2875,Pompeia,77,2,2,2,3950,740,4690,60.909092
2876,Chácara Santo Antônio,189,4,4,3,15000,1325,16325,86.37566
2877,Vila Olímpia,81,2,2,1,4500,1150,5650,69.75309
2878,Morumbi,140,3,2,2,3700,1400,5100,36.42857
2879,Vila Olímpia,40,1,1,1,3000,650,3650,91.25
2880,Santo Amaro,78,3,2,1,2850,853,3703,47.474358
2881,Campo Belo,78,2,1,0,1500,430,1930,24.74359
2882,Vila Mariana,88,2,2,1,2000,765,2765,31.420454
2883,Vila Nova Conceição,47,1,1,0,4822,942,5764,122.6383
2884,Jardim Paulista,105,2,2,0,3500,850,4350,41.42857
2885,Santana,40,1,1,2,1800,595,2395,59.875
2886,Outro,130,3,4,2,3996,2453,6449,49.607693
2887,Moema,147,4,4,2,6200,1700,7900,53.741497
2888,Pinheiros,90,2,1,1,4300,700,5000,55.555557
2889,Itaim Bibi,50,2,1,1,2300,915,3215,64.3
2890,Perdizes,100,3,2,1,2700,1110,3810,38.1
2891,Jardim Marajoara,283,4,4,3,7700,2300,10000,35.33569
2892,Outro,40,2,1,1,1530,330,1860,46.5
2893,Bela Vista,164,4,4,2,5900,1650,7550,46.036587
2894,Outro,70,2,1,1,2400,600,3000,42.857143
2895,Jardim Europa,280,3,5,3,37000,6120,43120,154.0
2896,Chácara Inglesa,76,3,3,2,2000,1061,3061,40.276318
2897,Campos Eliseos,49,1,1,0,1300,0,1300,26.530613
2898,Moema,70,2,1,1,3000,836,3836,54.8
2899,Brás,68,2,2,1,2650,538,3188,46.882355
2900,Itaim Bibi,100,2,3,1,5000,1360,6360,63.6
2901,Outro,71,2,2,1,1600,674,2274,32.028168
2902,Cerqueira César,262,3,3,2,8500,2600,11100,42.366413
2903,Ipiranga,101,2,4,2,3200,1007,4207,41.653465
2904,Outro,49,2,1,1,1150,0,1150,23.469387
2905,Campo Belo,80,2,2,1,2000,636,2636,32.95
2906,Brooklin,63,2,1,1,2000,812,2812,44.634922
2907,Jabaquara,57,3,1,1,1600,380,1980,34.736843
2908,Itaim Bibi,75,2,2,2,6130,2359,8489,113.18667
2909,Vila Clementino,115,3,3,2,1500,1668,3168,27.547827
2910,Outro,32,2,1,0,1200,190,1390,43.4375
2911,Perdizes,70,2,2,1,3700,587,4287,61.24286
2912,Butantã,44,2,1,1,3000,550,3550,80.681816
2913,Outro,50,1,1,1,1300,503,1803,36.06
2914,Pinheiros,126,3,3,2,7900,922,8822,70.01588
2915,Outro,55,2,2,2,2500,640,3140,57.090908
2916,Moema,100,3,2,1,2900,895,3795,37.95
2917,Outro,63,3,2,1,2000,500,2500,39.68254
2918,Vila Mascote,90,3,2,2,2800,877,3677,40.855556
2919,Jaguaré,70,3,2,0,2400,675,3075,43.92857
2920,Santa Cecília,45,1,1,1,1800,700,2500,55.555557
2921,Brás,62,2,1,1,1200,500,1700,27.419355
2922,Butantã,75,3,3,2,2000,998,2998,39.97333
2923,Santa Cecília,84,2,2,1,2500,950,3450,41.07143
2924,Brooklin,91,2,2,1,2850,1353,4203,46.186813
2925,Chácara Santo Antônio,104,4,4,2,3900,980,4880,46.923077
2926,Santana,18,1,1,0,950,0,950,52.77778
2927,Campo Belo,130,3,5,2,5000,1395,6395,49.192307
2928,Brooklin,41,1,1,1,2700,580,3280,80.0
2929,Outro,58,2,1,0,2000,707,2707,46.672413
2930,Vila Clementino,93,2,2,2,6000,1093,7093,76.268814
2931,Jardins,175,2,3,2,18000,2862,20862,119.211426
2932,Outro,126,3,4,3,1600,1980,3580,28.412699
2933,Vila Guarani,50,1,1,1,1600,640,2240,44.8
2934,Outro,47,2,1,1,1000,290,1290,27.446808
2935,Perdizes,78,2,1,2,3200,1154,4354,55.820515
2936,Moema,116,3,4,2,7200,1200,8400,72.413795
2937,República,45,1,1,0,1250,425,1675,37.22222
2938,Santa Cecília,171,3,3,2,3700,1950,5650,33.040936
2939,Itaim Bibi,90,1,2,2,10000,1350,11350,126.111115
2940,Vila Clementino,80,2,2,1,2500,817,3317,41.4625
2941,Vila Madalena,80,3,3,2,3800,840,4640,58.0
2942,Perdizes,52,1,2,1,3300,400,3700,71.15385
2943,Santa Cecília,40,1,1,1,1800,655,2455,61.375
2944,Bela Vista,120,2,2,0,2200,603,2803,23.358334
2945,Moema,73,2,1,1,2500,1047,3547,48.589043
2946,Outro,75,3,2,1,3300,0,3300,44.0
2947,Santa Cecília,35,1,1,1,1200,452,1652,47.2
2948,Pinheiros,30,1,1,1,2500,686,3186,106.2
2949,Cambuci,50,1,1,0,1700,380,2080,41.6
2950,Cerqueira César,120,2,1,1,3400,0,3400,28.333334
2951,Barra Funda,82,2,2,1,4000,800,4800,58.536587
2952,Brooklin,70,2,2,2,2400,793,3193,45.614285
2953,Perdizes,60,2,1,0,1850,160,2010,33.5
2954,Itaim Bibi,55,1,2,1,2300,710,3010,54.727272
2955,Água Branca,108,2,2,2,10000,1300,11300,104.62963
2956,Campos Eliseos,100,2,1,0,1750,897,2647,26.47
2957,Vila Gomes Cardim,165,4,2,3,5600,1411,7011,42.49091
2958,Alto Da Boa Vista,76,2,2,1,3100,670,3770,49.605263
2959,Itaim Bibi,96,2,3,2,8500,1750,10250,106.770836
2960,Itaim Bibi,75,2,2,1,8150,2350,10500,140.0
2961,Perdizes,126,3,2,1,4500,659,5159,40.944443
2962,Pinheiros,138,3,3,2,5000,1680,6680,48.405796
2963,Vila Clementino,140,4,4,2,4500,1400,5900,42.142857
2964,Outro,44,2,1,1,1500,420,1920,43.636364
2965,Aclimação,36,1,1,1,1200,837,2037,56.583332
2966,Vila Guarani,77,2,2,1,2900,803,3703,48.090908
2967,Jaguaré,74,3,1,2,2500,736,3236,43.72973
2968,Vila Olímpia,60,2,1,1,2200,1064,3264,54.4
2969,Moema,53,2,2,1,2500,520,3020,56.981133
2970,Vila Nova Conceição,127,3,2,2,6000,1414,7414,58.377953
2971,Outro,50,2,1,1,1100,259,1359,27.18
2972,Saúde,74,2,2,1,2000,450,2450,33.10811
2973,Moema,40,1,1,1,1899,710,2609,65.225
2974,Santa Ifigênia,34,1,1,1,2500,523,3023,88.911766
2975,Pinheiros,44,1,1,1,3500,635,4135,93.97727
2976,Pinheiros,30,1,1,1,2600,400,3000,100.0
2977,Chácara Santo Antônio,70,2,2,0,1900,310,2210,31.571428
2978,Vila Andrade,181,3,2,2,3800,663,4463,24.65746
2979,Aclimação,47,1,1,1,1345,499,1844,39.234043
2980,Outro,58,2,1,1,1300,625,1925,33.189655
2981,Vila Olímpia,60,2,1,1,3500,871,4371,72.85
2982,Chácara Santo Antônio,105,3,2,2,4500,988,5488,52.266666
2983,Outro,15,2,1,0,1520,110,1630,108.666664
2984,Vila Leopoldina,74,2,3,1,2500,735,3235,43.716217
2985,Higienópolis,96,2,2,1,3500,980,4480,46.666668
2986,Outro,40,2,1,0,1200,117,1317,32.925
2987,Outro,22,1,1,0,1100,100,1200,54.545456
2988,Sumaré,215,3,5,4,10800,3567,14367,66.82326
2989,Perdizes,80,3,3,1,2300,1033,3333,41.6625
2990,Cidade Monções,55,2,2,1,2600,962,3562,64.76363
2991,Outro,61,2,2,1,2500,650,3150,51.639343
2992,Vila Sônia,145,4,5,2,3500,1400,4900,33.793102
2993,Campos Eliseos,88,2,1,0,2100,0,2100,23.863636
2994,Itaim Bibi,62,2,2,1,5000,873,5873,94.72581
2995,Brooklin,56,2,2,1,2800,548,3348,59.785713
2996,Outro,44,2,1,1,1200,280,1480,33.636364
2997,Perdizes,65,2,3,2,3000,1175,4175,64.23077
2998,Vila Andrade,57,2,2,1,3000,535,3535,62.017544
2999,Outro,48,2,1,1,950,350,1300,27.083334
3000,Aclimação,34,1,1,1,1300,837,2137,62.85294
3001,Paraíso,114,2,4,1,2500,980,3480,30.526316
3002,Butantã,75,2,2,1,1900,900,2800,37.333332
3003,Lapa,138,3,2,3,5400,900,6300,45.652172
3004,Centro,42,1,1,0,1800,470,2270,54.04762
3005,Paraíso,300,4,5,4,22000,3600,25600,85.333336
3006,Saúde,52,2,1,1,2500,655,3155,60.673077
3007,Outro,55,2,1,1,1000,250,1250,22.727272
3008,Vila Madalena,82,2,1,2,7500,1900,9400,114.63415
3009,Outro,47,1,2,1,2950,600,3550,75.53191
3010,Bela Vista,51,2,1,1,2300,400,2700,52.941177
3011,Itaim Bibi,110,2,2,2,12000,1497,13497,122.7
3012,Vila Guarani,74,3,2,2,3500,562,4062,54.89189
3013,Paraíso,36,1,1,0,1500,540,2040,56.666668
3014,Vila Mariana,33,1,1,1,1600,560,2160,65.454544
3015,Outro,46,2,1,1,1100,444,1544,33.565216
3016,Outro,290,4,5,4,11000,5600,16600,57.24138
3017,Campo Belo,70,2,2,2,2950,1100,4050,57.857143
3018,Moema,65,2,2,1,2100,1100,3200,49.23077
3019,Itaim Bibi,138,3,3,1,6000,1774,7774,56.333332
3020,Moema,75,2,2,1,3200,780,3980,53.066666
3021,Liberdade,40,1,1,1,1200,615,1815,45.375
3022,Jardim Paulista,104,3,3,1,3200,1400,4600,44.23077
3023,Sumaré,213,4,4,4,6000,3600,9600,45.070423
3024,Consolação,138,3,3,1,2500,1200,3700,26.811594
3025,Liberdade,37,1,1,0,1199,334,1533,41.432434
3026,Jardins,60,1,2,1,2700,895,3595,59.916668
3027,Tatuapé,68,2,2,2,2000,548,2548,37.47059
3028,Butantã,38,2,1,1,1300,300,1600,42.105263
3029,Vila Guarani,110,3,4,2,4300,980,5280,48.0
3030,Outro,60,3,1,1,1200,602,1802,30.033333
3031,Pinheiros,70,2,1,1,4300,800,5100,72.85714
3032,Outro,55,2,1,0,1500,350,1850,33.636364
3033,Brooklin,60,1,2,2,3000,980,3980,66.333336
3034,Tatuapé,48,2,1,1,1300,494,1794,37.375
3035,Brooklin,48,1,1,1,1600,750,2350,48.958332
3036,Aclimação,90,3,3,2,2750,1060,3810,42.333332
3037,Perdizes,107,3,4,2,4300,1650,5950,55.607475
3038,Vila Guarani,65,3,2,1,1650,610,2260,34.76923
3039,Vila Olímpia,44,1,1,1,4000,679,4679,106.34091
3040,Outro,70,3,2,1,1600,620,2220,31.714285
3041,Outro,62,3,1,1,1750,540,2290,36.935482
3042,Outro,60,2,1,1,2500,280,2780,46.333332
3043,Moema,464,4,6,6,80000,6672,86672,186.7931
3044,Moema,84,2,2,2,2800,1193,3993,47.535713
3045,Campo Belo,63,2,2,1,2000,760,2760,43.809525
3046,Brooklin,86,3,2,1,2300,820,3120,36.279068
3047,Higienópolis,60,2,3,1,2500,680,3180,53.0
3048,Saúde,45,2,1,1,2280,665,2945,65.44444
3049,Bela Vista,60,2,1,0,1970,320,2290,38.166668
3050,Bela Vista,39,1,1,1,1700,423,2123,54.435898
3051,Moema,124,3,4,3,10000,2055,12055,97.21774
3052,Vila Mariana,65,2,2,1,2650,734,3384,52.06154
3053,Vila Olímpia,65,2,1,1,2500,965,3465,53.307693
3054,Itaim Bibi,70,2,1,1,2400,1020,3420,48.857143
3055,Moema,297,4,5,5,11000,4500,15500,52.188553
3056,Vila Madalena,82,1,1,2,5000,2177,7177,87.52439
3057,Vila Madalena,134,3,1,1,3100,526,3626,27.059702
3058,Vila Romana,80,2,2,2,3000,896,3896,48.7
3059,Vila Uberabinha,463,4,7,6,60000,0,60000,129.58963
3060,Cidade Monções,68,2,2,2,4200,800,5000,73.52941
3061,Vila Olímpia,107,2,2,1,3999,970,4969,46.43925
3062,Vila Clementino,115,4,4,3,4200,1350,5550,48.260868
3063,Outro,130,3,4,2,4800,1350,6150,47.307693
3064,Móoca,56,2,2,1,2200,580,2780,49.642857
3065,Outro,236,3,3,4,11000,1485,12485,52.902542
3066,Saúde,70,3,2,2,2400,574,2974,42.485714
3067,Alto Da Boa Vista,126,2,4,2,7300,920,8220,65.2381
3068,Jaguaré,63,2,2,1,2022,440,2462,39.079365
3069,Pinheiros,94,2,2,1,5900,1430,7330,77.97872
3070,Vila Anastácio,50,2,1,1,2350,500,2850,57.0
3071,Outro,58,2,2,1,1700,896,2596,44.75862
3072,Vila Madalena,69,2,2,1,6500,376,6876,99.652176
3073,República,38,1,1,0,1200,309,1509,39.710526
3074,Vila Olímpia,65,2,2,6,3000,1050,4050,62.307693
3075,Vila Nova Conceição,60,2,2,1,4460,860,5320,88.666664
3076,Santa Cecília,40,1,1,1,1750,545,2295,57.375
3077,Paraíso,55,2,1,1,2300,678,2978,54.145454
3078,Cidade Monções,85,3,2,1,2500,774,3274,38.517647
3079,Bom Retiro,120,3,2,0,1300,859,2159,17.991667
3080,Bela Vista,32,1,1,1,1400,530,1930,60.3125
3081,Pinheiros,90,3,3,1,3000,750,3750,41.666668
3082,Bela Vista,50,1,1,0,1700,526,2226,44.52
3083,Morumbi,74,3,3,2,2000,750,2750,37.162163
3084,Vila Buarque,25,1,1,0,1300,210,1510,60.4
3085,Santa Cecília,166,3,3,0,3800,1469,5269,31.740963
3086,Jardim Paulista,90,2,1,1,3200,1300,4500,50.0
3087,Brooklin,50,1,2,1,3500,546,4046,80.92
3088,Bela Vista,36,1,1,0,1000,387,1387,38.52778
3089,Outro,110,3,3,2,2430,1250,3680,33.454544
3090,Vila Clementino,50,2,1,1,1895,711,2606,52.12
3091,Vila Nova Conceição,166,3,5,3,20000,2100,22100,133.13252
3092,Vila Nova Conceição,70,3,3,1,3500,915,4415,63.07143
3093,Bela Vista,70,2,1,0,2000,390,2390,34.142857
3094,Saúde,42,1,1,1,2100,530,2630,62.61905
3095,Pompeia,61,2,1,1,2500,930,3430,56.229507
3096,Moema,48,1,1,1,2100,985,3085,64.270836
3097,Bela Vista,60,2,1,0,2200,0,2200,36.666668
3098,Higienópolis,60,2,2,2,4500,782,5282,88.03333
3099,Outro,65,2,2,1,3100,500,3600,55.384617
3100,Pinheiros,70,2,1,1,4300,838,5138,73.4
3101,Brooklin,55,2,2,1,2000,560,2560,46.545456
3102,Vila Clementino,67,2,2,1,2400,740,3140,46.865673
3103,Bela Vista,75,2,2,2,3500,1232,4732,63.093334
3104,Outro,41,2,1,0,1350,330,1680,40.97561
3105,Chácara Santo Antônio,35,1,1,1,2599,430,3029,86.542854
3106,Jardim Paulista,78,2,2,1,2500,870,3370,43.205128
3107,Perdizes,160,3,4,3,8000,1786,9786,61.1625
3108,Vila Carrão,80,3,2,1,4000,883,4883,61.0375
3109,Saúde,130,3,4,2,2700,1500,4200,32.307693
3110,Moema,105,3,3,2,3700,1767,5467,52.066666
3111,Bela Vista,42,1,1,1,2200,700,2900,69.04762
3112,Ipiranga,62,2,1,1,2500,550,3050,49.19355
3113,Jardim Paulista,42,1,1,1,3000,702,3702,88.14286
3114,Vila Mascote,37,1,1,0,1500,200,1700,45.945946
3115,Moema,210,3,5,4,4500,2700,7200,34.285713
3116,Moema,127,3,2,2,9500,1510,11010,86.69292
3117,Alto Da Boa Vista,40,1,1,1,1500,1300,2800,70.0
3118,Consolação,59,1,1,1,1300,960,2260,38.305084
3119,República,74,1,1,0,1450,485,1935,26.14865
3120,Casa Verde,49,1,1,1,2800,604,3404,69.46939
3121,Tatuapé,59,2,2,1,2200,424,2624,44.474575
3122,Pinheiros,68,2,1,2,4500,1007,5507,80.98529
3123,Brooklin,175,3,4,3,22000,2000,24000,137.14285
3124,Outro,64,3,1,1,1600,430,2030,31.71875
3125,Itaim Bibi,32,1,1,1,2850,1200,4050,126.5625
3126,Itaim Bibi,103,3,3,2,5200,1212,6412,62.252426
3127,Itaim Bibi,110,3,2,2,5000,1232,6232,56.654545
3128,Centro,45,1,1,0,1500,200,1700,37.77778
3129,Higienópolis,60,2,2,1,4800,749,5549,92.48333
3130,Brooklin,63,2,1,1,2800,750,3550,56.349205
3131,Itaim Bibi,75,2,2,2,3100,2315,5415,72.2
3132,Itaim Bibi,103,2,3,1,4500,1023,5523,53.62136
3133,Higienópolis,213,3,4,5,8000,5300,13300,62.441315
3134,Barra Funda,70,3,2,1,2400,446,2846,40.657143
3135,Vila Nova Conceição,95,2,3,1,5800,1150,6950,73.1579
3136,Moema,48,1,1,1,1800,900,2700,56.25
3137,Outro,60,2,1,1,1200,374,1574,26.233334
3138,Sumaré,50,2,1,1,1800,550,2350,47.0
3139,Outro,283,4,6,3,22000,2600,24600,86.9258
3140,Vila Nova Conceição,47,1,1,1,5000,1194,6194,131.78723
3141,Indianópolis,78,2,2,1,2800,682,3482,44.641026
3142,Jardim Prudência,58,2,1,1,1300,696,1996,34.41379
3143,Tatuapé,50,2,1,1,1400,550,1950,39.0
3144,Bela Vista,50,2,1,1,2200,715,2915,58.3
3145,Santa Ifigênia,44,1,1,1,2550,664,3214,73.045456
3146,Outro,45,1,1,0,1100,150,1250,27.777779
3147,Granja Julieta,168,4,4,3,8000,1300,9300,55.357143
3148,Saúde,50,1,1,0,1250,50,1300,26.0
3149,Vila Mariana,115,3,3,3,3500,1600,5100,44.347828
3150,Outro,49,2,1,1,1500,270,1770,36.122448
3151,Paraíso,157,3,3,2,5000,1000,6000,38.21656
3152,Indianópolis,55,2,2,1,2000,1400,3400,61.81818
3153,Vila Prudente,64,2,1,1,1908,460,2368,37.0
3154,Indianópolis,120,2,2,2,13000,0,13000,108.333336
3155,Moema,272,4,6,4,20000,3300,23300,85.661766
3156,Vila Nova Conceição,311,4,5,4,20000,3900,23900,76.84888
3157,Vila Mariana,75,3,3,2,2300,950,3250,43.333332
3158,Vila Mariana,108,3,1,2,6000,850,6850,63.425926
3159,Vila Leopoldina,120,3,3,2,3500,1700,5200,43.333332
3160,Vila Mariana,100,3,4,3,3400,1406,4806,48.06
3161,Mirandópolis,70,3,2,1,1900,807,2707,38.67143
3162,Vila Cruzeiro,115,3,4,2,5000,1000,6000,52.173912
3163,Vila Olímpia,55,2,1,1,5500,913,6413,116.6
3164,Outro,48,2,1,1,1100,350,1450,30.208334
3165,Lapa,52,2,1,1,1900,396,2296,44.153847
3166,Pinheiros,44,1,1,1,2800,633,3433,78.02273
3167,Vila Olímpia,78,2,3,1,2200,1190,3390,43.46154
3168,Brooklin,53,1,2,1,4450,600,5050,95.28302
3169,Vila Andrade,445,5,7,6,15000,6900,21900,49.21348
3170,Saúde,98,3,4,2,3075,1000,4075,41.581635
3171,Outro,60,2,1,1,1800,904,2704,45.066666
3172,Outro,44,2,1,1,1369,331,1700,38.636364
3173,Vila Olímpia,30,1,1,1,900,1400,2300,76.666664
3174,Perdizes,130,3,3,0,2600,1593,4193,32.253845
3175,Brooklin,95,3,3,1,2700,789,3489,36.726315
3176,Itaim Bibi,74,1,1,1,3200,1800,5000,67.567566
3177,Bela Vista,54,2,1,1,1800,400,2200,40.74074
3178,Brooklin,65,2,2,2,3985,800,4785,73.61539
3179,Cidade Monções,70,3,1,1,4300,715,5015,71.64286
3180,Moema,65,1,2,1,2578,1434,4012,61.723076
3181,Higienópolis,92,2,2,0,3800,780,4580,49.782608
3182,Freguesia do Ó,55,2,1,1,1400,670,2070,37.636364
3183,Outro,67,3,1,1,1400,850,2250,33.58209
3184,Vila Mariana,65,2,2,1,3000,745,3745,57.615383
3185,Outro,70,2,2,1,2000,0,2000,28.571428
3186,Itaim Bibi,67,2,2,0,3700,1012,4712,70.32836
3187,Vila Mariana,125,3,3,2,6200,750,6950,55.6
3188,Itaim Bibi,120,3,3,1,4400,1052,5452,45.433334
3189,Outro,60,2,2,1,1300,980,2280,38.0
3190,Outro,168,3,2,2,4700,1556,6256,37.238094
3191,Perdizes,38,1,1,1,2000,559,2559,67.3421
3192,Outro,100,2,2,1,1800,500,2300,23.0
3193,Chácara Santo Antônio,106,3,4,2,5500,1093,6593,62.198112
3194,Vila Mascote,95,3,3,3,2170,1759,3929,41.357895
3195,Cerqueira César,47,1,2,1,1800,630,2430,51.70213
3196,Vila Andrade,45,1,1,1,1900,598,2498,55.511112
3197,Vila Mariana,58,2,2,1,2600,820,3420,58.96552
3198,Vila Madalena,22,1,1,0,1700,700,2400,109.09091
3199,Mirandópolis,18,1,1,0,1000,200,1200,66.666664
3200,Pinheiros,157,3,5,3,12000,2000,14000,89.171974
3201,Pinheiros,70,2,1,1,4500,800,5300,75.71429
3202,Água Branca,68,2,2,1,6000,503,6503,95.632355
3203,Brooklin,75,2,2,2,3020,886,3906,52.08
3204,Paraíso,90,2,2,0,2350,605,2955,32.833332
3205,Perdizes,105,3,2,1,3500,988,4488,42.74286
3206,Outro,57,2,2,1,1602,398,2000,35.08772
3207,Butantã,58,2,2,2,1500,837,2337,40.293102
3208,Outro,70,2,2,2,5500,0,5500,78.57143
3209,Morumbi,42,1,1,1,1700,650,2350,55.95238
3210,Vila Buarque,58,1,1,0,2200,406,2606,44.931034
3211,Vila Guarani,50,2,1,1,1500,580,2080,41.6
3212,Cidade Monções,92,3,2,1,3000,726,3726,40.5
3213,Alto Da Boa Vista,180,3,3,2,4700,1660,6360,35.333332
3214,Panamby,44,1,1,1,1490,400,1890,42.954544
3215,Vila Olímpia,80,2,1,0,2900,809,3709,46.3625
3216,Brooklin,48,2,2,1,2500,864,3364,70.083336
3217,Jardim Paulista,76,2,2,1,3500,926,4426,58.236843
3218,Vila Guarani,79,2,3,1,1900,782,2682,33.949368
3219,Brooklin,119,3,3,2,10000,0,10000,84.033615
3220,Campo Belo,70,2,2,1,2600,750,3350,47.857143
3221,Vila Romana,60,2,2,1,2800,700,3500,58.333332
3222,Vila Guarani,66,3,2,1,2800,700,3500,53.030304
3223,Bela Vista,60,1,1,1,3600,716,4316,71.933334
3224,Outro,73,2,2,2,3800,0,3800,52.054794
3225,Moema,60,2,2,1,2600,808,3408,56.8
3226,Vila Olímpia,80,2,2,1,3200,950,4150,51.875
3227,Vila Mariana,60,1,1,1,1950,561,2511,41.85
3228,Outro,85,3,1,1,2300,850,3150,37.058823
3229,Cambuci,136,3,3,2,2000,1090,3090,22.720589
3230,Pinheiros,57,1,1,1,3950,769,4719,82.789474
3231,Chácara Klabin,60,2,2,1,1900,885,2785,46.416668
3232,Consolação,25,1,1,1,1650,480,2130,85.2
3233,Brooklin,70,2,2,1,1800,950,2750,39.285713
3234,Ipiranga,126,3,2,1,2500,230,2730,21.666666
3235,Pinheiros,66,1,1,1,2500,786,3286,49.78788
3236,Tatuapé,97,3,3,2,2700,908,3608,37.195877
3237,Outro,367,3,6,5,44985,3650,48635,132.52043
3238,Moema,110,3,3,2,4900,1350,6250,56.81818
3239,Consolação,25,1,1,1,1720,480,2200,88.0
3240,Higienópolis,198,3,2,2,5300,1490,6790,34.29293
3241,Outro,60,2,1,1,2000,0,2000,33.333332
3242,Santa Ifigênia,50,1,1,1,2200,400,2600,52.0
3243,Vila Buarque,32,1,1,0,1250,348,1598,49.9375
3244,Vila Mascote,54,2,2,2,1740,1163,2903,53.75926
3245,Cerqueira César,60,1,2,1,1500,1096,2596,43.266666
3246,Ipiranga,54,2,1,1,1650,485,2135,39.537037
3247,Ipiranga,75,3,2,1,3000,680,3680,49.066666
3248,Itaim Bibi,330,4,7,5,30000,1,30001,90.912125
3249,Tatuapé,29,1,1,0,1450,138,1588,54.75862
3250,Brooklin,51,1,1,1,2900,545,3445,67.54902
3251,Vila Olímpia,62,2,2,1,4800,873,5673,91.5
3252,Campo Belo,145,3,3,3,10000,1400,11400,78.62069
3253,Moema,74,2,3,1,4650,1240,5890,79.5946
3254,Outro,60,2,1,1,1300,450,1750,29.166666
3255,Butantã,36,1,1,1,2800,480,3280,91.111115
3256,Brooklin,50,1,1,1,2400,588,2988,59.76
3257,Itaim Bibi,98,2,2,1,3600,930,4530,46.22449
3258,Vila Mariana,134,3,1,2,5500,1650,7150,53.358208
3259,Vila Mariana,135,3,2,2,4785,1885,6670,49.407406
3260,Morumbi,105,3,4,0,3300,1190,4490,42.761906
3261,Consolação,140,3,2,0,3300,554,3854,27.528572
3262,Vila Andrade,34,2,1,1,1350,579,1929,56.735294
3263,Moema,165,3,4,2,6200,1400,7600,46.060608
3264,Moema,75,2,3,2,4500,1200,5700,76.0
3265,Perdizes,135,3,3,3,6000,1505,7505,55.592594
3266,Jardim Europa,277,3,1,3,20000,3500,23500,84.83755
3267,Outro,48,2,1,1,1200,430,1630,33.958332
3268,Jardim Paulista,48,1,1,0,1600,380,1980,41.25
3269,Vila Romana,161,4,4,3,11000,1500,12500,77.639755
3270,Vila Olímpia,35,1,1,1,3000,859,3859,110.25714
3271,Bela Vista,54,2,1,1,2800,850,3650,67.59259
3272,Outro,65,3,2,1,1300,485,1785,27.461538
3273,Vila Anastácio,55,2,1,1,2700,500,3200,58.18182
3274,Chácara Santo Antônio,70,2,2,2,4500,853,5353,76.47143
3275,Itaim Bibi,158,3,3,1,5350,1340,6690,42.341774
3276,Consolação,67,1,2,1,4600,800,5400,80.597015
3277,Vila Mariana,73,2,2,1,2100,880,2980,40.82192
3278,Moema,117,2,3,2,8500,2300,10800,92.30769
3279,Itaim Bibi,160,3,2,1,5000,2460,7460,46.625
3280,Chácara Santo Antônio,51,2,2,1,2800,625,3425,67.15686
3281,Vila Santa Catarina,70,2,2,1,3100,700,3800,54.285713
3282,Centro,51,1,1,1,1699,699,2398,47.019608
3283,Tatuapé,145,2,4,4,9600,1500,11100,76.55173
3284,Consolação,32,1,1,1,1650,425,2075,64.84375
3285,Pinheiros,106,1,2,2,14300,2200,16500,155.66037
3286,Perdizes,106,3,3,2,3100,1272,4372,41.24528
3287,Outro,160,4,6,3,6200,1900,8100,50.625
3288,Vila Prudente,70,2,2,1,1600,518,2118,30.257143
3289,Santa Cecília,46,1,1,1,1600,600,2200,47.826088
3290,Vila Clementino,40,1,1,1,2300,514,2814,70.35
3291,Higienópolis,122,3,2,2,5500,1690,7190,58.934425
3292,Mirandópolis,38,1,1,1,1000,943,1943,51.13158
3293,Pinheiros,90,3,2,1,4000,1028,5028,55.866665
3294,Itaim Bibi,131,3,2,1,5000,945,5945,45.38168
3295,Outro,32,2,1,0,1200,190,1390,43.4375
3296,Itaim Bibi,100,3,3,1,2700,1300,4000,40.0
3297,República,48,1,1,1,2990,548,3538,73.708336
3298,Outro,47,2,1,1,1150,396,1546,32.893616
3299,Pinheiros,63,1,2,1,3900,990,4890,77.61905
3300,Outro,47,2,1,1,1700,0,1700,36.17021
3301,Jardins,50,1,2,0,2800,380,3180,63.6
3302,Vila Olímpia,80,3,2,1,2900,1350,4250,53.125
3303,Pinheiros,60,2,2,1,4500,800,5300,88.333336
3304,Vila Gomes Cardim,112,3,3,0,3000,1100,4100,36.607143
3305,Vila Madalena,45,1,1,1,2600,601,3201,71.13333
3306,Higienópolis,40,1,1,1,2450,505,2955,73.875
3307,Saúde,37,1,1,1,2300,460,2760,74.5946
3308,Campo Belo,75,2,2,1,1600,800,2400,32.0
3309,Vila Mariana,45,2,2,1,1800,626,2426,53.91111
3310,Vila Nova Conceição,156,3,4,3,35000,2563,37563,240.78847
3311,Campos Eliseos,50,1,1,1,2303,565,2868,57.36
3312,Móoca,73,2,2,1,2000,540,2540,34.79452
3313,Cambuci,56,1,1,0,1300,580,1880,33.57143
3314,Itaim Bibi,118,3,3,1,4400,1525,5925,50.211864
3315,Outro,68,3,1,1,1450,431,1881,27.661764
3316,Itaim Bibi,105,3,3,1,3500,1100,4600,43.809525
3317,Bela Vista,58,2,1,1,3500,552,4052,69.86207
3318,Perdizes,42,1,1,1,2000,600,2600,61.904762
3319,Brooklin,40,1,1,1,1400,830,2230,55.75
3320,Outro,98,3,4,2,4000,0,4000,40.816326
3321,Jardim Paulista,40,1,1,1,1900,829,2729,68.225
3322,Santana,123,3,3,2,4300,1049,5349,43.487804
3323,Chácara Klabin,72,3,2,2,2500,836,3336,46.333332
3324,Outro,55,2,2,1,1700,455,2155,39.18182
3325,Morumbi,100,2,2,2,3200,961,4161,41.61
3326,Jardim Paulista,76,2,2,1,4000,900,4900,64.47369
3327,Bela Vista,50,1,1,0,1300,495,1795,35.9
3328,Vila Mariana,94,3,4,2,3600,810,4410,46.914894
3329,Vila Mariana,53,1,2,1,1800,665,2465,46.509434
3330,Pinheiros,48,2,1,1,2900,730,3630,75.625
3331,República,40,1,1,0,1200,300,1500,37.5
3332,Moema,72,2,1,2,2500,2200,4700,65.27778
3333,República,32,1,1,1,1100,785,1885,58.90625
3334,Campo Belo,131,4,4,3,6500,1420,7920,60.458015
3335,Vila Prudente,55,2,1,1,1900,550,2450,44.545456
3336,Pinheiros,49,2,1,1,3100,657,3757,76.67347
3337,Brooklin,83,3,3,2,3400,1000,4400,53.012047
3338,Itaim Bibi,218,3,5,4,17000,4600,21600,99.082565
3339,Ipiranga,95,3,2,1,2200,740,2940,30.947369
3340,Jaguaré,50,2,1,1,1200,583,1783,35.66
3341,Chácara Santo Antônio,52,2,1,1,3000,600,3600,69.23077
3342,Santa Cecília,108,2,2,0,2200,1021,3221,29.824074
3343,Saúde,160,4,2,2,3750,1700,5450,34.0625
3344,Vila Olímpia,59,2,2,1,2700,830,3530,59.83051
3345,Vila Cruzeiro,60,2,2,2,3300,700,4000,66.666664
3346,Campo Belo,144,3,1,2,4700,2060,6760,46.944443
3347,Outro,60,2,1,1,1650,0,1650,27.5
3348,Vila Nova Conceição,70,1,2,1,3200,1525,4725,67.5
3349,Vila Mariana,50,1,2,1,3500,550,4050,81.0
3350,Mirandópolis,62,2,2,1,1500,1250,2750,44.35484
3351,Consolação,118,3,3,1,2700,1335,4035,34.194916
3352,Outro,44,2,1,1,750,250,1000,22.727272
3353,Barra Funda,40,1,1,0,1200,470,1670,41.75
3354,Vila Leopoldina,70,1,1,1,3000,735,3735,53.357143
3355,Santo Amaro,70,2,1,0,1359,327,1686,24.085714
3356,Tatuapé,224,4,5,4,9500,1,9501,42.41518
3357,Morumbi,50,1,1,1,2500,800,3300,66.0
3358,Pinheiros,100,3,2,1,3200,1300,4500,45.0
3359,Bela Vista,48,1,1,1,2000,580,2580,53.75
3360,Freguesia do Ó,65,2,2,1,2250,324,2574,39.6
3361,Ipiranga,74,2,3,1,4200,460,4660,62.972973
3362,Jardim Paulista,75,2,2,1,3000,1200,4200,56.0
3363,Vila Olímpia,70,2,2,1,6800,900,7700,110.0
3364,Brás,67,3,1,1,1900,470,2370,35.373135
3365,Vila Leopoldina,88,3,1,2,4500,860,5360,60.909092
3366,Campo Belo,55,1,1,1,2300,600,2900,52.727272
3367,Jardins,37,1,1,1,1800,1350,3150,85.13513
3368,Vila Formosa,65,2,2,1,2350,800,3150,48.46154
3369,Alto da Lapa,57,2,2,2,2750,842,3592,63.017544
3370,Casa Verde,69,3,2,2,1800,545,2345,33.985508
3371,República,32,1,1,0,1550,435,1985,62.03125
3372,Chácara Klabin,78,3,3,2,2800,1380,4180,53.589745
3373,Brooklin,173,3,3,2,8500,2090,10590,61.21387
3374,Brooklin,173,3,3,2,8500,2090,10590,61.21387
3375,Vila Mariana,83,3,2,1,2500,731,3231,38.92771
3376,Outro,55,2,1,1,1850,570,2420,44.0
3377,Barra Funda,49,1,1,1,1600,260,1860,37.959183
3378,Moema,53,2,2,1,2500,520,3020,56.981133
3379,Higienópolis,80,3,3,2,4900,1070,5970,74.625
3380,Campo Belo,120,3,4,2,3700,1280,4980,41.5
3381,Outro,80,2,2,1,1900,306,2206,27.575
3382,Outro,123,3,4,2,5000,1800,6800,55.284554
3383,Cerqueira César,74,2,2,0,2990,338,3328,44.972973
3384,Itaim Bibi,98,2,4,1,5200,1584,6784,69.22449
3385,Chácara Santo Antônio,98,3,3,2,3000,705,3705,37.80612
3386,Perdizes,40,1,1,1,1750,582,2332,58.3
3387,Jardins,220,4,5,3,11000,3681,14681,66.73182
3388,Liberdade,64,2,1,1,1500,540,2040,31.875
3389,Santana,39,1,1,1,1700,530,2230,57.179485
3390,Jardim Paulista,227,3,5,3,20000,3457,23457,103.3348
3391,Vila Mariana,100,3,3,1,3000,1200,4200,42.0
3392,Perdizes,80,2,1,0,1700,524,2224,27.8
3393,Outro,27,1,1,0,1280,0,1280,47.407406
3394,Outro,82,3,3,2,1950,880,2830,34.512196
3395,Vila Mariana,65,2,2,2,3500,794,4294,66.06154
3396,Itaim Bibi,110,3,2,1,4500,1100,5600,50.909092
3397,Outro,55,2,1,0,1250,0,1250,22.727272
3398,Chácara Santo Antônio,100,3,3,2,4000,1021,5021,50.21
3399,Outro,52,2,1,1,1000,200,1200,23.076923
3400,Jaguaré,60,2,1,1,1300,634,1934,32.233334
3401,Vila Mariana,80,3,2,0,2600,515,3115,38.9375
3402,Santa Cecília,35,1,1,0,1300,500,1800,51.42857
3403,Paraíso,42,1,2,1,2300,550,2850,67.85714
3404,Vila Mariana,120,3,3,1,2950,723,3673,30.608334
3405,Vila Nova Conceição,150,2,3,1,8400,1165,9565,63.766666
3406,Bela Vista,55,2,1,1,2300,741,3041,55.29091
3407,Bela Vista,42,1,1,0,1360,393,1753,41.738094
3408,Outro,54,2,1,0,1550,420,1970,36.48148
3409,Ipiranga,76,2,2,1,2100,1022,3122,41.07895
3410,Ipiranga,76,2,2,1,2100,1022,3122,41.07895
3411,Moema,50,1,1,1,2736,600,3336,66.72
3412,Lapa,58,2,1,1,1350,450,1800,31.034483
3413,Aclimação,87,2,1,1,1680,360,2040,23.448277
3414,Indianópolis,86,3,2,2,3300,1282,4582,53.279068
3415,Jardim Prudência,50,2,1,0,1200,310,1510,30.2
3416,Outro,126,4,5,2,2900,1500,4400,34.920635
3417,Alto da Lapa,65,2,2,1,2000,805,2805,43.153847
3418,Outro,56,2,1,1,2000,0,2000,35.714287
3419,Vila Mariana,38,1,1,1,3000,600,3600,94.73684
3420,Pinheiros,80,2,2,2,6690,1350,8040,100.5
3421,Jardim Prudência,60,2,1,1,1100,600,1700,28.333334
3422,Vila Prudente,60,2,1,1,3300,331,3631,60.516666
3423,Santana,110,3,2,2,1700,1300,3000,27.272728
3424,Vila Mariana,80,3,2,1,2800,900,3700,46.25
3425,Campo Belo,169,3,4,3,10000,0,10000,59.171597
3426,Vila Mariana,45,2,1,1,1800,640,2440,54.22222
3427,Jardim Paulista,50,2,1,1,2600,838,3438,68.76
3428,Jardins,220,3,3,3,25000,3000,28000,127.27273
3429,Moema,86,2,1,2,3700,749,4449,51.73256
3430,Jardim Paulista,110,3,3,1,4500,1200,5700,51.81818
3431,Chácara Santo Antônio,70,2,1,1,3200,734,3934,56.2
3432,Outro,60,2,1,1,2900,342,3242,54.033333
3433,Outro,40,2,1,1,1200,340,1540,38.5
3434,Outro,75,2,2,1,4200,680,4880,65.066666
3435,Jardins,150,3,4,1,4000,2200,6200,41.333332
3436,Panamby,97,2,2,2,4300,1300,5600,57.73196
3437,Vila Mariana,81,2,3,2,3100,1440,4540,56.04938
3438,Outro,49,2,1,0,1400,480,1880,38.367348
3439,Tatuapé,60,2,2,1,2400,650,3050,50.833332
3440,Moema,50,1,2,1,3000,597,3597,71.94
3441,Indianópolis,47,1,2,0,2200,863,3063,65.17021
3442,Bela Vista,37,1,1,1,2300,530,2830,76.48649
3443,Santo Amaro,102,2,2,1,5000,587,5587,54.77451
3444,Ipiranga,86,3,1,1,2000,950,2950,34.302326
3445,Outro,65,2,1,1,1250,600,1850,28.461538
3446,Lapa,65,2,1,1,1400,368,1768,27.2
3447,Outro,64,2,2,1,1900,560,2460,38.4375
3448,Jardim Anália Franco,45,1,1,1,2700,459,3159,70.2
3449,Consolação,59,2,1,0,1800,620,2420,41.01695
3450,Pinheiros,24,1,1,1,2800,400,3200,133.33333
3451,Outro,91,2,3,2,3500,620,4120,45.274727
3452,Granja Julieta,174,3,4,3,9000,1644,10644,61.172413
3453,Indianópolis,95,3,3,2,3800,1350,5150,54.210526
3454,Jardim Anália Franco,100,3,4,0,6490,1040,7530,75.3
3455,Vila Mariana,30,1,1,0,3190,0,3190,106.333336
3456,Vila Clementino,43,1,1,0,3400,342,3742,87.023254
3457,Vila Olímpia,51,2,1,1,3150,700,3850,75.4902
3458,Outro,396,4,7,3,10000,0,10000,25.252525
3459,Vila Clementino,77,3,2,1,2700,1050,3750,48.701298
3460,Higienópolis,64,2,1,1,2200,670,2870,44.84375
3461,Jardim Marajoara,182,3,2,2,6600,1600,8200,45.054947
3462,Vila Prudente,74,2,1,1,1250,508,1758,23.756756
3463,Saúde,64,2,2,1,1900,790,2690,42.03125
3464,Itaim Bibi,87,3,3,1,5500,1108,6608,75.954025
3465,Cidade Monções,105,2,3,2,11000,0,11000,104.7619
3466,Jardins,110,2,1,1,3200,2900,6100,55.454544
3467,Cidade Monções,55,2,2,1,2500,962,3462,62.945454
3468,Bela Vista,40,1,1,1,2500,490,2990,74.75
3469,Lapa,64,2,1,1,1450,368,1818,28.40625
3470,Itaim Bibi,110,2,3,2,11000,1800,12800,116.36364
3471,Vila Mariana,45,1,1,0,1600,430,2030,45.11111
3472,Outro,84,3,1,3,2600,1345,3945,46.964287
3473,Água Branca,70,3,2,1,2500,530,3030,43.285713
3474,Granja Julieta,95,3,3,2,4500,600,5100,53.68421
3475,Alto Da Boa Vista,98,3,4,2,3400,532,3932,40.122448
3476,Vila Carrão,142,4,5,2,4800,1900,6700,47.183098
3477,Vila Olímpia,65,1,2,2,5500,970,6470,99.53846
3478,Jardim Marajoara,107,3,4,2,4500,764,5264,49.196262
3479,Jardim Paulista,115,3,3,1,7000,0,7000,60.869564
3480,Vila Madalena,88,2,2,2,6500,1383,7883,89.579544
3481,Vila Nova Conceição,128,3,4,2,8500,1400,9900,77.34375
3482,Liberdade,29,1,1,1,4900,0,4900,168.96552
3483,Outro,60,2,1,1,2600,343,2943,49.05
3484,Ipiranga,78,3,3,1,2200,606,2806,35.974358
3485,Outro,50,1,2,1,1950,600,2550,51.0
3486,Ipiranga,142,4,3,4,3800,980,4780,33.661972
3487,Vila Leopoldina,172,4,5,3,5700,1838,7538,43.82558
3488,Outro,50,1,1,0,1300,171,1471,29.42
3489,Outro,39,2,1,0,1000,120,1120,28.717949
3490,Vila Olímpia,54,1,1,1,1500,1250,2750,50.925926
3491,Jardim Paulista,50,1,1,1,1900,537,2437,48.74
3492,Outro,58,2,1,2,4000,960,4960,85.51724
3493,Outro,60,2,1,1,1650,370,2020,33.666668
3494,Jardim Paulista,114,2,3,2,8750,2400,11150,97.807014
3495,Santo Amaro,96,2,2,1,2500,800,3300,34.375
3496,Outro,343,4,5,1,8500,3907,12407,36.172012
3497,Outro,56,2,1,1,1300,365,1665,29.732143
3498,Moema,74,2,2,1,4850,880,5730,77.432434
3499,Freguesia do Ó,50,2,1,0,990,750,1740,34.8
3500,Saúde,55,2,1,0,2300,687,2987,54.30909
3501,Perdizes,68,2,2,2,3000,1174,4174,61.382355
3502,Tatuapé,54,2,2,1,1700,700,2400,44.444443
3503,Outro,50,2,1,1,1500,380,1880,37.6
3504,Brooklin,55,2,2,1,2700,962,3662,66.58182
3505,Ipiranga,111,3,4,2,5500,1000,6500,58.55856
3506,Granja Julieta,138,4,4,2,6800,805,7605,55.108696
3507,Outro,52,2,1,1,1200,520,1720,33.076923
3508,Jardim Anália Franco,60,2,2,2,2300,780,3080,51.333332
3509,Morumbi,48,1,2,1,1700,665,2365,49.270832
3510,Brooklin,143,3,3,2,12500,2433,14933,104.426575
3511,Cerqueira César,64,2,2,1,3200,607,3807,59.484375
3512,Vila Olímpia,94,1,3,2,10000,1002,11002,117.04256
3513,Higienópolis,100,3,1,0,3500,355,3855,38.55
3514,Itaim Bibi,230,4,5,4,9500,2400,11900,51.739132
3515,Jardim Paulista,173,3,3,1,6900,1500,8400,48.554913
3516,Bela Vista,26,1,1,0,2300,0,2300,88.46154
3517,Brooklin,70,2,2,1,4500,120,4620,66.0
3518,Brooklin,70,2,2,1,4500,120,4620,66.0
3519,Vila Leopoldina,172,3,4,3,6200,1700,7900,45.930233
3520,Outro,50,2,1,1,1300,402,1702,34.04
3521,Vila Mariana,120,2,2,0,3850,0,3850,32.083332
3522,Jardim Prudência,73,2,2,2,3800,550,4350,59.589043
3523,Vila Madalena,75,2,2,1,3500,932,4432,59.093334
3524,Outro,117,3,3,3,2900,1317,4217,36.042736
3525,Outro,102,3,3,2,3000,1800,4800,47.058823
3526,Vila Buarque,58,2,1,0,1990,690,2680,46.206898
3527,Jardim Paulista,198,3,4,2,9500,4280,13780,69.59596
3528,Jardim Paulista,55,1,1,1,2500,865,3365,61.18182
3529,Jardim Paulista,135,4,2,2,4100,1610,5710,42.296295
3530,Perdizes,60,2,2,1,2000,664,2664,44.4
3531,Jardim Paulista,50,1,1,1,3545,1380,4925,98.5
3532,Outro,47,2,1,1,1300,650,1950,41.48936
3533,Bela Vista,66,2,2,1,4800,600,5400,81.818184
3534,Perdizes,40,1,1,1,1650,922,2572,64.3
3535,Vila Nova Conceição,71,2,2,2,4000,1300,5300,74.64789
3536,Campo Belo,75,2,2,2,4500,1080,5580,74.4
3537,Barra Funda,100,3,2,0,2200,0,2200,22.0
3538,Perdizes,100,3,2,1,1800,1597,3397,33.97
3539,Vila Uberabinha,110,3,3,2,3900,1040,4940,44.909092
3540,Vila Gomes Cardim,92,3,2,2,2590,1082,3672,39.913044
3541,Outro,67,3,2,1,1950,0,1950,29.104477
3542,Vila Olímpia,50,1,2,0,2300,537,2837,56.74
3543,Outro,42,2,1,1,1395,250,1645,39.166668
3544,Outro,76,3,3,2,1850,816,2666,35.07895
3545,Vila Olímpia,38,1,1,1,6500,1200,7700,202.63158
3546,Vila Olímpia,74,2,1,1,8400,850,9250,125.0
3547,Pinheiros,60,2,2,1,4900,1100,6000,100.0
3548,Pinheiros,135,3,4,2,7500,1520,9020,66.81481
3549,Mirandópolis,56,2,2,1,2800,520,3320,59.285713
3550,Higienópolis,64,2,2,1,2100,608,2708,42.3125
3551,Pinheiros,75,2,2,2,3400,850,4250,56.666668
3552,Santo Amaro,34,2,1,1,1600,400,2000,58.82353
3553,Outro,68,2,2,2,1700,840,2540,37.35294
3554,Outro,68,2,2,2,1700,840,2540,37.35294
3555,Itaim Bibi,146,3,5,2,12800,1700,14500,99.31507
3556,Butantã,13,1,1,0,1220,1000,2220,170.76923
3557,Outro,50,2,1,1,1500,544,2044,40.88
3558,Vila Clementino,38,1,1,1,1500,500,2000,52.63158
3559,Moema,35,1,1,1,2400,850,3250,92.85714
3560,Outro,52,2,1,1,1400,0,1400,26.923077
3561,Morumbi,64,2,2,1,2000,650,2650,41.40625
3562,Saúde,120,4,3,2,4600,1136,5736,47.8
3563,Vila Guarani,59,2,2,1,1800,699,2499,42.35593
3564,Chácara Santo Antônio,65,2,1,0,3200,650,3850,59.23077
3565,Jardim Marajoara,50,2,1,1,1600,480,2080,41.6
3566,Brás,58,2,1,1,1200,452,1652,28.48276
3567,Pinheiros,74,2,3,1,3000,1237,4237,57.256756
3568,Jardim Prudência,57,2,2,1,2500,630,3130,54.91228
3569,Outro,135,4,5,3,3500,1715,5215,38.62963
3570,Outro,40,2,1,0,1100,319,1419,35.475
3571,Lapa,103,3,3,2,2150,858,3008,29.203884
3572,Outro,49,2,1,1,1500,270,1770,36.122448
3573,Alto da Lapa,60,2,1,1,1400,835,2235,37.25
3574,Jardim Paulista,60,1,1,1,1200,1031,2231,37.183334
3575,Jardim Paulista,190,3,4,3,11500,3400,14900,78.42105
3576,Santa Ifigênia,44,1,1,1,2600,664,3264,74.181816
3577,Outro,383,4,3,3,6500,4750,11250,29.373367
3578,Itaim Bibi,62,1,1,1,6880,1300,8180,131.93549
3579,Vila Clementino,77,2,2,1,2600,830,3430,44.545456
3580,Campo Belo,50,1,2,1,2800,725,3525,70.5
3581,Jardim Paulista,120,3,2,1,4000,1380,5380,44.833332
3582,Outro,98,3,3,2,2000,1050,3050,31.12245
3583,Campo Belo,60,2,1,1,5500,860,6360,106.0
3584,Moema,42,1,2,1,1800,560,2360,56.190475
3585,Cambuci,26,1,1,0,1100,150,1250,48.076923
3586,Aclimação,55,1,1,1,1600,594,2194,39.890907
3587,Vila Mariana,141,3,4,3,3500,1950,5450,38.65248
3588,Outro,145,3,3,2,3700,1500,5200,35.86207
3589,Vila Leopoldina,78,3,2,1,3300,580,3880,49.74359
3590,Brooklin,38,1,1,1,3000,550,3550,93.42105
3591,Higienópolis,70,1,1,0,1900,700,2600,37.142857
3592,Higienópolis,120,3,2,1,3500,2283,5783,48.191666
3593,Consolação,32,1,1,0,1300,310,1610,50.3125
3594,Outro,59,2,1,1,2200,800,3000,50.847458
3595,Ipiranga,86,3,3,1,2800,1000,3800,44.186047
3596,Perdizes,60,2,2,1,2700,620,3320,55.333332
3597,Outro,60,3,1,2,1900,750,2650,44.166668
3598,Outro,105,2,3,2,2950,1221,4171,39.72381
3599,Vila Gomes Cardim,160,4,6,3,3500,1600,5100,31.875
3600,Moema,45,1,1,1,3400,1000,4400,97.77778
3601,Vila Clementino,45,1,2,1,2500,750,3250,72.22222
3602,Jardim Prudência,52,2,1,1,1250,671,1921,36.942307
3603,Vila Carrão,70,3,2,1,1800,377,2177,31.1
3604,Moema,51,1,1,1,4950,480,5430,106.47059
3605,Brooklin,50,2,2,1,2500,580,3080,61.6
3606,Vila Mariana,65,2,2,1,2500,744,3244,49.907692
3607,Moema,150,3,4,2,3500,1900,5400,36.0
3608,Outro,128,3,2,2,4000,1200,5200,40.625
3609,Outro,113,3,2,2,4500,877,5377,47.584072
3610,Higienópolis,560,3,3,1,17000,4997,21997,39.280357
3611,Vila Buarque,40,1,1,1,2200,515,2715,67.875
3612,Jardim Paulista,35,1,1,1,2300,500,2800,80.0
3613,Pompeia,83,3,3,2,3800,1100,4900,59.036144
3614,Vila Leopoldina,130,3,4,2,6200,1160,7360,56.615383
3615,Brás,80,2,1,0,1300,200,1500,18.75
3616,Bela Vista,45,1,1,1,1660,602,2262,50.266666
3617,Água Branca,46,1,1,0,1300,301,1601,34.804348
3618,Bela Vista,75,2,2,2,5000,700,5700,76.0
3619,Ipiranga,90,3,2,1,2350,0,2350,26.11111
3620,Liberdade,62,1,1,0,1190,375,1565,25.241936
3621,Móoca,88,3,2,1,2600,680,3280,37.272728
3622,Móoca,48,2,1,1,1750,400,2150,44.791668
3623,Vila Nova Conceição,54,1,2,1,6500,950,7450,137.96297
3624,Outro,626,5,6,7,80000,11000,91000,145.36742
3625,Campo Belo,50,1,1,1,2950,570,3520,70.4
3626,Saúde,28,1,1,0,1600,120,1720,61.42857
3627,Perdizes,40,1,1,1,2000,890,2890,72.25
3628,Santa Cecília,90,2,2,1,2600,1000,3600,40.0
3629,Itaim Bibi,151,3,5,3,17500,3000,20500,135.7616
3630,Vila Andrade,94,2,3,2,3500,700,4200,44.68085
3631,Vila Olímpia,72,3,2,2,3300,1246,4546,63.13889
3632,Pinheiros,140,3,3,1,5000,1300,6300,45.0
3633,Santana,39,1,1,1,1600,640,2240,57.435898
3634,Centro,75,1,1,0,1200,900,2100,28.0
3635,Aclimação,46,2,1,1,2250,400,2650,57.608696
3636,Pinheiros,135,3,3,1,4000,700,4700,34.814816
3637,Vila Olímpia,46,1,1,1,2800,750,3550,77.17391
3638,Bela Vista,60,2,1,2,2250,824,3074,51.233334
3639,Pinheiros,63,2,2,1,4700,990,5690,90.31746
3640,Ipiranga,50,1,1,1,2000,0,2000,40.0
3641,Pinheiros,90,2,2,2,6500,938,7438,82.64445
3642,Aclimação,65,2,2,2,4500,0,4500,69.23077
3643,Itaim Bibi,90,2,2,1,6500,1006,7506,83.4
3644,Vila Nova Conceição,104,2,2,2,10900,1400,12300,118.26923
3645,Outro,47,1,1,1,2200,475,2675,56.914894
3646,Pinheiros,60,2,2,2,4500,830,5330,88.833336
3647,Pinheiros,30,1,1,1,3000,550,3550,118.333336
3648,Pinheiros,63,2,1,0,1699,635,2334,37.04762
3649,Vila Olímpia,98,2,1,2,5000,950,5950,60.714287
3650,Vila Clementino,57,2,2,1,3350,728,4078,71.54386
3651,Paraíso,66,2,1,1,2800,1129,3929,59.530304
3652,Mirandópolis,38,1,1,1,1000,943,1943,51.13158
3653,Móoca,64,2,2,1,2700,800,3500,54.6875
3654,Vila Clementino,274,3,6,0,15000,4369,19369,70.68978
3655,Barra Funda,20,1,1,0,1050,0,1050,52.5
3656,Móoca,70,2,2,2,2500,850,3350,47.857143
3657,Pinheiros,70,2,2,2,4200,864,5064,72.34286
3658,Vila Carrão,62,3,1,1,1850,520,2370,38.225807
3659,Vila Andrade,75,3,3,2,1800,900,2700,36.0
3660,Brás,70,3,2,1,2300,481,2781,39.728573
3661,Itaim Bibi,105,2,3,1,6000,1433,7433,70.790474
3662,Outro,300,3,4,4,45000,5800,50800,169.33333
3663,Outro,54,2,1,1,1300,270,1570,29.074074
3664,Tatuapé,35,1,1,0,1400,155,1555,44.42857
3665,Campos Eliseos,52,2,1,1,2300,391,2691,51.75
3666,Paraíso,45,1,1,1,2000,573,2573,57.177776
3667,Outro,44,2,1,1,1000,0,1000,22.727272
3668,Pinheiros,60,2,2,1,4710,810,5520,92.0
3669,Pinheiros,42,2,1,1,2300,279,2579,61.404762
3670,Vila Olímpia,57,2,1,1,2500,1200,3700,64.91228
3671,Itaim Bibi,45,1,1,1,2500,1500,4000,88.888885
3672,Outro,47,2,1,1,680,220,900,19.148935
3673,Tatuapé,178,3,5,3,10000,1500,11500,64.60674
3674,Jardim Prudência,57,2,3,1,2400,580,2980,52.2807
3675,Aclimação,176,4,4,3,8900,1400,10300,58.522728
3676,Perdizes,69,3,2,1,2500,867,3367,48.7971
3677,Itaim Bibi,98,2,3,1,4900,1174,6074,61.97959
3678,Vila Mascote,60,2,2,1,1800,650,2450,40.833332
3679,Outro,30,1,1,0,900,150,1050,35.0
3680,Vila Leopoldina,35,1,1,0,1800,300,2100,60.0
3681,Vila Andrade,97,3,3,2,4000,1400,5400,55.670105
3682,Brooklin,238,4,5,4,20000,2997,22997,96.62605
3683,Vila Olímpia,95,2,2,2,7900,1225,9125,96.052635
3684,Outro,69,2,3,1,2200,1020,3220,46.666668
3685,Perdizes,60,2,3,2,2900,1170,4070,67.833336
3686,Bela Vista,65,2,1,1,2800,1060,3860,59.384617
3687,Outro,50,2,2,1,1500,700,2200,44.0
3688,Brooklin,185,3,2,2,4685,1008,5693,30.772972
3689,Higienópolis,80,2,1,1,3500,685,4185,52.3125
3690,Vila Leopoldina,72,2,2,1,2600,800,3400,47.22222
3691,Vila Romana,60,2,2,1,3000,584,3584,59.733334
3692,Barra Funda,71,3,2,1,3300,625,3925,55.28169
3693,Itaim Bibi,118,3,3,2,4995,2041,7036,59.627117
3694,Moema,45,1,1,1,2100,481,2581,57.355556
3695,Outro,67,3,1,1,2300,446,2746,40.985073
3696,Vila Mariana,58,2,2,1,2350,695,3045,52.5
3697,Pompeia,87,3,2,2,2600,1400,4000,45.977013
3698,Pompeia,87,3,2,2,2600,1400,4000,45.977013
3699,Outro,48,2,1,1,1100,0,1100,22.916666
3700,Outro,66,2,1,2,2750,715,3465,52.5
3701,Jardim Paulista,406,3,6,3,25000,5056,30056,74.02956
3702,Outro,117,3,3,3,3500,1309,4809,41.102566
3703,Pinheiros,48,1,1,1,4063,957,5020,104.583336
3704,Jardim Marajoara,81,3,2,1,2700,700,3400,41.975307
3705,Barra Funda,40,1,1,1,2000,520,2520,63.0
3706,Vila Leopoldina,175,4,5,2,6500,1596,8096,46.262856
3707,Brás,55,2,1,1,1550,405,1955,35.545456
3708,Vila Andrade,134,2,2,2,4300,786,5086,37.955223
3709,Aclimação,167,3,2,1,3000,1150,4150,24.8503
3710,Cerqueira César,130,3,3,2,8000,980,8980,69.07692
3711,Bela Vista,80,2,1,0,1700,955,2655,33.1875
3712,Itaim Bibi,116,2,3,1,5950,1900,7850,67.67242
3713,Higienópolis,80,3,3,2,4700,1070,5770,72.125
3714,Panamby,715,5,8,8,65000,8777,73777,103.184616
3715,Alto Da Boa Vista,63,2,2,2,3500,669,4169,66.17461
3716,Consolação,113,3,2,1,3600,1451,5051,44.699116
3717,Outro,77,2,2,0,5650,800,6450,83.766235
3718,Itaim Bibi,55,2,1,1,2000,713,2713,49.327274
3719,Chácara Santo Antônio,93,2,2,2,5500,1650,7150,76.88172
3720,Brooklin,145,3,5,3,8999,1400,10399,71.71724
3721,Outro,130,2,2,1,3300,790,4090,31.461538
3722,Itaim Bibi,74,1,1,1,2700,1810,4510,60.945946
3723,Freguesia do Ó,75,3,2,1,1600,590,2190,29.2
3724,República,30,1,1,0,1800,395,2195,73.166664
3725,Brooklin,87,2,2,1,3200,644,3844,44.183907
3726,Vila Nova Conceição,60,2,1,1,5500,0,5500,91.666664
3727,Aclimação,50,1,1,1,1700,590,2290,45.8
3728,Jardim Europa,184,3,3,1,15396,3059,18455,100.29891
3729,Vila Mariana,50,1,1,1,1700,982,2682,53.64
3730,Pinheiros,50,2,1,1,2500,800,3300,66.0
3731,Vila Leopoldina,87,3,2,2,3500,550,4050,46.551723
3732,Morumbi,120,3,3,2,3500,1100,4600,38.333332
3733,Campo Belo,194,3,5,4,13500,2000,15500,79.896904
3734,Outro,110,3,3,2,2550,1200,3750,34.090908
3735,Paraíso,195,3,3,2,4800,1604,6404,32.841026
3736,Liberdade,70,3,2,0,1500,798,2298,32.82857
3737,Outro,60,2,2,1,1700,412,2112,35.2
3738,Higienópolis,236,3,3,2,4500,2049,6549,27.75
3739,Jaguaré,70,3,1,1,2800,442,3242,46.314285
3740,Chácara Klabin,105,3,2,2,4200,961,5161,49.15238
3741,Outro,70,2,2,1,6000,0,6000,85.71429
3742,Aclimação,170,3,2,3,11000,1100,12100,71.17647
3743,Chácara Santo Antônio,51,1,1,1,2990,875,3865,75.78432
3744,Campo Belo,35,1,1,1,3450,0,3450,98.57143
3745,Brooklin,86,3,2,2,3400,800,4200,48.837208
3746,Brás,50,2,1,1,1350,401,1751,35.02
3747,Móoca,70,3,1,1,1800,500,2300,32.857143
3748,Ipiranga,50,2,2,2,2200,860,3060,61.2
3749,Jardim Paulista,30,1,1,1,1200,798,1998,66.6
3750,Vila Cruzeiro,68,2,2,1,4700,800,5500,80.882355
3751,Bela Vista,96,3,2,0,2700,900,3600,37.5
3752,Vila Mariana,41,1,2,1,2000,490,2490,60.73171
3753,Consolação,362,4,6,4,20000,4146,24146,66.70166
3754,Vila Mariana,70,3,2,1,1850,730,2580,36.857143
3755,Pinheiros,30,1,1,0,2750,400,3150,105.0
3756,Morumbi,50,2,1,1,1750,450,2200,44.0
3757,Outro,20,1,1,0,1250,0,1250,62.5
3758,Vila Andrade,100,3,2,2,2990,948,3938,39.38
3759,Outro,51,1,1,1,3300,545,3845,75.39216
3760,Moema,144,4,5,3,5500,1875,7375,51.21528
3761,Higienópolis,160,3,6,3,5900,1900,7800,48.75
3762,Morumbi,326,4,4,4,4100,3000,7100,21.77914
3763,Campo Belo,35,1,1,1,2600,610,3210,91.71429
3764,Jardim Paulista,32,1,1,1,1700,925,2625,82.03125
3765,Sumaré,83,3,3,2,3800,1500,5300,63.855423
3766,Brooklin,70,2,1,1,4400,650,5050,72.14286
3767,Brooklin,85,1,2,2,6000,950,6950,81.76471
3768,Chácara Klabin,75,3,2,1,2000,925,2925,39.0
3769,Outro,49,2,1,1,1250,565,1815,37.040817
3770,Moema,70,2,2,2,4800,790,5590,79.85714
3771,Campo Belo,40,1,1,1,1800,648,2448,61.2
3772,Outro,626,3,4,5,18000,6500,24500,39.13738
3773,Vila Nova Conceição,54,1,2,1,7000,1070,8070,149.44444
3774,Bela Vista,48,1,1,1,1700,900,2600,54.166668
3775,Saúde,35,1,1,1,2400,460,2860,81.71429
3776,Itaim Bibi,191,2,2,2,13500,2150,15650,81.93717
3777,Moema,70,2,2,2,4500,850,5350,76.42857
3778,Campos Eliseos,82,1,2,0,1000,450,1450,17.682926
3779,Santo Amaro,100,3,2,1,2999,920,3919,39.19
3780,Vila Olímpia,156,3,5,4,15000,1500,16500,105.76923
3781,Cerqueira César,40,1,1,1,1900,774,2674,66.85
3782,Vila Mariana,95,2,2,2,6200,1150,7350,77.36842
3783,Jardim Europa,557,4,6,7,100000,12000,112000,201.0772
3784,Vila Nova Conceição,151,2,3,3,17500,2490,19990,132.38411
3785,Outro,52,2,1,1,1250,0,1250,24.038462
3786,Barra Funda,82,3,1,1,3800,645,4445,54.207317
3787,Moema,75,2,2,1,5900,780,6680,89.066666
3788,Itaim Bibi,77,1,2,2,8000,1700,9700,125.97403
3789,Itaim Bibi,56,2,2,1,6500,541,7041,125.73214
3790,Outro,24,1,1,0,1700,370,2070,86.25
3791,Vila Mascote,93,3,3,2,4500,0,4500,48.387096
3792,Bela Vista,45,2,1,1,2700,431,3131,69.577774
3793,Outro,105,3,1,1,3000,1185,4185,39.857143
3794,Outro,35,1,1,1,900,440,1340,38.285713
3795,Bela Vista,14,1,1,0,1656,158,1814,129.57143
3796,Outro,62,2,1,1,1000,350,1350,21.774193
3797,Barra Funda,57,2,2,2,2500,570,3070,53.85965
3798,Bela Vista,42,1,1,1,2400,415,2815,67.02381
3799,Centro,85,2,2,0,2500,500,3000,35.294117
3800,Mirandópolis,98,3,3,2,4500,893,5393,55.030613
3801,Outro,40,1,1,0,790,0,790,19.75
3802,Pinheiros,50,2,1,1,3200,750,3950,79.0
3803,Moema,80,2,2,1,3485,911,4396,54.95
3804,Pinheiros,62,2,2,1,3500,0,3500,56.451614
3805,Mirandópolis,60,3,2,2,1800,430,2230,37.166668
3806,Pompeia,75,3,2,2,3200,1100,4300,57.333332
3807,Outro,63,2,1,1,1700,925,2625,41.666668
3808,Móoca,34,1,1,0,2100,270,2370,69.70588
3809,Vila Mascote,86,3,4,2,2600,1054,3654,42.488373
3810,Higienópolis,60,1,1,1,2200,550,2750,45.833332
3811,Tatuapé,26,1,1,1,1700,480,2180,83.84615
3812,Jardins,140,3,3,2,4500,1339,5839,41.70714
3813,Brooklin,48,1,1,1,3500,800,4300,89.583336
3814,Alto Da Boa Vista,35,1,1,1,1950,695,2645,75.57143
3815,Consolação,40,1,1,1,2500,0,2500,62.5
3816,Lapa,70,2,1,1,1800,500,2300,32.857143
3817,Campo Belo,49,1,1,1,3000,600,3600,73.46939
3818,Higienópolis,500,4,6,5,39000,8300,47300,94.6
3819,Moema,95,3,4,2,4200,1130,5330,56.105263
3820,Jardim América,27,1,1,1,2200,461,2661,98.55556
3821,Pinheiros,40,1,1,1,2200,974,3174,79.35
3822,Outro,23,1,1,0,2250,380,2630,114.347824
3823,Chácara Santo Antônio,95,2,2,2,6500,700,7200,75.789474
3824,Bela Vista,28,1,1,0,1400,545,1945,69.46429
3825,Granja Julieta,47,1,1,1,3000,500,3500,74.46809
3826,Outro,36,2,2,0,1200,190,1390,38.61111
3827,Campo Belo,48,1,1,1,3400,699,4099,85.395836
3828,Outro,72,3,2,2,3200,730,3930,54.583332
3829,Móoca,65,2,2,1,2300,660,2960,45.53846
3830,Moema,287,4,5,4,28000,3500,31500,109.756096
3831,Saúde,53,2,2,1,1700,380,2080,39.24528
3832,Ipiranga,67,2,1,1,2600,585,3185,47.53731
3833,Vila Olímpia,75,3,3,2,3000,1200,4200,56.0
3834,República,23,1,1,0,1150,248,1398,60.782608
3835,Bela Vista,80,2,2,1,3800,930,4730,59.125
3836,Pirituba,51,2,1,1,1265,340,1605,31.470589
3837,Jardins,114,2,4,2,10500,2100,12600,110.52631
3838,Vila Nova Conceição,167,3,3,3,16485,2100,18585,111.28742
3839,Paraíso,110,3,2,1,2800,1348,4148,37.70909
3840,Outro,60,2,2,1,1040,544,1584,26.4
3841,Vila Mariana,51,2,2,1,1950,750,2700,52.941177
3842,Pinheiros,45,1,2,1,2600,786,3386,75.244446
3843,Vila Olímpia,67,2,2,1,3000,867,3867,57.71642
3844,Bela Vista,40,1,1,1,1000,437,1437,35.925
3845,Vila Buarque,45,2,1,1,1500,500,2000,44.444443
3846,Pinheiros,71,2,2,1,5000,584,5584,78.64789
3847,Outro,57,3,1,1,1470,400,1870,32.80702
3848,Paraíso,76,3,2,1,3200,750,3950,51.973682
3849,Vila Olímpia,110,3,3,1,3300,950,4250,38.636364
3850,Saúde,98,3,3,2,3000,1130,4130,42.142857
3851,Outro,77,2,2,2,3100,0,3100,40.25974
3852,Vila Mariana,90,3,2,1,2400,910,3310,36.77778
3853,Cambuci,40,2,1,0,1700,320,2020,50.5
3854,Outro,67,3,2,1,1900,600,2500,37.313435
3855,Sumaré,74,2,3,2,5500,880,6380,86.21622
3856,Jardim Paulista,44,1,1,1,4200,880,5080,115.454544
3857,Vila Madalena,70,2,2,1,4000,830,4830,69.0
3858,Ipiranga,80,2,2,1,2000,260,2260,28.25
3859,Vila Mariana,73,2,1,2,4000,0,4000,54.79452
3860,Brooklin,144,4,3,2,6000,2300,8300,57.63889
3861,Outro,37,1,1,1,1500,140,1640,44.324326
3862,Ipiranga,59,2,2,1,2200,866,3066,51.966103
3863,Brooklin,68,2,3,1,2664,1031,3695,54.338234
3864,Outro,30,1,1,0,1150,150,1300,43.333332
3865,Mirandópolis,63,2,2,2,3800,1050,4850,76.98412
3866,Outro,30,1,1,0,500,0,500,16.666666
3867,Perdizes,50,1,1,1,2200,650,2850,57.0
3868,Itaim Bibi,55,2,1,1,3000,0,3000,54.545456
3869,Outro,68,2,2,1,2200,500,2700,39.705883
3870,Paraíso,200,4,6,3,7500,2150,9650,48.25
3871,Outro,76,3,1,1,1800,840,2640,34.736843
3872,Vila Cruzeiro,60,2,2,2,3600,780,4380,73.0
3873,Vila Olímpia,65,1,1,2,6490,2065,8555,131.61539
3874,Paraíso,120,3,4,2,6900,1500,8400,70.0
3875,Vila Gomes Cardim,82,3,2,1,1400,950,2350,28.658537
3876,Bela Vista,56,1,2,1,4200,933,5133,91.66071
3877,Bela Vista,45,1,1,1,2199,602,2801,62.244446
3878,Outro,40,1,1,1,640,360,1000,25.0
3879,Tatuapé,80,2,2,0,1400,230,1630,20.375
3880,Outro,140,3,3,2,3800,1400,5200,37.142857
3881,Vila Clementino,55,2,1,0,2200,690,2890,52.545456
3882,Lapa,55,2,2,1,2300,410,2710,49.272728
3883,Moema,195,3,4,3,12000,2800,14800,75.89744
3884,Saúde,60,2,1,1,2250,750,3000,50.0
3885,Vila Madalena,45,2,1,1,2300,336,2636,58.577778
3886,Butantã,67,2,1,1,3200,637,3837,57.268658
3887,Pinheiros,140,2,4,2,8000,1420,9420,67.28571
3888,Consolação,44,1,1,0,1900,437,2337,53.113636
3889,Vila Mariana,72,2,3,2,4600,1266,5866,81.47222
3890,Campo Belo,50,1,2,2,4200,685,4885,97.7
3891,Pinheiros,95,3,4,2,5500,1326,6826,71.85263
3892,Outro,33,1,1,0,1100,70,1170,35.454544
3893,Móoca,50,2,1,1,1550,607,2157,43.14
3894,Vila Mariana,38,1,1,1,1500,650,2150,56.57895
3895,Vila Olímpia,69,2,2,1,3000,940,3940,57.101448
3896,Pompeia,70,2,1,0,1900,100,2000,28.571428
3897,Vila Mariana,72,2,1,1,2300,820,3120,43.333332
3898,Consolação,60,1,1,1,2000,595,2595,43.25
3899,Vila Olímpia,110,3,3,0,3800,1050,4850,44.090908
3900,Outro,55,2,1,1,1700,550,2250,40.909092
3901,Santa Cecília,50,2,1,1,1900,502,2402,48.04
3902,Cambuci,50,2,1,1,2000,800,2800,56.0
3903,Pinheiros,40,1,1,1,3610,860,4470,111.75
3904,Outro,83,3,3,2,2200,795,2995,36.08434
3905,Vila Mascote,84,3,3,2,2300,1142,3442,40.97619
3906,Jardim Paulista,101,2,2,1,6000,1277,7277,72.04951
3907,Pinheiros,60,2,1,0,2000,485,2485,41.416668
3908,Outro,42,2,1,1,1350,0,1350,32.142857
3909,Outro,200,2,4,3,12950,3408,16358,81.79
3910,Vila Nova Conceição,71,2,1,1,3000,698,3698,52.084507
3911,Ipiranga,40,1,1,1,1900,502,2402,60.05
3912,Outro,63,1,1,1,4150,620,4770,75.71429
3913,Outro,63,1,1,1,4150,620,4770,75.71429
3914,Outro,64,2,2,2,2270,970,3240,50.625
3915,Vila Clementino,51,2,1,1,2900,530,3430,67.254906
3916,Liberdade,72,3,2,2,3000,1100,4100,56.944443
3917,Outro,55,2,1,1,1300,370,1670,30.363636
3918,Itaim Bibi,40,1,1,1,2400,0,2400,60.0
3919,Cerqueira César,24,1,1,1,1700,620,2320,96.666664
3920,Brooklin,45,1,1,1,3999,586,4585,101.888885
3921,Santa Cecília,97,2,2,1,2200,1016,3216,33.15464
3922,Vila Mariana,93,3,2,0,3100,450,3550,38.172043
3923,Jardins,151,3,4,3,15000,3000,18000,119.2053
3924,Barra Funda,33,1,1,1,1850,510,2360,71.51515
3925,Centro,26,1,1,0,1650,350,2000,76.92308
3926,Brooklin,96,3,2,2,3900,1391,5291,55.114582
3927,Vila Mascote,198,4,4,3,2400,2415,4815,24.318182
3928,Outro,142,3,4,3,2900,1600,4500,31.690142
3929,Outro,54,2,1,1,1200,400,1600,29.62963
3930,Pinheiros,51,2,1,1,2500,658,3158,61.92157
3931,Moema,50,1,1,1,2100,860,2960,59.2
3932,Outro,50,2,1,0,850,0,850,17.0
3933,Bela Vista,50,2,2,1,3400,550,3950,79.0
3934,Santa Cecília,40,1,1,1,1400,518,1918,47.95
3935,Santa Cecília,98,3,3,2,4500,1047,5547,56.60204
3936,Vila Romana,69,2,2,1,4700,600,5300,76.81159
3937,Outro,49,2,1,1,1300,658,1958,39.959183
3938,Higienópolis,72,2,2,0,2500,473,2973,41.291668
3939,Consolação,43,1,1,1,1700,570,2270,52.7907
3940,Pinheiros,100,3,3,2,2200,2400,4600,46.0
3941,Vila Mariana,100,2,2,1,2500,800,3300,33.0
3942,Outro,60,2,2,1,2150,460,2610,43.5
3943,Vila Nova Conceição,107,1,4,1,18000,2140,20140,188.2243
3944,Brooklin,100,2,2,1,6750,990,7740,77.4
3945,Pompeia,53,2,1,1,2000,570,2570,48.490566
3946,Bela Vista,341,3,3,2,4500,3500,8000,23.460411
3947,Outro,50,2,1,1,1200,327,1527,30.54
3948,Moema,125,3,4,2,9000,1960,10960,87.68
3949,Vila Nova Conceição,40,1,1,1,3400,900,4300,107.5
3950,Consolação,60,2,1,0,2000,462,2462,41.033333
3951,Jardins,173,3,3,1,4500,1600,6100,35.260117
3952,Vila Cruzeiro,37,1,1,1,1900,540,2440,65.945946
3953,Jaguaré,84,3,2,1,1500,616,2116,25.190475
3954,Saúde,75,2,2,1,1600,834,2434,32.453335
3955,Jardim América,80,2,2,1,3000,706,3706,46.325
3956,Outro,30,1,1,0,1400,0,1400,46.666668
3957,Jardim Paulista,35,1,1,1,1800,509,2309,65.97143
3958,Outro,80,3,2,2,2800,741,3541,44.2625
3959,Barra Funda,63,2,2,1,2500,637,3137,49.79365
3960,Ipiranga,100,3,1,2,2000,1300,3300,33.0
3961,Brooklin,198,4,6,3,8000,3500,11500,58.080807
3962,Consolação,60,1,2,0,1500,430,1930,32.166668
3963,Barra Funda,58,2,2,0,2300,450,2750,47.41379
3964,Tatuapé,65,2,2,2,2200,575,2775,42.692307
3965,Pinheiros,44,1,1,1,3500,600,4100,93.181816
3966,Outro,40,1,1,0,650,0,650,16.25
3967,Vila Madalena,67,2,1,2,6000,952,6952,103.76119
3968,Vila Mariana,72,1,1,0,1400,230,1630,22.63889
3969,Jardins,74,2,2,1,4200,692,4892,66.10811
3970,Butantã,74,3,2,2,2200,690,2890,39.054054
3971,Brooklin,124,3,4,3,6500,1275,7775,62.701614
3972,Cambuci,80,2,2,0,1500,310,1810,22.625
3973,Tatuapé,173,3,5,3,5000,1900,6900,39.88439
3974,Outro,68,3,1,1,2300,800,3100,45.588234
3975,Paraíso,92,3,3,1,3100,1250,4350,47.282608
3976,Lapa,48,2,1,1,1950,365,2315,48.229168
3977,Vila Clementino,40,1,1,1,2300,450,2750,68.75
3978,Perdizes,65,2,2,2,3100,850,3950,60.76923
3979,Vila Nova Conceição,180,3,4,1,8000,3215,11215,62.305557
3980,Vila Nova Conceição,103,1,2,1,11925,1900,13825,134.2233
3981,Bela Vista,100,2,2,1,2100,850,2950,29.5
3982,Ipiranga,141,3,5,3,6100,1466,7566,53.659573
3983,Paraíso,100,2,1,1,4000,950,4950,49.5
3984,Butantã,45,2,1,0,950,0,950,21.11111
3985,Outro,55,2,2,1,2490,565,3055,55.545456
3986,Outro,43,2,1,0,1590,185,1775,41.279068
3987,Brás,55,2,1,1,1400,470,1870,34.0
3988,Outro,111,3,4,2,4500,1300,5800,52.25225
3989,Jardim Marajoara,95,3,1,2,3650,847,4497,47.33684
3990,Pompeia,48,1,1,1,2484,650,3134,65.291664
3991,Vila Guarani,40,1,1,1,1500,406,1906,47.65
3992,Bela Vista,82,2,2,2,2400,484,2884,35.17073
3993,Outro,49,2,1,1,1200,485,1685,34.387756
3994,Vila Mariana,60,2,2,1,2400,1100,3500,58.333332
3995,Santana,104,3,4,2,2300,1316,3616,34.76923
3996,Água Branca,73,2,2,2,2950,850,3800,52.054794
3997,Higienópolis,75,2,3,1,3200,681,3881,51.746666
3998,Vila Clementino,99,2,3,2,4600,966,5566,56.22222
3999,Outro,60,2,1,1,2000,694,2694,44.9
4000,Jardim Paulista,65,1,2,2,4900,940,5840,89.84615
4001,Moema,110,3,4,2,2500,2187,4687,42.609093
4002,Cambuci,110,3,3,2,3500,1500,5000,45.454544
4003,Pinheiros,70,3,3,1,2700,1032,3732,53.314285
4004,Paraíso,57,1,1,1,1350,345,1695,29.736841
4005,Bela Vista,45,1,1,1,2200,705,2905,64.55556
4006,Água Branca,40,1,1,1,2200,630,2830,70.75
4007,Saúde,68,3,2,1,2100,698,2798,41.14706
4008,Saúde,74,3,2,1,2200,700,2900,39.18919
4009,Itaim Bibi,204,4,5,3,12700,4410,17110,83.87255
4010,Barra Funda,93,3,3,2,2600,750,3350,36.021507
4011,Santana,34,1,1,1,2000,500,2500,73.52941
4012,Bela Vista,50,2,1,0,2500,536,3036,60.72
4013,Moema,55,2,2,1,2480,520,3000,54.545456
4014,Pompeia,36,1,1,1,2200,530,2730,75.833336
4015,Vila Prudente,48,2,1,1,2000,450,2450,51.041668
4016,Moema,50,1,2,1,2742,600,3342,66.84
4017,Vila Guarani,55,2,1,1,1950,754,2704,49.163635
4018,Santana,102,3,4,2,2000,1300,3300,32.35294
4019,Santo Amaro,55,1,2,1,3800,850,4650,84.545456
4020,Pompeia,41,1,1,1,2100,594,2694,65.70731
4021,Vila Nova Conceição,80,2,2,2,10000,1500,11500,143.75
4022,Outro,63,2,3,2,2900,984,3884,61.650795
4023,Perdizes,62,2,2,1,4600,750,5350,86.29032
4024,Jardim Paulista,140,3,4,1,8000,2100,10100,72.14286
4025,Morumbi,55,2,2,1,1500,750,2250,40.909092
4026,Moema,157,4,5,2,13250,1590,14840,94.52229
4027,Butantã,72,2,2,1,2000,1000,3000,41.666668
4028,Vila Leopoldina,83,3,3,2,3300,950,4250,51.20482
4029,Tatuapé,50,2,1,1,1420,291,1711,34.22
4030,Ipiranga,10,1,1,0,950,0,950,95.0
4031,Pinheiros,25,1,1,0,2800,220,3020,120.8
4032,Outro,211,3,5,4,4700,1803,6503,30.819904
4033,Pompeia,60,2,2,1,2400,896,3296,54.933334
4034,Bela Vista,35,1,1,1,2200,435,2635,75.28571
4035,Vila Mariana,31,1,1,1,2420,528,2948,95.09677
4036,Alto da Lapa,105,2,3,1,3500,830,4330,41.238094
4037,Outro,70,3,2,2,2000,890,2890,41.285713
4038,Moema,90,3,3,2,3600,1010,4610,51.22222
4039,Jardim Paulista,79,3,3,1,3500,862,4362,55.21519
4040,Outro,58,3,2,0,1800,527,2327,40.12069
4041,Morumbi,61,2,2,1,3450,10,3460,56.72131
4042,Água Branca,168,4,4,3,7000,1250,8250,49.107143
4043,Vila Leopoldina,73,2,3,1,2550,790,3340,45.753426
4044,Vila Formosa,54,2,1,1,1900,426,2326,43.074074
4045,Saúde,87,3,2,1,2300,565,2865,32.931034
4046,Vila Anastácio,50,1,1,1,1900,600,2500,50.0
4047,Cidade Monções,41,1,1,1,3000,620,3620,88.29269
4048,Vila Olímpia,95,1,2,2,8500,2200,10700,112.63158
4049,Vila Olímpia,65,2,2,1,3000,1050,4050,62.307693
4050,Vila Nova Conceição,103,1,1,2,5471,2154,7625,74.02913
4051,Aclimação,70,2,1,1,1800,600,2400,34.285713
4052,Outro,128,3,3,2,3000,900,3900,30.46875
4053,Vila Olímpia,48,1,1,1,3200,900,4100,85.416664
4054,Vila Olímpia,56,2,1,1,4500,720,5220,93.21429
4055,Aclimação,37,1,1,1,2260,530,2790,75.4054
4056,Itaim Bibi,60,2,2,1,3000,938,3938,65.63333
4057,Itaim Bibi,60,2,2,1,3000,938,3938,65.63333
4058,Vila Prudente,233,4,5,3,1900,2416,4316,18.523605
4059,Centro,48,1,2,1,1900,550,2450,51.041668
4060,Vila Mascote,150,3,2,3,3000,1500,4500,30.0
4061,Brooklin,52,1,2,1,3600,478,4078,78.42308
4062,Vila Andrade,50,2,1,1,2000,350,2350,47.0
4063,Vila Mariana,120,3,1,2,4600,700,5300,44.166668
4064,Higienópolis,130,3,2,2,3800,1325,5125,39.423077
4065,Vila Nova Conceição,192,4,5,4,25000,2950,27950,145.57292
4066,Campo Belo,35,1,1,1,1752,478,2230,63.714287
4067,Vila Olímpia,120,2,3,3,12500,2000,14500,120.833336
4068,Vila Prudente,48,2,1,1,2100,0,2100,43.75
4069,Santa Cecília,125,2,2,2,2500,1000,3500,28.0
4070,Vila Mariana,137,2,2,1,1900,560,2460,17.956203
4071,Outro,240,4,4,3,3300,2800,6100,25.416666
4072,Vila Olímpia,49,1,1,2,8000,0,8000,163.2653
4073,Tatuapé,54,2,2,2,3000,620,3620,67.03704
4074,Consolação,75,2,1,1,2500,749,3249,43.32
4075,Brooklin,45,1,1,1,2000,870,2870,63.77778
4076,Bela Vista,62,2,2,1,4500,760,5260,84.83871
4077,Paraíso,65,2,2,1,2000,842,2842,43.723076
4078,Itaim Bibi,50,1,2,1,5000,719,5719,114.38
4079,Pinheiros,24,1,1,1,1600,500,2100,87.5
4080,Moema,103,3,2,1,4800,968,5768,56.0
4081,Ipiranga,89,3,2,0,1700,0,1700,19.101124
4082,Perdizes,80,3,2,2,3000,1340,4340,54.25
4083,Brooklin,85,3,2,2,7300,900,8200,96.47059
4084,Vila Mariana,70,2,2,1,1600,913,2513,35.9
4085,Outro,32,1,1,0,790,0,790,24.6875
4086,Pompeia,45,1,1,1,2000,523,2523,56.066666
4087,Tatuapé,55,2,2,1,1980,460,2440,44.363636
4088,Bela Vista,42,1,1,1,2500,650,3150,75.0
4089,Vila Nova Conceição,70,1,1,1,6300,1600,7900,112.85714
4090,Ipiranga,76,2,1,1,1500,343,1843,24.25
4091,Vila Madalena,134,3,2,1,3100,527,3627,27.067163
4092,Vila Buarque,32,1,1,0,1000,408,1408,44.0
4093,Santa Ifigênia,40,1,1,1,3300,586,3886,97.15
4094,Moema,78,1,2,1,3492,1160,4652,59.641026
4095,Campos Eliseos,38,1,1,1,1750,525,2275,59.86842
4096,Higienópolis,285,3,1,4,19500,7536,27036,94.86316
4097,Campos Eliseos,50,1,1,1,1550,790,2340,46.8
4098,Vila Santa Catarina,60,2,1,1,1600,438,2038,33.966667
4099,Tatuapé,85,3,4,2,3500,619,4119,48.458824
4100,Jardim Paulista,56,1,2,2,3080,1550,4630,82.67857
4101,Outro,120,2,4,2,2700,1544,4244,35.366665
4102,Aclimação,40,1,1,1,1900,558,2458,61.45
4103,Consolação,30,1,1,0,1550,550,2100,70.0
4104,Tatuapé,30,1,1,1,1600,328,1928,64.26667
4105,Outro,70,3,1,0,1300,0,1300,18.571428
4106,Pinheiros,70,2,2,0,2500,644,3144,44.914288
4107,Chácara Santo Antônio,105,3,2,1,2985,780,3765,35.857143
4108,Chácara Santo Antônio,70,2,2,1,3300,735,4035,57.642857
4109,Brooklin,96,3,2,2,3800,1300,5100,53.125
4110,Outro,40,1,1,0,1300,50,1350,33.75
4111,Mirandópolis,36,1,2,1,1600,450,2050,56.944443
4112,Jardins,95,2,2,1,2300,760,3060,32.210526
4113,Brooklin,90,2,2,2,4800,952,5752,63.91111
4114,Campo Belo,37,1,1,1,2000,538,2538,68.5946
4115,Centro,72,2,2,0,1850,500,2350,32.63889
4116,Higienópolis,56,2,2,1,2400,650,3050,54.464287
4117,Chácara Santo Antônio,70,2,2,1,3200,735,3935,56.214287
4118,Moema,130,3,4,1,5000,1347,6347,48.82308
4119,Perdizes,70,2,4,2,3300,1229,4529,64.7
4120,Jardim Paulista,98,3,2,1,4400,1133,5533,56.459183
4121,Santo Amaro,53,1,2,1,3700,920,4620,87.169815
4122,Moema,15,1,1,0,1590,295,1885,125.666664
4123,Vila Buarque,77,3,2,1,2100,830,2930,38.05195
4124,Santa Cecília,56,2,1,1,3000,680,3680,65.71429
4125,Aclimação,48,1,1,1,2000,426,2426,50.541668
4126,Barra Funda,132,3,4,2,6500,1000,7500,56.81818
4127,Vila Olímpia,103,2,4,1,3750,970,4720,45.82524
4128,Consolação,25,1,1,0,1800,276,2076,83.04
4129,Vila Nova Conceição,307,3,5,5,60000,8500,68500,223.12703
4130,Cerqueira César,120,2,1,1,3500,1197,4697,39.141666
4131,Granja Julieta,81,2,2,1,3600,850,4450,54.93827
4132,Vila Romana,67,1,1,1,1600,850,2450,36.567165
4133,Jabaquara,65,3,2,1,2700,580,3280,50.46154
4134,Itaim Bibi,98,3,2,1,3800,1298,5098,52.02041
4135,Aclimação,37,1,1,1,2260,530,2790,75.4054
4136,Outro,62,2,1,1,1300,600,1900,30.64516
4137,Outro,76,2,1,0,2000,467,2467,32.460526
4138,Santo Amaro,48,2,2,1,2200,570,2770,57.708332
4139,Brás,50,2,1,1,1300,350,1650,33.0
4140,Pompeia,65,2,2,2,3400,700,4100,63.076923
4141,Itaim Bibi,87,2,3,1,6000,1080,7080,81.37931
4142,Indianópolis,82,2,2,1,2800,940,3740,45.609756
4143,Morumbi,40,1,1,1,1050,645,1695,42.375
4144,Lapa,70,2,2,2,2800,500,3300,47.142857
4145,Vila Guarani,42,1,1,1,2000,0,2000,47.61905
4146,Cambuci,81,3,2,1,2750,705,3455,42.65432
4147,Santana,60,3,1,0,1600,200,1800,30.0
4148,Santana,123,3,2,2,4500,994,5494,44.666668
4149,Outro,42,2,1,1,2000,330,2330,55.47619
4150,Pinheiros,32,1,1,1,4485,300,4785,149.53125
4151,Outro,50,2,2,1,1500,100,1600,32.0
4152,Lapa,55,2,2,1,2000,410,2410,43.81818
4153,Saúde,50,2,1,1,1500,366,1866,37.32
4154,Vila Sônia,64,2,2,1,2500,400,2900,45.3125
4155,Outro,65,3,1,1,1500,510,2010,30.923077
4156,Itaim Bibi,131,3,3,1,5000,945,5945,45.38168
4157,Vila Mascote,50,3,2,1,2500,321,2821,56.42
4158,Jardim Paulista,38,1,1,0,1600,130,1730,45.526318
4159,Jardim América,70,2,2,1,2500,1700,4200,60.0
4160,Itaim Bibi,150,3,4,2,13000,1500,14500,96.666664
4161,Santa Cecília,43,1,1,1,2240,554,2794,64.976746
4162,Bela Vista,32,1,1,1,1400,831,2231,69.71875
4163,Móoca,50,2,1,1,1500,350,1850,37.0
4164,Outro,48,2,1,1,1300,440,1740,36.25
4165,Morumbi,57,2,1,1,1870,720,2590,45.438595
4166,Saúde,30,1,1,1,1700,0,1700,56.666668
4167,Vila Leopoldina,130,3,4,2,6000,340,6340,48.76923
4168,Vila Clementino,42,1,1,1,1600,550,2150,51.190475
4169,Vila Olímpia,70,1,2,1,4550,1200,5750,82.14286
4170,Pinheiros,102,3,3,2,4800,1370,6170,60.490196
4171,Outro,47,2,1,1,1300,425,1725,36.70213
4172,Outro,51,2,1,1,1300,0,1300,25.490196
4173,Pinheiros,75,3,2,1,3500,1100,4600,61.333332
4174,Brooklin,22,1,1,0,2400,300,2700,122.72727
4175,Itaim Bibi,110,2,2,2,7500,2105,9605,87.318184
4176,Chácara Santo Antônio,95,2,3,2,6200,1000,7200,75.789474
4177,Vila Leopoldina,70,2,1,1,3000,901,3901,55.728573
4178,Outro,61,3,1,1,2500,607,3107,50.934425
4179,Moema,76,2,3,2,6400,1250,7650,100.6579
4180,Alto Da Boa Vista,70,1,1,1,3500,800,4300,61.42857
4181,Vila Olímpia,65,1,2,1,5800,1200,7000,107.69231
4182,Ipiranga,85,3,3,2,3500,563,4063,47.8
4183,Jardim Paulista,60,1,2,1,3500,650,4150,69.166664
4184,Barra Funda,101,2,2,2,3800,1060,4860,48.118813
4185,Vila Guarani,55,2,1,1,1500,785,2285,41.545456
4186,Vila Mariana,73,3,3,2,4100,500,4600,63.0137
4187,Santo Amaro,70,2,1,0,1410,326,1736,24.8
4188,Brooklin,80,2,1,1,1800,1492,3292,41.15
4189,Centro,40,1,1,0,1100,300,1400,35.0
4190,Vila Prudente,44,2,1,1,1400,305,1705,38.75
4191,Outro,48,2,1,1,1300,316,1616,33.666668
4192,Vila Olímpia,93,2,3,2,7500,1250,8750,94.08602
4193,Jardim Europa,229,2,4,2,11000,2150,13150,57.42358
4194,Santana,86,2,1,1,1850,686,2536,29.488373
4195,Campo Belo,50,1,1,0,3200,587,3787,75.74
4196,Vila Madalena,310,4,4,4,16000,3898,19898,64.187096
4197,Bela Vista,34,1,1,1,2400,600,3000,88.23529
4198,Vila Mariana,94,3,2,1,3000,750,3750,39.893616
4199,Paraíso,157,3,2,1,4300,1325,5625,35.828026
4200,Higienópolis,27,1,1,0,1650,242,1892,70.07407
4201,Outro,49,2,1,1,1690,430,2120,43.265305
4202,Centro,54,2,1,0,1300,329,1629,30.166666
4203,Vila Clementino,68,2,2,1,4200,0,4200,61.764706
4204,Pinheiros,35,1,1,1,2800,0,2800,80.0
4205,Brooklin,52,1,1,1,3200,600,3800,73.07692
4206,Brooklin,70,2,2,1,4922,600,5522,78.88571
4207,Barra Funda,85,1,1,0,1590,365,1955,23.0
4208,Outro,46,2,1,1,1390,0,1390,30.217392
4209,Jardim Marajoara,93,3,2,1,2400,870,3270,35.16129
4210,Liberdade,55,2,1,0,1400,564,1964,35.70909
4211,Brooklin,58,2,2,1,3400,710,4110,70.86207
4212,Campo Belo,210,3,5,3,12290,2200,14490,69.0
4213,Vila Mariana,75,2,2,1,5500,670,6170,82.26667
4214,Brooklin,84,1,2,2,6000,901,6901,82.15476
4215,Santo Amaro,73,1,1,0,1250,485,1735,23.767124
4216,Outro,32,2,1,0,1200,190,1390,43.4375
4217,Pinheiros,75,2,2,2,2800,1100,3900,52.0
4218,Vila Gomes Cardim,182,3,3,3,10000,2000,12000,65.93407
4219,Vila Nova Conceição,161,4,5,3,16500,2900,19400,120.496895
4220,Aclimação,38,1,1,1,4000,600,4600,121.052635
4221,Jaguaré,82,2,2,1,2400,620,3020,36.82927
4222,Vila Olímpia,120,2,3,3,9550,2000,11550,96.25
4223,Jardim Paulista,113,2,3,2,10000,1400,11400,100.88496
4224,Pinheiros,47,1,1,1,3450,740,4190,89.14893
4225,Bela Vista,33,1,1,1,2900,585,3485,105.606064
4226,Aclimação,115,3,3,2,1900,904,2804,24.382608
4227,Barra Funda,71,3,2,2,3500,826,4326,60.929577
4228,Móoca,50,2,1,1,2200,350,2550,51.0
4229,Bela Vista,55,1,1,0,1100,1318,2418,43.963634
4230,Alto Da Boa Vista,45,1,1,1,2200,380,2580,57.333332
4231,Vila Mariana,50,1,1,0,1900,440,2340,46.8
4232,Outro,51,2,1,1,1500,377,1877,36.80392
4233,Vila Clementino,135,4,4,2,4500,1393,5893,43.65185
4234,Jaguaré,70,3,2,1,2800,550,3350,47.857143
4235,Água Branca,34,1,1,1,2500,830,3330,97.94118
4236,Higienópolis,130,3,2,1,3500,2160,5660,43.53846
4237,Brooklin,72,2,2,2,4400,700,5100,70.833336
4238,Bela Vista,100,3,3,2,3200,1350,4550,45.5
4239,Vila Mariana,68,2,2,1,2300,605,2905,42.72059
4240,Moema,34,1,1,0,3060,600,3660,107.64706
4241,Vila Leopoldina,56,2,1,1,2600,550,3150,56.25
4242,Perdizes,72,3,2,1,2700,754,3454,47.97222
4243,Brooklin,55,2,2,1,2800,548,3348,60.872726
4244,Móoca,96,2,2,2,3800,850,4650,48.4375
4245,Moema,36,1,1,1,1800,700,2500,69.44444
4246,Vila Olímpia,76,2,2,2,4200,1100,5300,69.73684
4247,Vila Clementino,45,1,1,1,1950,425,2375,52.77778
4248,Vila Olímpia,82,2,3,1,15000,1100,16100,196.34146
4249,Outro,50,2,1,1,1200,478,1678,33.56
4250,Vila Clementino,97,3,3,2,2200,1435,3635,37.474228
4251,Jaguaré,90,3,3,2,1600,500,2100,23.333334
4252,Outro,238,4,6,4,9000,1535,10535,44.264706
4253,Moema,69,2,1,1,2000,998,2998,43.449276
4254,Morumbi,50,2,1,1,1400,1,1401,28.02
4255,Vila Clementino,112,3,3,2,2800,1300,4100,36.607143
4256,Jardim Paulista,113,2,3,2,8000,1400,9400,83.185844
4257,Moema,72,2,3,2,3700,867,4567,63.430557
4258,Santa Cecília,35,1,1,1,2300,550,2850,81.42857
4259,Tatuapé,67,2,2,2,2600,598,3198,47.731342
4260,Butantã,60,2,1,1,1800,453,2253,37.55
4261,Outro,64,3,2,1,1700,350,2050,32.03125
4262,Bela Vista,90,2,1,0,1900,795,2695,29.944445
4263,Vila Olímpia,43,1,1,1,3100,600,3700,86.04651
4264,Moema,123,3,4,2,8000,1250,9250,75.203255
4265,Saúde,75,3,2,1,2100,900,3000,40.0
4266,Santa Cecília,105,3,2,2,2800,1450,4250,40.47619
4267,Santa Cecília,42,1,1,1,1900,551,2451,58.357143
4268,Vila Olímpia,60,2,2,1,3000,867,3867,64.45
4269,Outro,61,3,1,1,1400,749,2149,35.229507
4270,Consolação,40,2,1,0,950,627,1577,39.425
4271,Consolação,34,1,1,1,3000,200,3200,94.117645
4272,Tatuapé,134,2,4,2,5700,800,6500,48.50746
4273,Itaim Bibi,202,4,3,3,21000,3500,24500,121.28713
4274,Moema,226,3,5,4,25000,3700,28700,126.99115
4275,Vila Olímpia,35,1,1,1,3200,700,3900,111.42857
4276,Paraíso,80,2,2,1,2300,1093,3393,42.4125
4277,Vila Mariana,245,4,5,4,15000,1800,16800,68.57143
4278,Jardim Marajoara,52,2,1,1,1700,472,2172,41.76923
4279,Jardim Paulista,75,2,2,1,3000,811,3811,50.81333
4280,Brás,44,2,1,1,1620,280,1900,43.18182
4281,Campo Belo,110,3,2,2,3797,1800,5597,50.881817
4282,Alto da Lapa,45,1,1,1,1800,515,2315,51.444443
4283,Pinheiros,80,2,1,1,2150,760,2910,36.375
4284,Vila Mariana,56,2,1,2,3500,802,4302,76.82143
4285,Pinheiros,131,3,5,2,7200,1680,8880,67.78626
4286,Moema,40,1,1,1,1600,1050,2650,66.25
4287,Campo Belo,43,1,1,1,1500,580,2080,48.372093
4288,Outro,50,2,1,1,1900,637,2537,50.74
4289,Aclimação,65,3,2,2,2300,453,2753,42.353848
4290,Lapa,138,3,5,3,6800,874,7674,55.608696
4291,Ipiranga,39,1,1,1,1600,0,1600,41.025642
4292,Vila Olímpia,65,2,2,1,3500,875,4375,67.30769
4293,Itaim Bibi,62,1,2,1,7500,1282,8782,141.64516
4294,Vila Leopoldina,130,3,3,2,5500,1050,6550,50.384617
4295,Santa Cecília,53,1,1,0,1400,450,1850,34.90566
4296,Vila Mariana,90,3,1,1,5000,1200,6200,68.888885
4297,Santa Ifigênia,50,1,1,1,2900,623,3523,70.46
4298,Outro,46,2,1,1,1200,0,1200,26.086956
4299,Vila Olímpia,48,1,1,1,3200,900,4100,85.416664
4300,Consolação,44,1,1,1,1850,442,2292,52.090908
4301,Saúde,56,2,2,1,2800,520,3320,59.285713
4302,Água Branca,43,2,1,1,1800,390,2190,50.930233
4303,Pinheiros,58,2,2,1,2600,1200,3800,65.51724
4304,Outro,37,1,1,1,2300,418,2718,73.45946
4305,Higienópolis,159,2,2,1,6500,1200,7700,48.427673
4306,Morumbi,541,4,6,6,35000,9979,44979,83.14048
4307,Moema,102,3,4,2,4200,1700,5900,57.843136
4308,Itaim Bibi,100,2,4,1,4200,1583,5783,57.83
4309,Chácara Santo Antônio,143,3,4,2,7000,1060,8060,56.363636
4310,Vila Olímpia,55,2,1,1,3300,566,3866,70.29091
4311,Pinheiros,26,1,1,0,2600,577,3177,122.19231
4312,Barra Funda,65,2,1,1,1300,970,2270,34.923077
4313,Jaguaré,60,3,1,1,1400,500,1900,31.666666
4314,Moema,102,3,2,2,6000,1233,7233,70.911766
4315,Vila Olímpia,45,1,1,1,2500,970,3470,77.111115
4316,Outro,69,2,1,1,1600,672,2272,32.927536
4317,Consolação,42,1,1,1,3050,800,3850,91.666664
4318,Pinheiros,62,2,2,2,3350,1070,4420,71.29032
4319,Pinheiros,74,2,2,2,5400,1098,6498,87.810814
4320,Outro,79,3,2,1,1900,710,2610,33.037975
4321,Santana,80,4,3,2,2500,680,3180,39.75
4322,Vila Formosa,40,1,1,0,1200,60,1260,31.5
4323,Tatuapé,22,1,1,0,1250,150,1400,63.636364
4324,República,35,1,1,0,1200,600,1800,51.42857
4325,República,30,1,1,1,2150,450,2600,86.666664
4326,Vila Nova Conceição,95,2,3,1,5000,1190,6190,65.1579
4327,Perdizes,45,1,1,1,2250,554,2804,62.31111
4328,Pinheiros,270,4,6,4,20000,3100,23100,85.55556
4329,Saúde,82,3,3,2,4000,580,4580,55.853657
4330,Aclimação,34,1,1,1,1500,837,2337,68.73529
4331,Pinheiros,36,1,1,1,3000,356,3356,93.22222
4332,Móoca,40,1,1,1,1500,234,1734,43.35
4333,Pompeia,80,2,2,2,5000,1340,6340,79.25
4334,Santo Amaro,65,2,2,1,2875,615,3490,53.692307
4335,Outro,56,2,1,1,1800,570,2370,42.32143
4336,Vila Nova Conceição,48,1,1,1,4637,1193,5830,121.458336
4337,Jardim América,150,2,2,2,10000,2157,12157,81.04667
4338,Alto de Pinheiros,130,3,4,2,5500,1861,7361,56.623077
4339,Pinheiros,88,1,1,2,4400,917,5317,60.420456
4340,Moema,50,1,1,1,1800,860,2660,53.2
4341,Outro,34,1,1,1,2000,330,2330,68.52941
4342,Tatuapé,60,2,1,0,1250,150,1400,23.333334
4343,Vila Mascote,65,2,2,1,1950,620,2570,39.53846
4344,Paraíso,45,1,2,1,2700,823,3523,78.28889
4345,Itaim Bibi,73,1,1,1,6500,1400,7900,108.21918
4346,Jardim Paulista,48,2,2,2,3400,680,4080,85.0
4347,Campo Belo,65,2,1,2,2500,1100,3600,55.384617
4348,Mirandópolis,90,3,2,2,2900,990,3890,43.22222
4349,Centro,35,1,1,0,1500,438,1938,55.37143
4350,Jardim Paulista,30,1,1,1,1210,1150,2360,78.666664
4351,Tatuapé,94,3,2,1,1800,630,2430,25.851065
4352,Vila Mariana,51,2,1,1,3000,430,3430,67.254906
4353,Vila Andrade,70,3,2,2,1800,865,2665,38.07143
4354,Pinheiros,120,3,3,1,2900,1434,4334,36.116665
4355,Itaim Bibi,60,1,2,1,4500,1200,5700,95.0
4356,Bela Vista,82,2,2,0,2600,870,3470,42.317074
4357,Jardim Anália Franco,257,4,5,4,15000,3000,18000,70.03891
4358,Vila Buarque,30,1,1,0,2000,331,2331,77.7
4359,Vila Mariana,31,1,1,1,2420,528,2948,95.09677
4360,Vila Andrade,51,2,1,1,1700,400,2100,41.17647
4361,Outro,50,2,1,1,1500,0,1500,30.0
4362,Bela Vista,45,1,1,1,1790,602,2392,53.155556
4363,Ipiranga,34,1,1,1,2400,340,2740,80.588234
4364,Morumbi,70,3,2,1,1750,823,2573,36.75714
4365,Casa Verde,140,4,3,3,3800,1550,5350,38.214287
4366,Perdizes,25,1,1,1,2100,330,2430,97.2
4367,Jardim Prudência,84,2,2,2,3500,790,4290,51.07143
4368,Santa Cecília,62,1,1,1,4000,616,4616,74.451614
4369,Vila Mascote,43,2,1,0,2100,200,2300,53.488373
4370,Brooklin,42,1,1,1,2300,865,3165,75.35714
4371,Santa Cecília,80,3,2,0,2700,400,3100,38.75
4372,Vila Andrade,48,2,1,1,2200,430,2630,54.791668
4373,Vila Buarque,53,1,1,0,1400,375,1775,33.490566
4374,Outro,50,2,1,1,2020,439,2459,49.18
4375,Vila Mariana,62,2,2,1,1350,1041,2391,38.564518
4376,Saúde,70,3,2,2,1500,1050,2550,36.42857
4377,Pinheiros,53,2,2,1,4200,800,5000,94.33962
4378,Higienópolis,40,1,1,0,1600,500,2100,52.5
4379,Vila Olímpia,30,1,1,1,2700,800,3500,116.666664
4380,Chácara Santo Antônio,70,2,2,1,3100,734,3834,54.771427
4381,Vila Olímpia,72,3,2,1,4195,1008,5203,72.263885
4382,Vila Olímpia,150,2,2,2,8400,1165,9565,63.766666
4383,Vila Madalena,106,3,4,2,3400,1740,5140,48.490566
4384,Vila Mariana,65,3,2,1,2100,680,2780,42.76923
4385,Moema,45,1,2,1,2000,540,2540,56.444443
4386,Santo Amaro,45,1,1,1,2400,383,2783,61.844444
4387,Vila Olímpia,36,1,1,1,3300,0,3300,91.666664
4388,Jabaquara,53,2,2,1,2100,720,2820,53.207546
4389,Móoca,80,2,1,0,1100,207,1307,16.3375
4390,Santo Amaro,60,1,1,1,1150,396,1546,25.766666
4391,Moema,35,1,1,1,1800,642,2442,69.77143
4392,Vila Mariana,100,4,1,0,2600,100,2700,27.0
4393,Vila Olímpia,80,3,3,1,3200,1350,4550,56.875
4394,Moema,95,3,3,1,2600,1112,3712,39.073685
4395,Vila Gomes Cardim,165,4,2,3,5000,1411,6411,38.854546
4396,Outro,58,2,1,1,1252,543,1795,30.948277
4397,Brooklin,88,2,2,2,4800,1167,5967,67.806816
4398,Morumbi,40,1,1,1,1400,580,1980,49.5
4399,Campo Belo,75,2,3,1,1700,1100,2800,37.333332
4400,Vila Formosa,40,1,1,0,1700,0,1700,42.5
4401,Higienópolis,30,1,1,1,2000,490,2490,83.0
4402,Campo Belo,49,1,2,1,2600,665,3265,66.63265
4403,Santo Amaro,76,2,2,2,3000,350,3350,44.07895
4404,Consolação,60,2,1,2,4450,714,5164,86.066666
4405,Outro,18,1,1,0,1100,40,1140,63.333332
4406,Aclimação,76,3,3,2,3700,1000,4700,61.842106
4407,Casa Verde,40,1,1,1,1400,661,2061,51.525
4408,Outro,47,2,1,1,1350,0,1350,28.723404
4409,Vila Prudente,50,2,1,1,1300,395,1695,33.9
4410,Morumbi,79,2,3,1,3400,594,3994,50.55696
4411,Outro,72,3,2,1,1750,650,2400,33.333332
4412,Campo Belo,132,3,1,1,4500,1600,6100,46.21212
4413,Jardim Paulista,90,2,1,1,3200,1300,4500,50.0
4414,Vila Olímpia,30,1,1,1,3060,600,3660,122.0
4415,Itaim Bibi,77,1,2,2,6950,1676,8626,112.02597
4416,Moema,73,2,1,1,2400,960,3360,46.027397
4417,Aclimação,38,1,1,0,1440,260,1700,44.736843
4418,Vila Andrade,50,2,1,1,2101,426,2527,50.54
4419,Outro,49,2,1,1,1010,240,1250,25.510204
4420,Ipiranga,80,2,3,1,1700,933,2633,32.9125
4421,Barra Funda,33,1,1,1,1700,290,1990,60.303032
4422,Cerqueira César,180,3,3,2,8500,1666,10166,56.47778
4423,Moema,40,1,1,0,1700,0,1700,42.5
4424,Vila Mariana,135,3,2,2,4900,1750,6650,49.25926
4425,Outro,60,2,1,2,1200,690,1890,31.5
4426,Bela Vista,40,2,1,1,2700,450,3150,78.75
4427,Vila Guarani,85,3,3,2,2650,750,3400,40.0
4428,Bela Vista,75,2,2,1,2400,800,3200,42.666668
4429,Moema,147,4,4,3,4000,1800,5800,39.455784
4430,Vila Sônia,48,2,1,1,1500,512,2012,41.916668
4431,Campo Belo,47,1,1,1,2800,573,3373,71.76596
4432,Vila Clementino,72,2,2,1,4000,938,4938,68.583336
4433,Chácara Inglesa,36,1,1,0,2300,450,2750,76.388885
4434,Outro,22,1,1,0,1900,362,2262,102.818184
4435,Tatuapé,57,2,1,1,2300,432,2732,47.929825
4436,Campo Belo,245,4,4,4,10000,3320,13320,54.367348
4437,Vila Leopoldina,65,2,1,1,1500,532,2032,31.261538
4438,Vila Olímpia,55,1,1,1,1698,600,2298,41.78182
4439,Pinheiros,38,1,1,1,2800,568,3368,88.63158
4440,Cambuci,80,3,2,2,2100,890,2990,37.375
4441,Outro,160,3,3,2,4000,1150,5150,32.1875
4442,Pompeia,50,1,1,1,2800,660,3460,69.2
4443,Itaim Bibi,90,2,2,1,4100,765,4865,54.055557
4444,Alto de Pinheiros,58,1,2,2,3800,774,4574,78.86207
4445,Pinheiros,65,2,2,1,5500,950,6450,99.23077
4446,Vila Madalena,24,1,1,0,2300,525,2825,117.708336
4447,Saúde,101,3,1,2,3500,600,4100,40.59406
4448,Itaim Bibi,44,1,1,1,2300,908,3208,72.90909
4449,Vila Mariana,100,2,2,1,2100,925,3025,30.25
4450,Consolação,42,1,1,1,1750,390,2140,50.95238
4451,Vila Madalena,25,1,1,0,2100,700,2800,112.0
4452,Itaim Bibi,70,2,2,1,3000,992,3992,57.028572
4453,Liberdade,40,1,1,0,1000,400,1400,35.0
4454,Campo Belo,83,2,3,2,4500,699,5199,62.638554
4455,Consolação,500,4,5,6,40000,11295,51295,102.59
4456,Granja Julieta,110,2,3,2,4800,1365,6165,56.045456
4457,Itaim Bibi,107,3,3,1,3800,1293,5093,47.59813
4458,Consolação,65,1,2,0,1500,407,1907,29.33846
4459,Saúde,58,2,1,1,2700,480,3180,54.827587
4460,Consolação,50,1,1,1,4000,700,4700,94.0
4461,Campos Eliseos,32,1,1,1,1250,560,1810,56.5625
4462,Vila Anastácio,87,3,1,2,3500,800,4300,49.42529
4463,Barra Funda,54,2,2,1,2400,580,2980,55.185184
4464,Mirandópolis,200,3,2,2,3800,0,3800,19.0
4465,Vila Olímpia,60,2,2,1,2500,950,3450,57.5
4466,Alto da Lapa,89,3,3,1,2800,860,3660,41.123596
4467,Itaim Bibi,201,3,5,3,22000,4100,26100,129.85075
4468,Bela Vista,640,4,5,4,9000,6990,15990,24.984375
4469,Saúde,70,3,2,1,2000,820,2820,40.285713
4470,Jardim América,205,2,3,1,8000,4365,12365,60.317074
4471,Vila Mariana,37,1,1,1,1500,370,1870,50.54054
4472,Campo Belo,76,1,2,2,5250,937,6187,81.4079
4473,Pinheiros,160,4,6,3,7000,2500,9500,59.375
4474,Higienópolis,64,2,1,1,2500,608,3108,48.5625
4475,Outro,55,2,1,1,1250,422,1672,30.4
4476,Perdizes,85,1,1,1,1700,350,2050,24.117647
4477,Outro,72,2,1,1,1900,460,2360,32.77778
4478,Tatuapé,52,2,1,1,1900,555,2455,47.21154
4479,Campo Belo,210,3,5,3,13000,2000,15000,71.42857
4480,Outro,71,1,1,1,2620,780,3400,47.887325
4481,Aclimação,170,3,5,3,10000,1060,11060,65.05882
4482,Jardins,150,3,3,2,4200,2350,6550,43.666668
4483,Vila Leopoldina,55,2,2,1,2300,656,2956,53.745453
4484,Pinheiros,50,1,1,1,3000,1044,4044,80.88
4485,Outro,42,2,1,1,950,550,1500,35.714287
4486,Móoca,66,2,1,1,1700,583,2283,34.590908
4487,Jardim Marajoara,52,2,1,1,2100,0,2100,40.384617
4488,Bela Vista,60,2,2,0,2500,600,3100,51.666668
4489,Paraíso,46,1,2,1,3400,592,3992,86.78261
4490,Vila Cruzeiro,134,3,3,2,7000,1395,8395,62.649254
4491,Consolação,53,1,2,1,1980,570,2550,48.11321
4492,Tatuapé,122,3,3,2,3420,1500,4920,40.32787
4493,Jardim Paulista,137,3,3,1,6400,1187,7587,55.379562
4494,Pinheiros,25,1,1,0,4000,545,4545,181.8
4495,Barra Funda,33,1,1,1,2200,366,2566,77.757576
4496,Casa Verde,62,2,2,1,1980,660,2640,42.580647
4497,Vila Madalena,72,2,2,1,2350,900,3250,45.13889
4498,Aclimação,70,2,1,0,2300,620,2920,41.714287
4499,Pompeia,60,2,2,2,2500,1152,3652,60.866665
4500,Outro,70,2,2,1,1500,860,2360,33.714287
4501,Cerqueira César,117,2,2,1,5000,820,5820,49.74359
4502,Jardim Paulista,110,2,4,2,7500,2100,9600,87.27273
4503,Outro,47,2,1,1,1400,0,1400,29.787233
4504,Itaim Bibi,62,2,2,1,4800,873,5673,91.5
4505,Moema,72,3,2,1,3300,970,4270,59.305557
4506,Vila Madalena,55,1,1,2,4300,1408,5708,103.781815
4507,Outro,70,2,1,2,2700,600,3300,47.142857
4508,Santa Cecília,58,2,1,1,2500,638,3138,54.103447
4509,Jabaquara,65,3,2,1,1500,542,2042,31.415384
4510,Morumbi,72,3,2,2,2100,950,3050,42.36111
4511,Saúde,70,3,2,1,1700,659,2359,33.7
4512,Outro,50,2,1,1,1500,500,2000,40.0
4513,Moema,282,4,6,4,13485,4700,18185,64.48582
4514,Outro,45,2,1,1,950,393,1343,29.844444
4515,Vila Clementino,90,3,2,1,2900,0,2900,32.22222
4516,Ipiranga,61,2,2,1,1800,659,2459,40.311474
4517,Saúde,57,2,2,1,1600,650,2250,39.473682
4518,Vila Olímpia,111,3,4,2,10500,1450,11950,107.65766
4519,Tatuapé,49,2,1,1,1650,351,2001,40.836735
4520,Paraíso,188,3,3,2,5000,1631,6631,35.27128
4521,Outro,35,1,1,0,1100,150,1250,35.714287
4522,Indianópolis,38,1,1,1,2300,1100,3400,89.47369
4523,Vila Carrão,38,2,1,0,1300,100,1400,36.842106
4524,Outro,62,3,2,2,1800,1100,2900,46.774193
4525,Vila Anastácio,157,3,3,3,7000,1200,8200,52.229298
4526,República,28,1,1,0,2300,0,2300,82.14286
4527,Pinheiros,158,4,5,3,4500,2550,7050,44.620255
4528,Bela Vista,45,1,1,0,2000,365,2365,52.555557
4529,Barra Funda,65,2,1,0,1500,469,1969,30.292307
4530,Consolação,34,1,1,1,2500,536,3036,89.29412
4531,Chácara Santo Antônio,104,3,4,2,3900,980,4880,46.923077
4532,Outro,47,2,1,1,1950,597,2547,54.19149
4533,Outro,74,2,2,2,1850,680,2530,34.18919
4534,Jaguaré,58,2,1,2,1500,402,1902,32.793102
4535,Vila Madalena,66,1,1,2,3280,1400,4680,70.90909
4536,Paraíso,43,1,1,1,1600,720,2320,53.953487
4537,Bela Vista,54,2,2,1,3400,550,3950,73.14815
4538,Campo Belo,70,2,2,2,5200,650,5850,83.57143
4539,Pompeia,76,2,2,2,3500,1120,4620,60.789474
4540,Vila Carrão,84,2,2,2,3600,600,4200,50.0
4541,Santa Cecília,190,3,2,0,2600,1040,3640,19.157894
4542,Perdizes,45,1,1,1,2250,554,2804,62.31111
4543,Moema,90,3,4,2,3800,1182,4982,55.355556
4544,Outro,58,2,1,1,5000,0,5000,86.206894
4545,Chácara Santo Antônio,63,2,2,1,3200,680,3880,61.587303
4546,Mirandópolis,60,2,2,1,2100,680,2780,46.333332
4547,Cerqueira César,58,1,2,1,3700,820,4520,77.93104
4548,Vila Madalena,113,3,3,2,2300,1175,3475,30.752213
4549,Chácara Santo Antônio,35,1,1,1,1500,530,2030,58.0
4550,Cidade Monções,33,1,1,1,2800,620,3420,103.63636
4551,Campo Belo,51,1,1,1,3000,669,3669,71.94118
4552,Vila Olímpia,274,4,7,5,30000,4746,34746,126.81022
4553,Brooklin,70,2,2,1,5000,720,5720,81.71429
4554,Aclimação,34,1,1,1,1980,608,2588,76.117645
4555,Vila Carrão,84,2,2,2,3600,600,4200,50.0
4556,Vila Olímpia,60,2,2,1,4500,850,5350,89.166664
4557,Vila Leopoldina,98,3,2,1,3490,710,4200,42.857143
4558,Moema,75,2,2,2,3000,1472,4472,59.626667
4559,Outro,48,2,1,1,1350,0,1350,28.125
4560,Vila Mariana,168,4,4,4,8500,1900,10400,61.904762
4561,Higienópolis,80,2,1,1,4800,1211,6011,75.1375
4562,Moema,96,3,4,2,3700,1137,4837,50.385418
4563,Indianópolis,92,2,1,1,3900,960,4860,52.826088
4564,Vila Mariana,70,3,3,1,3300,583,3883,55.471428
4565,Jabaquara,74,2,2,1,1700,750,2450,33.10811
4566,Liberdade,26,1,1,0,700,500,1200,46.153847
4567,Campo Belo,47,2,2,1,3400,860,4260,90.6383
4568,Moema,70,2,1,1,2700,1100,3800,54.285713
4569,Bela Vista,42,1,1,1,1800,700,2500,59.52381
4570,Campo Belo,75,2,1,1,2500,616,3116,41.546665
4571,Outro,102,3,2,0,1700,200,1900,18.62745
4572,Granja Julieta,411,4,3,4,31000,2100,33100,80.53528
4573,Bela Vista,43,1,1,0,1400,590,1990,46.279068
4574,Itaim Bibi,256,4,5,4,60000,2086,62086,242.52344
4575,Saúde,140,3,2,2,3800,1300,5100,36.42857
4576,Centro,40,1,1,1,1800,397,2197,54.925
4577,Brooklin,172,3,5,3,9990,2500,12490,72.61628
4578,Vila Madalena,100,3,3,2,5500,982,6482,64.82
4579,Outro,55,2,1,2,1400,815,2215,40.272728
4580,Tatuapé,75,2,2,2,3300,800,4100,54.666668
4581,Pinheiros,157,3,5,4,10400,3170,13570,86.43312
4582,Jardim Paulista,142,3,3,2,5200,1300,6500,45.774647
4583,Tatuapé,52,2,1,1,1500,550,2050,39.423077
4584,Higienópolis,113,3,3,1,4500,1600,6100,53.9823
4585,Perdizes,74,2,3,2,5500,630,6130,82.83784
4586,Bela Vista,45,1,1,1,2000,0,2000,44.444443
4587,Moema,71,2,2,1,7000,980,7980,112.39436
4588,Perdizes,60,2,2,1,2300,797,3097,51.616665
4589,Pinheiros,42,1,1,1,2000,700,2700,64.28571
4590,Vila Santa Catarina,72,2,2,1,2700,692,3392,47.11111
4591,Outro,68,2,2,1,2200,781,2981,43.838234
4592,Pinheiros,84,2,2,1,2400,996,3396,40.42857
4593,Perdizes,63,2,2,1,5000,1101,6101,96.84127
4594,Vila Mascote,98,3,3,3,2200,1759,3959,40.39796
4595,Moema,85,2,3,1,3000,545,3545,41.705883
4596,Consolação,35,1,1,1,2800,805,3605,103.0
4597,Perdizes,65,2,2,1,3600,900,4500,69.23077
4598,Outro,42,1,1,1,1400,455,1855,44.166668
4599,Moema,95,3,3,2,4000,1130,5130,54.0
4600,Morumbi,60,1,1,1,900,592,1492,24.866667
4601,Campo Belo,37,1,1,1,2400,500,2900,78.37838
4602,Brás,56,2,2,1,2300,450,2750,49.107143
4603,Outro,48,2,1,1,1600,267,1867,38.895832
4604,Outro,47,2,1,1,1300,230,1530,32.553192
4605,Vila Buarque,55,1,1,0,1400,554,1954,35.52727
4606,Mirandópolis,68,2,2,0,1900,670,2570,37.794117
4607,Campo Belo,108,3,3,2,5000,1400,6400,59.25926
4608,Outro,75,3,2,1,1600,700,2300,30.666666
4609,Vila Anastácio,69,2,2,2,3100,0,3100,44.927536
4610,Bela Vista,64,2,2,1,4200,700,4900,76.5625
4611,Vila Olímpia,75,2,2,1,2200,1106,3306,44.08
4612,Outro,208,3,4,3,3000,1800,4800,23.076923
4613,Vila Prudente,48,2,1,1,1500,571,2071,43.145832
4614,Saúde,34,1,1,1,1700,560,2260,66.47059
4615,Pompeia,130,3,4,3,3100,2092,5192,39.93846
4616,Itaim Bibi,109,2,4,2,7000,1400,8400,77.06422
4617,Outro,50,2,1,1,800,300,1100,22.0
4618,Aclimação,178,3,5,3,9500,1100,10600,59.55056
4619,Jardins,61,2,1,1,2650,1089,3739,61.295082
4620,Campo Belo,60,2,2,1,2300,591,2891,48.183334
4621,Consolação,40,1,1,1,1900,597,2497,62.425
4622,Outro,60,2,1,1,1100,280,1380,23.0
4623,Outro,65,2,2,2,2000,650,2650,40.76923
4624,Alto Da Boa Vista,310,4,6,4,16600,2148,18748,60.47742
4625,Jardim Paulista,50,2,1,1,2600,838,3438,68.76
4626,Moema,70,2,2,1,2900,1080,3980,56.857143
4627,Consolação,51,1,1,1,3000,550,3550,69.60784
4628,Moema,40,1,1,1,2200,800,3000,75.0
4629,Outro,49,2,1,1,1500,170,1670,34.081635
4630,Vila Leopoldina,130,3,3,2,6000,1200,7200,55.384617
4631,Brooklin,43,1,1,1,3800,650,4450,103.48837
4632,Perdizes,45,1,2,1,1950,768,2718,60.4
4633,Barra Funda,40,1,1,1,2000,470,2470,61.75
4634,Outro,112,2,4,2,5000,1265,6265,55.9375
4635,Ipiranga,78,3,2,2,2500,736,3236,41.48718
4636,Outro,49,2,1,1,1350,490,1840,37.55102
4637,Outro,116,3,3,1,2500,1050,3550,30.603449
4638,Jardim Marajoara,92,3,1,2,3000,870,3870,42.065216
4639,Móoca,49,2,1,1,1890,400,2290,46.734695
4640,Pinheiros,54,2,2,1,3200,881,4081,75.57407
4641,Outro,58,2,1,1,1300,420,1720,29.655172
4642,Outro,60,1,1,0,1000,0,1000,16.666666
4643,Vila Clementino,98,3,4,2,5500,966,6466,65.97959
4644,Perdizes,40,1,1,0,1500,203,1703,42.575
4645,Outro,76,2,2,2,3000,736,3736,49.157894
4646,Paraíso,298,3,4,3,12350,3745,16095,54.010067
4647,Outro,55,2,1,1,1700,540,2240,40.727272
4648,Brooklin,62,1,2,1,3000,744,3744,60.387096
4649,Brooklin,83,3,3,2,3500,1000,4500,54.21687
4650,Vila Leopoldina,48,2,1,1,1800,440,2240,46.666668
4651,Outro,27,1,1,0,1100,100,1200,44.444443
4652,Vila Buarque,30,1,1,0,1200,380,1580,52.666668
4653,Santana,50,2,1,1,1600,575,2175,43.5
4654,Vila Santa Catarina,57,2,1,1,1550,638,2188,38.385963
4655,Vila Madalena,75,2,2,1,4500,933,5433,72.44
4656,Aclimação,37,1,1,1,2260,530,2790,75.4054
4657,Vila Andrade,110,3,2,2,5000,895,5895,53.590908
4658,República,70,3,2,0,2000,700,2700,38.57143
4659,Vila Prudente,50,2,1,0,1150,160,1310,26.2
4660,Sumaré,215,3,5,4,10800,3567,14367,66.82326
4661,Morumbi,65,3,2,1,1960,485,2445,37.615383
4662,Brooklin,78,2,2,2,6900,1200,8100,103.84615
4663,Outro,92,3,2,3,2500,950,3450,37.5
4664,Pinheiros,72,2,3,1,5150,584,5734,79.638885
4665,Alto da Lapa,62,2,2,1,1700,788,2488,40.129032
4666,Outro,50,2,1,1,2300,0,2300,46.0
4667,Móoca,60,2,1,1,1400,617,2017,33.616665
4668,Chácara Santo Antônio,71,2,2,1,3000,742,3742,52.704224
4669,Pinheiros,75,2,2,2,4400,790,5190,69.2
4670,Perdizes,104,3,3,2,7300,989,8289,79.70192
4671,Campo Belo,198,4,6,3,9710,2400,12110,61.161617
4672,Outro,55,2,1,1,2000,0,2000,36.363636
4673,Vila Nova Conceição,71,2,2,1,6000,1250,7250,102.11268
4674,Vila Mariana,20,1,1,0,1710,300,2010,100.5
4675,Paraíso,80,2,2,1,2500,980,3480,43.5
4676,Jardins,30,1,1,0,3800,515,4315,143.83333
4677,Itaim Bibi,90,2,2,1,4200,1020,5220,58.0
4678,Outro,50,2,1,1,1500,544,2044,40.88
4679,Moema,115,3,3,2,5000,1100,6100,53.04348
4680,Granja Julieta,38,1,1,1,2600,578,3178,83.63158
4681,Jardim Paulista,105,1,1,1,1990,1443,3433,32.695236
4682,Barra Funda,33,1,1,0,1600,290,1890,57.272728
4683,Jardins,31,1,1,1,2400,806,3206,103.41936
4684,Outro,60,2,2,1,2200,400,2600,43.333332
4685,Vila Nova Conceição,166,3,5,3,20000,2202,22202,133.747
4686,Moema,95,3,4,2,3800,1137,4937,51.968422
4687,Liberdade,64,2,1,0,1600,480,2080,32.5
4688,Outro,54,2,1,1,1200,550,1750,32.407406
4689,Outro,54,2,1,1,1120,551,1671,30.944445
4690,Aclimação,39,1,1,1,2260,530,2790,71.53846
4691,Jardim Paulista,190,3,3,2,4000,3540,7540,39.68421
4692,Bela Vista,98,2,1,1,6430,0,6430,65.61224
4693,Vila Mascote,50,1,1,1,1500,650,2150,43.0
4694,Outro,75,3,2,1,2900,0,2900,38.666668
4695,Santana,148,3,3,3,3100,1675,4775,32.26351
4696,Vila Mariana,70,2,3,1,5000,820,5820,83.14286
4697,Outro,53,1,1,1,900,580,1480,27.924528
4698,Jardim Europa,150,3,4,3,8500,3800,12300,82.0
4699,Outro,63,2,2,1,1142,700,1842,29.238094
4700,Vila Mariana,50,1,2,1,3700,580,4280,85.6
4701,Campo Belo,82,2,3,1,2100,1149,3249,39.621952
4702,Saúde,80,3,2,1,2300,1100,3400,42.5
4703,Chácara Klabin,76,2,2,1,1900,970,2870,37.763157
4704,Butantã,60,2,2,1,2000,368,2368,39.466667
4705,Ipiranga,105,2,2,1,1800,870,2670,25.428572
4706,Itaim Bibi,130,3,3,1,4500,964,5464,42.03077
4707,Outro,52,1,1,0,1350,0,1350,25.961538
4708,Jabaquara,34,1,1,1,1880,366,2246,66.05882
4709,Perdizes,135,3,3,3,5000,2000,7000,51.851852
4710,Vila Olímpia,100,3,3,2,4200,1020,5220,52.2
4711,Vila Leopoldina,58,2,2,1,2799,562,3361,57.948277
4712,Campos Eliseos,102,2,2,0,2000,474,2474,24.254902
4713,Higienópolis,226,3,3,2,5500,2680,8180,36.19469
4714,Chácara Santo Antônio,80,2,1,0,1890,300,2190,27.375
4715,Chácara Santo Antônio,132,4,5,2,5500,990,6490,49.166668
4716,Outro,62,2,2,1,2300,518,2818,45.451614
4717,Chácara Inglesa,55,2,2,2,2500,750,3250,59.090908
4718,Itaim Bibi,40,1,1,0,4500,0,4500,112.5
4719,República,39,1,1,1,1700,750,2450,62.820515
4720,Outro,84,3,2,2,2190,660,2850,33.92857
4721,Higienópolis,42,1,1,0,1600,448,2048,48.761906
4722,Vila Olímpia,35,1,1,1,3000,860,3860,110.28571
4723,Santo Amaro,73,1,2,1,2800,800,3600,49.315067
4724,Outro,298,4,4,3,7500,3434,10934,36.691277
4725,Pinheiros,80,3,2,1,2250,1124,3374,42.175
4726,Pinheiros,60,2,1,0,2299,550,2849,47.483334
4727,República,28,1,1,0,1500,338,1838,65.64286
4728,Bela Vista,55,1,1,0,1600,600,2200,40.0
4729,Chácara Santo Antônio,60,2,2,2,3200,670,3870,64.5
4730,Indianópolis,47,1,1,1,3100,540,3640,77.44681
4731,Vila Mariana,31,1,1,1,2420,528,2948,95.09677
4732,Campo Belo,140,3,3,2,4500,1900,6400,45.714287
4733,Brooklin,80,2,2,2,6000,670,6670,83.375
4734,Vila Cruzeiro,37,1,1,1,2000,515,2515,67.97298
4735,Outro,179,3,5,3,7000,1300,8300,46.368713
4736,Cerqueira César,40,1,2,1,1333,603,1936,48.4
4737,Morumbi,59,2,2,2,2000,800,2800,47.457626
4738,Perdizes,461,4,6,5,35000,2000,37000,80.26031
4739,Vila Mariana,251,4,6,5,16000,2120,18120,72.19124
4740,Outro,61,2,1,1,1300,400,1700,27.868853
4741,Pinheiros,64,2,2,0,2200,921,3121,48.765625
4742,Itaim Bibi,129,2,3,2,13000,2145,15145,117.4031
4743,Chácara Santo Antônio,65,1,2,1,2800,646,3446,53.015385
4744,Campo Belo,83,2,3,1,2100,1147,3247,39.120483
4745,Outro,50,2,1,1,1500,0,1500,30.0
4746,Vila Mariana,128,3,4,3,3000,1100,4100,32.03125
4747,Outro,46,1,1,1,1050,50,1100,23.913044
4748,Jaguaré,55,2,1,1,1600,405,2005,36.454544
4749,Pinheiros,103,3,2,1,3500,1270,4770,46.31068
4750,Pompeia,121,3,4,3,4500,1300,5800,47.933884
4751,Outro,55,2,1,1,1200,490,1690,30.727272
4752,Itaim Bibi,154,2,3,1,4300,1000,5300,34.415585
4753,Chácara Klabin,100,3,3,2,3200,890,4090,40.9
4754,Consolação,56,2,1,1,3900,950,4850,86.60714
4755,Móoca,150,3,2,2,1700,1450,3150,21.0
4756,Campo Belo,63,2,1,1,4900,1100,6000,95.2381
4757,Itaim Bibi,80,2,2,2,12000,1610,13610,170.125
4758,Jardim América,50,1,1,1,3500,1700,5200,104.0
4759,Saúde,57,2,2,2,2750,625,3375,59.210526
4760,Pompeia,128,3,4,2,10000,1259,11259,87.96094
4761,Paraíso,39,1,1,1,1400,843,2243,57.51282
4762,Paraíso,157,2,3,3,11000,1890,12890,82.10191
4763,Vila Mariana,100,3,1,0,2000,0,2000,20.0
4764,Ipiranga,85,2,1,2,3800,791,4591,54.011765
4765,Campo Belo,34,1,1,1,3000,0,3000,88.23529
4766,Campo Belo,53,1,1,1,3950,450,4400,83.01887
4767,Perdizes,68,2,3,2,5390,1229,6619,97.338234
4768,Água Branca,162,3,4,3,7000,1500,8500,52.469135
4769,Alto da Lapa,68,2,2,2,3500,720,4220,62.058823
4770,Outro,52,2,1,1,1400,420,1820,35.0
4771,Vila Nova Conceição,354,3,5,5,40000,7000,47000,132.76836
4772,Alto da Lapa,70,2,3,2,2500,968,3468,49.54286
4773,Jardim Europa,137,3,3,1,6800,1428,8228,60.058395
4774,Outro,23,1,1,0,1600,338,1938,84.26087
4775,Pompeia,50,2,2,1,2550,580,3130,62.6
4776,Itaim Bibi,165,4,4,3,8000,2000,10000,60.60606
4777,Vila Mariana,168,3,3,2,3500,1600,5100,30.357143
4778,Vila Mariana,84,3,1,1,2700,580,3280,39.04762
4779,Outro,224,4,5,4,8500,2140,10640,47.5
4780,Moema,100,3,1,2,4500,1100,5600,56.0
4781,Jardim Paulista,185,3,4,3,11990,2480,14470,78.21622
4782,Brooklin,91,3,2,2,7300,950,8250,90.65934
4783,Vila Nova Conceição,145,2,4,3,10500,2402,12902,88.97931
4784,Tatuapé,69,2,2,1,2200,450,2650,38.405796
4785,Chácara Santo Antônio,138,3,5,2,6900,1404,8304,60.173912
4786,Pinheiros,125,3,2,1,7500,1550,9050,72.4
4787,Vila Anastácio,63,1,2,1,2950,350,3300,52.38095
4788,Campo Belo,27,1,1,1,1149,715,1864,69.03704
4789,Vila Buarque,28,1,1,0,1300,0,1300,46.42857
4790,Brooklin,56,1,1,1,3610,950,4560,81.42857
4791,Jardins,150,3,4,4,15000,3824,18824,125.49333
4792,Outro,69,2,2,2,2700,975,3675,53.260868
4793,Água Branca,120,2,4,2,8000,940,8940,74.5
4794,Chácara Klabin,72,2,2,2,2700,990,3690,51.25
4795,Jardim América,101,3,2,2,4500,1310,5810,57.524754
4796,Santo Amaro,65,2,1,1,3400,0,3400,52.307693
4797,Outro,49,2,1,1,1500,270,1770,36.122448
4798,Barra Funda,126,4,3,2,5859,1200,7059,56.02381
4799,Tatuapé,62,3,1,1,1900,461,2361,38.080647
4800,Outro,60,2,1,1,1500,200,1700,28.333334
4801,Santo Amaro,31,1,1,1,1600,621,2221,71.645164
4802,Santa Cecília,80,2,1,1,2500,1160,3660,45.75
4803,Outro,35,1,1,1,900,440,1340,38.285713
4804,Bela Vista,25,1,1,0,1700,275,1975,79.0
4805,Outro,50,2,1,1,1100,330,1430,28.6
4806,Higienópolis,40,1,1,0,1600,500,2100,52.5
4807,Brooklin,58,1,2,1,3800,642,4442,76.586205
4808,Vila Mariana,85,2,2,1,3600,515,4115,48.411766
4809,Outro,53,2,1,1,1600,343,1943,36.660378
4810,Vila Mariana,50,2,1,1,3500,300,3800,76.0
4811,Barra Funda,53,2,2,1,2900,550,3450,65.09434
4812,Moema,247,4,6,4,18000,3800,21800,88.25911
4813,Cerqueira César,95,2,2,0,2600,890,3490,36.736843
4814,Chácara Santo Antônio,48,2,1,1,2400,580,2980,62.083332
4815,Moema,40,1,1,1,1800,700,2500,62.5
4816,Moema,50,1,2,1,2100,570,2670,53.4
4817,Ipiranga,35,1,1,1,2490,341,2831,80.88571
4818,Tatuapé,337,4,6,5,12000,3850,15850,47.032642
4819,Vila Guarani,53,1,1,1,2500,619,3119,58.849056
4820,Tatuapé,46,2,1,1,1600,475,2075,45.108696
4821,Pinheiros,107,3,3,2,6800,2000,8800,82.24299
4822,Vila Madalena,83,2,3,2,4500,1350,5850,70.481926
4823,Consolação,32,1,1,1,2950,400,3350,104.6875
4824,Vila Guarani,62,2,2,1,1600,850,2450,39.51613
4825,Jaguaré,33,2,1,0,1400,0,1400,42.424244
4826,Jardins,104,3,3,2,5000,2018,7018,67.48077
4827,Outro,30,1,1,1,1000,0,1000,33.333332
4828,Indianópolis,67,2,3,1,3700,850,4550,67.910446
4829,Vila Mascote,70,2,2,1,3100,720,3820,54.57143
4830,Bela Vista,44,1,1,1,1675,750,2425,55.113636
4831,Jardim Paulista,256,3,4,2,10500,2684,13184,51.5
4832,Vila Mariana,127,4,5,3,4950,1800,6750,53.149605
4833,Vila Mariana,86,3,1,2,4200,920,5120,59.534885
4834,Outro,68,3,2,1,2100,698,2798,41.14706
4835,Vila Prudente,30,1,1,1,1700,445,2145,71.5
4836,Saúde,60,2,2,1,1700,585,2285,38.083332
4837,Higienópolis,78,3,2,1,2900,718,3618,46.384617
4838,Chácara Santo Antônio,137,3,5,3,12000,800,12800,93.43066
4839,Pinheiros,68,2,2,1,4800,1000,5800,85.29412
4840,Outro,93,3,3,2,3700,550,4250,45.698925
4841,Ipiranga,45,1,1,0,1200,0,1200,26.666666
4842,Outro,44,2,1,1,2000,637,2637,59.93182
4843,Brooklin,37,1,1,1,3000,700,3700,100.0
4844,Perdizes,60,1,1,0,1300,392,1692,28.2
4845,Vila Olímpia,43,1,1,1,2410,705,3115,72.441864
4846,Moema,71,2,2,1,6700,900,7600,107.04225
4847,Alto da Lapa,68,2,2,2,3500,720,4220,62.058823
4848,Moema,105,3,3,2,6000,872,6872,65.44762
4849,Brooklin,138,3,5,3,7000,1404,8404,60.898552
4850,Campo Belo,75,2,3,2,3500,1080,4580,61.066666
4851,Itaim Bibi,80,1,2,2,10200,1500,11700,146.25
4852,Outro,65,2,1,1,1320,600,1920,29.538462
4853,Campos Eliseos,23,1,1,0,1401,0,1401,60.913044
4854,Outro,105,3,2,2,2700,0,2700,25.714285
4855,Moema,36,1,1,1,1800,539,2339,64.97222
4856,Vila Formosa,56,2,1,1,2600,351,2951,52.69643
4857,Vila Olímpia,124,3,2,2,4350,0,4350,35.080647
4858,Móoca,80,2,1,1,1300,300,1600,20.0
4859,Vila Gomes Cardim,165,4,4,3,5700,1400,7100,43.030304
4860,Saúde,70,2,2,1,1600,803,2403,34.32857
4861,Moema,102,3,3,2,6000,1188,7188,70.47059
4862,Moema,36,1,1,1,2300,685,2985,82.916664
4863,Vila Nova Conceição,94,2,2,2,10000,1133,11133,118.43617
4864,Pinheiros,110,3,1,0,4000,120,4120,37.454544
4865,Vila Olímpia,111,3,3,2,9000,1336,10336,93.11712
4866,Vila Mariana,130,3,3,1,3900,1089,4989,38.376923
4867,Chácara Inglesa,55,2,1,1,2009,907,2916,53.01818
4868,Jardim Marajoara,65,2,2,2,1500,635,2135,32.846153
4869,Outro,94,3,3,4,3000,915,3915,41.648937
4870,Outro,90,3,2,1,1400,705,2105,23.38889
4871,Morumbi,88,2,2,2,2200,1150,3350,38.06818
4872,Vila Mariana,48,1,1,0,1800,632,2432,50.666668
4873,Outro,165,4,4,2,5200,0,5200,31.515152
4874,Pompeia,46,2,1,1,1600,652,2252,48.95652
4875,Outro,165,3,4,2,5500,2500,8000,48.484848
4876,Panamby,33,1,1,1,1490,450,1940,58.78788
4877,Itaim Bibi,35,1,1,0,1500,1100,2600,74.28571
4878,Campo Belo,242,4,3,4,10000,3450,13450,55.578514
4879,Outro,55,2,1,1,2150,366,2516,45.745453
4880,Tatuapé,55,2,1,1,2000,480,2480,45.090908
4881,Bela Vista,54,2,2,1,2400,832,3232,59.851852
4882,Campo Belo,47,1,1,1,2800,823,3623,77.085106
4883,Vila Santa Catarina,62,2,2,1,1250,570,1820,29.35484
4884,Vila Mariana,54,2,1,1,2300,631,2931,54.27778
4885,Aclimação,45,2,1,0,1500,465,1965,43.666668
4886,Pompeia,84,3,3,1,2600,1266,3866,46.02381
4887,Vila Andrade,185,3,4,4,4500,2580,7080,38.27027
4888,Jardim Paulista,75,2,2,1,3500,1200,4700,62.666668
4889,Liberdade,52,2,1,1,1900,320,2220,42.692307
4890,Itaim Bibi,230,3,5,3,10000,2600,12600,54.782608
4891,Bela Vista,37,1,1,1,2950,411,3361,90.83784
4892,Outro,22,1,1,1,900,500,1400,63.636364
4893,Moema,145,3,5,2,8000,1513,9513,65.606895
4894,Lapa,80,2,1,1,1900,0,1900,23.75
4895,Lapa,83,3,3,2,3300,950,4250,51.20482
4896,Pinheiros,71,2,2,2,4200,864,5064,71.323944
4897,Jardim Paulista,44,1,1,1,1800,970,2770,62.954544
4898,Vila Clementino,55,2,1,0,2000,820,2820,51.272728
4899,Outro,60,1,1,0,1300,200,1500,25.0
4900,Chácara Santo Antônio,50,2,1,1,2000,670,2670,53.4
4901,Campo Belo,43,1,1,1,2900,550,3450,80.23256
4902,Outro,65,2,1,1,1200,352,1552,23.876923
4903,Saúde,96,3,3,2,2300,1056,3356,34.958332
4904,Outro,62,1,2,1,2300,380,2680,43.225807
4905,Cambuci,34,2,1,1,2000,185,2185,64.26471
4906,Outro,42,2,1,1,1000,185,1185,28.214285
4907,Itaim Bibi,100,3,2,1,4500,1100,5600,56.0
4908,Santa Cecília,40,1,1,1,1200,444,1644,41.1
4909,Vila Nova Conceição,104,1,2,2,10900,1400,12300,118.26923
4910,Brooklin,51,1,1,1,3300,592,3892,76.31373
4911,Outro,120,3,3,2,3800,1008,4808,40.066666
4912,Jaguaré,57,2,1,1,1400,600,2000,35.08772
4913,Outro,61,2,1,1,1840,0,1840,30.163935
4914,Jardim Prudência,73,2,2,2,3800,550,4350,59.589043
4915,Vila Olímpia,44,1,1,1,2600,627,3227,73.34091
4916,Outro,58,2,1,1,1000,500,1500,25.862068
4917,Jardim Europa,70,2,2,1,2400,1075,3475,49.642857
4918,Lapa,51,2,1,1,1900,466,2366,46.39216
4919,Itaim Bibi,80,2,3,1,3500,1150,4650,58.125
4920,Outro,70,3,1,1,1500,630,2130,30.428572
4921,Aclimação,33,1,1,1,1420,758,2178,66.0
4922,Pinheiros,66,2,2,1,4858,1351,6209,94.07576
4923,Barra Funda,40,1,1,1,2200,470,2670,66.75
4924,Chácara Klabin,53,2,2,2,3300,945,4245,80.09434
4925,Chácara Santo Antônio,113,3,3,2,11000,1160,12160,107.61062
4926,Outro,80,3,1,1,2500,973,3473,43.4125
4927,Alto Da Boa Vista,183,3,3,2,6600,1579,8179,44.69399
4928,Outro,70,2,1,0,1200,393,1593,22.757143
4929,Vila Nova Conceição,167,3,5,3,16500,2300,18800,112.57485
4930,Vila Olímpia,60,1,1,1,4800,1648,6448,107.46667
4931,Outro,55,2,1,1,1550,650,2200,40.0
4932,Jardim Paulista,40,1,1,1,3800,0,3800,95.0
4933,Perdizes,62,2,2,1,2700,800,3500,56.451614
4934,Outro,32,2,1,0,1200,187,1387,43.34375
4935,Itaim Bibi,105,3,2,2,5400,1212,6612,62.971428
4936,Saúde,35,1,1,0,1500,310,1810,51.714287
4937,República,45,1,1,0,1000,465,1465,32.555557
4938,Vila Mariana,37,1,1,1,3800,544,4344,117.4054
4939,Moema,80,2,3,2,3300,1160,4460,55.75
4940,Ipiranga,213,4,5,3,10000,2000,12000,56.338028
4941,Moema,125,3,3,1,3500,1490,4990,39.92
4942,Butantã,105,3,2,2,2300,1024,3324,31.657143
4943,Itaim Bibi,240,2,3,1,18000,3500,21500,89.583336
4944,Moema,46,1,1,1,2800,1400,4200,91.304344
4945,Outro,45,1,1,0,1000,0,1000,22.222221
4946,Itaim Bibi,52,1,2,1,4600,1050,5650,108.65385
4947,Outro,70,3,2,2,1990,741,2731,39.014286
4948,Pinheiros,70,2,1,1,5300,659,5959,85.12857
4949,Outro,50,1,1,1,3200,500,3700,74.0
4950,Jabaquara,65,2,1,1,1180,375,1555,23.923077
4951,Butantã,31,1,1,0,1500,175,1675,54.032257
4952,Outro,55,2,1,1,1250,506,1756,31.927273
4953,Indianópolis,40,1,1,1,1800,787,2587,64.675
4954,Pinheiros,70,2,1,0,2200,300,2500,35.714287
4955,Outro,75,2,1,0,1690,120,1810,24.133333
4956,Higienópolis,92,2,2,1,3000,705,3705,40.27174
4957,Jardim Paulista,74,2,2,1,4500,610,5110,69.054054
4958,Vila Madalena,149,3,4,2,5500,2683,8183,54.919464
4959,Outro,62,3,2,1,2200,580,2780,44.83871
4960,Santo Amaro,79,3,2,2,2490,870,3360,42.531647
4961,Santana,55,2,1,0,1400,502,1902,34.581818
4962,Moema,72,2,2,1,7500,900,8400,116.666664
4963,Alto Da Boa Vista,45,1,1,1,2200,380,2580,57.333332
4964,Alto Da Boa Vista,70,2,2,1,3300,771,4071,58.157143
4965,Tatuapé,64,3,1,1,1500,670,2170,33.90625
4966,Pompeia,146,3,5,3,5500,1340,6840,46.849316
4967,Vila Sônia,72,3,2,2,2000,889,2889,40.125
4968,Brooklin,60,1,2,0,1800,384,2184,36.4
4969,Vila Andrade,48,2,1,1,2600,0,2600,54.166668
4970,Brooklin,45,1,1,1,2720,585,3305,73.44444
4971,Vila Guarani,128,3,2,2,4600,1180,5780,45.15625
4972,Perdizes,57,2,2,1,3600,900,4500,78.947365
4973,Outro,42,2,1,1,1300,637,1937,46.11905
4974,Brooklin,148,3,2,2,6200,0,6200,41.89189
4975,Outro,72,3,2,1,1900,670,2570,35.694443
4976,Campo Belo,240,4,5,4,8000,3350,11350,47.291668
4977,Cambuci,82,2,2,1,2750,850,3600,43.90244
4978,Moema,465,5,8,6,60000,8350,68350,146.98924
4979,Outro,48,2,1,1,2100,0,2100,43.75
4980,Vila Uberabinha,60,2,2,1,3200,900,4100,68.333336
4981,Móoca,98,2,2,1,2300,700,3000,30.612246
4982,Vila Nova Conceição,72,1,2,2,4300,970,5270,73.19444
4983,Vila Mariana,80,2,1,1,2200,588,2788,34.85
4984,Jabaquara,49,1,1,1,1300,720,2020,41.22449
4985,Bela Vista,75,2,2,1,4300,1231,5531,73.746666
4986,Butantã,65,2,2,1,1900,1067,2967,45.646152
4987,Moema,76,2,2,1,2900,1040,3940,51.842106
4988,Bela Vista,42,1,1,1,1400,350,1750,41.666668
4989,Indianópolis,144,3,5,3,4000,1800,5800,40.27778
4990,Vila Nova Conceição,62,2,2,1,4800,873,5673,91.5
4991,Campo Belo,45,1,1,1,2600,650,3250,72.22222
4992,Perdizes,105,3,3,1,6000,1000,7000,66.666664
4993,Outro,58,2,1,2,4400,798,5198,89.62069
4994,Brooklin,65,2,1,1,4550,880,5430,83.53846
4995,Jardim Anália Franco,241,4,2,6,22000,4100,26100,108.29875
4996,Paraíso,100,3,3,1,4500,1146,5646,56.46
4997,Moema,135,3,4,1,5200,1390,6590,48.814816
4998,Mirandópolis,55,2,1,0,2000,340,2340,42.545456
4999,Jardim Anália Franco,40,1,1,1,2350,458,2808,70.2
5000,Pinheiros,42,1,1,1,2200,800,3000,71.42857
5001,Outro,72,3,2,1,1350,400,1750,24.305555
5002,Perdizes,81,3,3,1,3500,1000,4500,55.555557
5003,Pinheiros,65,2,2,0,2500,1011,3511,54.015385
5004,Barra Funda,75,3,2,2,3500,650,4150,55.333332
5005,Itaim Bibi,150,2,3,1,3800,1400,5200,34.666668
5006,Vila Olímpia,94,3,2,1,2900,942,3842,40.87234
5007,Bela Vista,51,1,1,1,3300,400,3700,72.54902
5008,Outro,80,2,1,3,2750,1342,4092,51.15
5009,Santo Amaro,85,3,2,1,3500,600,4100,48.235294
5010,Outro,141,3,4,3,3980,900,4880,34.60993
5011,Santa Cecília,149,2,1,0,2900,794,3694,24.791946
5012,Outro,45,1,1,0,1050,55,1105,24.555555
5013,Outro,40,2,1,1,2300,405,2705,67.625
5014,Vila Olímpia,55,2,1,1,3700,640,4340,78.90909
5015,Tatuapé,52,2,1,1,2400,0,2400,46.153847
5016,Perdizes,82,3,3,0,2700,1300,4000,48.780487
5017,Jaguaré,70,3,1,2,2300,706,3006,42.942856
5018,Vila Olímpia,72,3,2,1,4170,1010,5180,71.94444
5019,Paraíso,80,2,2,1,2500,980,3480,43.5
5020,Aclimação,30,1,1,0,1100,330,1430,47.666668
5021,Bela Vista,42,1,1,1,2500,416,2916,69.42857
5022,Paraíso,147,3,2,1,3500,1445,4945,33.639454
5023,Cidade Monções,70,2,1,2,4200,840,5040,72.0
5024,Vila Andrade,48,2,1,1,1790,410,2200,45.833332
5025,Consolação,50,2,2,1,2416,580,2996,59.92
5026,Bela Vista,81,2,1,0,2800,768,3568,44.04938
5027,Outro,67,2,1,1,2100,441,2541,37.925373
5028,Aclimação,95,3,2,1,1900,801,2701,28.43158
5029,Outro,47,2,1,1,1500,0,1500,31.914894
5030,Barra Funda,112,3,4,2,5600,1100,6700,59.82143
5031,Itaim Bibi,275,4,3,5,30000,4746,34746,126.34909
5032,Vila Nova Conceição,222,3,1,4,20000,5800,25800,116.21622
5033,Morumbi,97,3,3,2,2528,1600,4128,42.5567
5034,Bela Vista,40,1,1,0,1200,440,1640,41.0
5035,Aclimação,70,1,2,1,2200,763,2963,42.32857
5036,Brooklin,133,3,3,2,10000,1357,11357,85.390976
5037,Jardim Paulista,38,1,1,1,1500,987,2487,65.447365
5038,Campo Belo,100,3,3,1,2400,922,3322,33.22
5039,Cerqueira César,98,2,3,1,5300,676,5976,60.97959
5040,Tatuapé,88,3,1,1,1400,1400,2800,31.818182
5041,Bela Vista,50,1,1,0,8500,0,8500,170.0
5042,Vila Leopoldina,143,3,5,2,6000,1340,7340,51.32867
5043,Itaim Bibi,120,2,2,1,3300,620,3920,32.666668
5044,Outro,54,2,1,1,930,470,1400,25.925926
5045,Outro,70,2,2,1,3200,848,4048,57.82857
5046,Freguesia do Ó,65,2,1,1,900,700,1600,24.615385
5047,Jardim Paulista,45,1,1,1,2200,837,3037,67.48889
5048,Vila Madalena,72,2,2,1,3350,800,4150,57.63889
5049,Vila Mariana,82,2,2,1,2000,820,2820,34.390244
5050,Aclimação,50,1,1,0,1200,260,1460,29.2
5051,Chácara Santo Antônio,130,3,4,2,6000,1132,7132,54.861538
5052,Consolação,39,1,1,1,2400,392,2792,71.589745
5053,Outro,192,4,6,4,8000,3254,11254,58.614582
5054,Pinheiros,95,3,3,2,4800,1500,6300,66.31579
5055,Outro,73,3,2,1,1980,550,2530,34.657536
5056,Jardim Paulista,35,1,1,1,1600,573,2173,62.085712
5057,Outro,80,3,2,2,2700,841,3541,44.2625
5058,Itaim Bibi,261,5,4,4,30000,4200,34200,131.03448
5059,Vila Nova Conceição,40,1,1,1,2100,850,2950,73.75
5060,Consolação,50,2,2,1,2416,580,2996,59.92
5061,Bela Vista,81,2,1,0,2800,768,3568,44.04938
5062,Outro,35,1,1,1,2000,706,2706,77.314285
5063,Pinheiros,37,1,1,1,2800,1200,4000,108.10811
5064,Outro,50,2,1,1,1000,500,1500,30.0
5065,Tatuapé,85,2,2,2,3400,880,4280,50.35294
5066,Pinheiros,72,2,2,1,2950,954,3904,54.22222
5067,Tatuapé,40,1,1,0,1380,100,1480,37.0
5068,Paraíso,87,2,2,1,3300,737,4037,46.402298
5069,Vila Olímpia,220,4,6,3,27000,1700,28700,130.45454
5070,Vila Nova Conceição,136,3,4,2,11000,2000,13000,95.588234
5071,Moema,74,2,2,1,4350,1250,5600,75.675674
5072,Jabaquara,60,2,1,1,1400,450,1850,30.833334
5073,Granja Julieta,38,1,1,1,2500,577,3077,80.97369
5074,Campo Belo,325,4,8,4,3500,5000,8500,26.153847
5075,Vila Olímpia,45,1,1,1,5000,900,5900,131.11111
5076,Itaim Bibi,83,2,1,1,3500,1100,4600,55.421688
5077,Vila Mariana,110,3,2,1,4070,828,4898,44.52727
5078,Indianópolis,140,4,3,2,7000,1764,8764,62.6
5079,Pinheiros,72,3,2,1,2900,896,3796,52.72222
5080,Alto de Pinheiros,62,2,1,1,1950,969,2919,47.080647
5081,Pompeia,70,3,1,1,2200,740,2940,42.0
5082,Outro,56,2,1,1,1200,100,1300,23.214285
5083,Bela Vista,55,1,1,0,3000,374,3374,61.345455
5084,Vila Prudente,61,3,2,1,1700,537,2237,36.67213
5085,Moema,127,2,4,2,10500,1320,11820,93.07087
5086,Outro,32,1,1,0,1500,298,1798,56.1875
5087,Perdizes,104,3,1,2,7300,980,8280,79.61539
5088,Campo Belo,38,1,1,1,2000,700,2700,71.052635
5089,Outro,76,2,1,0,1391,340,1731,22.776316
5090,Jardim Paulista,70,2,1,1,2600,860,3460,49.42857
5091,Paraíso,160,2,4,1,4800,1300,6100,38.125
5092,Moema,40,1,1,1,1800,789,2589,64.725
5093,Santa Ifigênia,30,1,1,1,2400,480,2880,96.0
5094,Tatuapé,43,1,1,1,2300,360,2660,61.860466
5095,Bela Vista,70,2,1,1,1500,700,2200,31.428572
5096,Jabaquara,89,3,2,2,2800,650,3450,38.764046
5097,Outro,50,2,1,1,1500,450,1950,39.0
5098,Outro,89,2,3,2,9500,2818,12318,138.4045
5099,Brooklin,62,2,2,1,2800,750,3550,57.258064
5100,Centro,30,1,1,0,1500,338,1838,61.266666
5101,Itaim Bibi,128,2,4,3,15000,2100,17100,133.59375
5102,Pinheiros,46,1,1,1,2000,1300,3300,71.73913
5103,Jardim Paulista,120,2,3,2,7500,1450,8950,74.583336
5104,Vila Uberabinha,142,2,5,3,8980,2840,11820,83.23943
5105,Outro,69,3,2,1,1150,1088,2238,32.434784
5106,Outro,56,2,1,1,1000,0,1000,17.857143
5107,Outro,34,2,1,0,2100,0,2100,61.764706
5108,Santana,70,3,2,2,1950,700,2650,37.857143
5109,Bela Vista,36,1,1,1,2130,590,2720,75.55556
5110,Perdizes,81,3,3,1,3500,984,4484,55.358025
5111,Outro,56,2,1,2,1700,670,2370,42.32143
5112,Campo Belo,49,1,1,1,2950,575,3525,71.938774
5113,Ipiranga,60,2,2,1,2100,454,2554,42.566666
5114,Itaim Bibi,65,2,1,1,2300,900,3200,49.23077
5115,Pinheiros,30,1,1,0,3200,0,3200,106.666664
5116,Vila Olímpia,94,3,3,2,7500,1196,8696,92.510635
5117,Bela Vista,25,1,1,0,1200,295,1495,59.8
5118,Chácara Santo Antônio,34,1,1,0,1100,140,1240,36.47059
5119,Indianópolis,50,1,1,1,2100,860,2960,59.2
5120,Jardim Paulista,70,1,1,1,3900,1082,4982,71.171425
5121,Pirituba,49,2,1,1,1200,648,1848,37.714287
5122,Consolação,46,1,1,1,2150,555,2705,58.804348
5123,Água Branca,70,3,2,1,2600,444,3044,43.485714
5124,Cidade Monções,51,1,1,1,4200,750,4950,97.05882
5125,Outro,45,1,1,0,950,0,950,21.11111
5126,Chácara Santo Antônio,45,1,1,1,2200,500,2700,60.0
5127,Consolação,24,1,1,1,2000,250,2250,93.75
5128,Vila Madalena,58,2,2,1,4400,700,5100,87.93104
5129,Outro,70,2,1,1,2400,600,3000,42.857143
5130,Lapa,87,3,2,2,4500,630,5130,58.96552
5131,Vila Olímpia,95,3,2,1,1990,1370,3360,35.36842
5132,Chácara Santo Antônio,85,2,2,2,1600,1900,3500,41.17647
5133,Vila Mariana,73,2,2,2,4000,0,4000,54.79452
5134,Ipiranga,96,3,2,1,1600,1200,2800,29.166666
5135,Vila Romana,62,2,2,1,3000,630,3630,58.548386
5136,Tatuapé,20,1,1,0,909,100,1009,50.45
5137,Paraíso,36,1,1,1,3200,0,3200,88.888885
5138,Moema,100,3,4,1,4500,1300,5800,58.0
5139,Perdizes,67,2,2,1,1900,930,2830,42.238808
5140,Santa Cecília,58,2,1,1,1800,1643,3443,59.36207
5141,Moema,50,1,1,1,1650,1040,2690,53.8
5142,Vila Olímpia,62,2,2,1,3990,868,4858,78.354836
5143,Chácara Santo Antônio,70,1,1,1,3500,780,4280,61.142857
5144,Outro,80,2,2,1,2300,847,3147,39.3375
5145,Jabaquara,55,2,1,1,1300,433,1733,31.50909
5146,Vila Olímpia,60,2,2,2,2700,1048,3748,62.466667
5147,Outro,41,2,1,0,1450,0,1450,35.365852
5148,Brooklin,86,2,2,1,3200,680,3880,45.11628
5149,Pirituba,50,2,1,1,1100,287,1387,27.74
5150,Higienópolis,60,2,2,1,4500,749,5249,87.48333
5151,Vila Leopoldina,50,1,1,1,2300,650,2950,59.0
5152,Vila Nova Conceição,222,4,4,4,20000,5500,25500,114.86487
5153,Vila Clementino,42,1,1,1,2100,700,2800,66.666664
5154,Cambuci,63,2,2,1,1900,806,2706,42.95238
5155,Outro,50,2,1,1,880,190,1070,21.4
5156,Vila Guarani,65,2,1,1,1950,359,2309,35.523075
5157,Perdizes,270,4,6,4,17000,3450,20450,75.74074
5158,Aclimação,98,3,2,1,3850,1310,5160,52.65306
5159,Vila Olímpia,50,1,2,1,2100,753,2853,57.06
5160,Saúde,68,2,2,2,2800,987,3787,55.691177
5161,Brooklin,460,4,6,4,28000,3100,31100,67.608696
5162,Pinheiros,73,2,1,1,2000,950,2950,40.410957
5163,Itaim Bibi,60,2,2,1,3300,938,4238,70.63333
5164,Outro,60,2,2,2,3200,580,3780,63.0
5165,Outro,55,2,2,1,1200,464,1664,30.254545
5166,Tatuapé,27,1,1,0,1700,220,1920,71.111115
5167,Outro,72,3,2,1,2200,489,2689,37.34722
5168,Mirandópolis,55,1,2,1,3500,504,4004,72.8
5169,Granja Julieta,38,1,1,1,2000,512,2512,66.10526
5170,Chácara Santo Antônio,96,3,3,1,2500,1180,3680,38.333332
5171,Outro,63,2,2,1,1500,650,2150,34.126984
5172,Butantã,13,1,1,0,1220,1000,2220,170.76923
5173,Outro,50,2,1,0,1340,350,1690,33.8
5174,Vila Clementino,65,2,2,1,1700,1218,2918,44.892307
5175,Barra Funda,65,3,1,2,2000,499,2499,38.446156
5176,Outro,50,2,1,1,1650,0,1650,33.0
5177,Água Branca,94,2,2,2,4500,847,5347,56.88298
5178,Vila Uberabinha,50,1,1,1,1450,1550,3000,60.0
5179,Perdizes,34,1,1,1,2600,698,3298,97.0
5180,Itaim Bibi,54,1,2,1,7300,970,8270,153.14815
5181,Brooklin,85,2,3,2,8500,1110,9610,113.05882
5182,Pinheiros,130,3,1,1,2499,0,2499,19.223078
5183,Itaim Bibi,90,2,2,1,5300,996,6296,69.95556
5184,Itaim Bibi,50,1,1,1,3500,1290,4790,95.8
5185,Pompeia,60,2,1,1,2800,878,3678,61.3
5186,Indianópolis,24,1,1,1,1800,400,2200,91.666664
5187,Perdizes,125,3,5,2,3000,1500,4500,36.0
5188,Tatuapé,148,3,5,2,7500,1210,8710,58.851353
5189,Vila Leopoldina,56,2,2,1,2300,620,2920,52.142857
5190,Vila Mascote,60,2,1,1,1500,875,2375,39.583332
5191,Saúde,80,3,3,2,2300,1200,3500,43.75
5192,Lapa,54,2,2,1,2200,734,2934,54.333332
5193,Vila Mascote,90,3,4,2,2700,1100,3800,42.22222
5194,Pirituba,68,2,1,1,1100,430,1530,22.5
5195,Cerqueira César,90,2,2,2,5428,1580,7008,77.86667
5196,Outro,107,3,3,2,2300,1150,3450,32.242992
5197,Itaim Bibi,62,1,1,1,11000,1230,12230,197.25807
5198,Mirandópolis,60,2,2,2,3800,1092,4892,81.53333
5199,Brás,59,2,1,1,2400,407,2807,47.57627
5200,Outro,40,1,1,1,1100,530,1630,40.75
5201,Outro,58,2,2,1,1850,645,2495,43.017242
5202,Morumbi,35,1,2,1,1350,700,2050,58.57143
5203,Vila Madalena,92,2,3,2,6500,1400,7900,85.86957
5204,Perdizes,130,3,2,2,3800,1005,4805,36.96154
5205,Bela Vista,85,2,2,0,2400,650,3050,35.882355
5206,Outro,35,1,1,0,530,0,530,15.142858
5207,Pinheiros,45,1,1,0,2100,381,2481,55.133335
5208,Tatuapé,80,3,3,2,2200,720,2920,36.5
5209,Vila Sônia,74,3,2,2,2200,855,3055,41.283783
5210,Outro,30,1,1,0,1400,90,1490,49.666668
5211,Pinheiros,47,1,1,1,2780,650,3430,72.97872
5212,Aclimação,37,1,1,0,1100,323,1423,38.45946
5213,Itaim Bibi,50,1,2,1,2800,856,3656,73.12
5214,Sumaré,74,2,3,2,5900,880,6780,91.62162
5215,Vila Olímpia,70,2,2,1,2500,933,3433,49.04286
5216,Outro,40,2,1,0,1250,0,1250,31.25
5217,Vila Formosa,56,2,1,1,900,646,1546,27.607143
5218,Vila Romana,60,1,1,1,1200,880,2080,34.666668
5219,Vila Romana,73,2,2,2,3000,850,3850,52.739727
5220,Pompeia,105,2,2,1,2500,1100,3600,34.285713
5221,Chácara Klabin,57,1,2,2,1700,1350,3050,53.508774
5222,Itaim Bibi,38,1,1,1,1990,770,2760,72.63158
5223,Consolação,40,1,1,1,1400,625,2025,50.625
5224,Jardim Paulista,162,3,5,4,14000,2700,16700,103.08642
5225,Campo Belo,57,2,3,1,2600,952,3552,62.31579
5226,Vila Olímpia,67,2,3,1,3700,800,4500,67.16418
5227,Pinheiros,90,2,2,0,3200,1200,4400,48.88889
5228,Outro,82,3,2,2,3000,580,3580,43.658535
5229,Outro,49,2,1,1,900,100,1000,20.408163
5230,Vila Nova Conceição,80,2,1,0,2850,759,3609,45.1125
5231,Campo Belo,83,2,3,2,4500,700,5200,62.650604
5232,Campos Eliseos,40,1,1,1,1550,502,2052,51.3
5233,Tatuapé,91,3,2,2,4700,850,5550,60.98901
5234,Campo Belo,60,2,2,1,2000,952,2952,49.2
5235,Ipiranga,56,2,1,1,1600,741,2341,41.80357
5236,Ipiranga,37,1,1,0,1650,0,1650,44.594593
5237,Moema,90,3,3,2,3950,1990,5940,66.0
5238,Vila Mariana,130,3,3,1,3000,1343,4343,33.407692
5239,Perdizes,106,3,2,1,3500,989,4489,42.349056
5240,Pirituba,50,2,1,1,1600,400,2000,40.0
5241,Pinheiros,48,1,2,1,2700,807,3507,73.0625
5242,Vila Romana,50,2,2,1,2700,582,3282,65.64
5243,Santa Ifigênia,26,1,1,1,2700,0,2700,103.84615
5244,Morumbi,350,4,6,5,4100,4800,8900,25.428572
5245,Higienópolis,80,3,3,2,4900,1070,5970,74.625
5246,Moema,80,2,2,2,7000,613,7613,95.1625
5247,Outro,73,3,2,0,2000,788,2788,38.19178
5248,Jardim Paulista,30,1,1,1,890,1910,2800,93.333336
5249,Itaim Bibi,36,1,1,1,1500,1694,3194,88.72222
5250,Pinheiros,90,3,2,0,2800,600,3400,37.77778
5251,Vila Mariana,85,3,2,2,2800,1050,3850,45.294117
5252,Outro,53,2,1,1,1600,350,1950,36.792454
5253,Outro,54,2,1,1,1100,180,1280,23.703703
5254,Pinheiros,300,4,4,4,14900,3118,18018,60.06
5255,Jardim Europa,750,4,7,6,180000,24000,204000,272.0
5256,Outro,60,2,1,1,1400,465,1865,31.083334
5257,República,41,1,1,1,2000,479,2479,60.463413
5258,Outro,62,2,2,1,1900,517,2417,38.98387
5259,Moema,70,2,3,2,3300,1266,4566,65.22857
5260,Alto Da Boa Vista,88,3,2,1,4500,583,5083,57.761364
5261,Paraíso,108,2,3,1,4000,982,4982,46.12963
5262,Outro,80,3,1,1,1400,646,2046,25.575
5263,Outro,50,2,1,1,1100,435,1535,30.7
5264,Outro,69,3,2,1,3500,450,3950,57.246376
5265,Freguesia do Ó,70,2,2,1,2500,370,2870,41.0
5266,Vila Andrade,70,3,2,3,1900,930,2830,40.42857
5267,Perdizes,52,2,2,2,3600,800,4400,84.61539
5268,Móoca,55,2,1,1,1600,617,2217,40.30909
5269,Aclimação,118,2,3,2,3100,1360,4460,37.79661
5270,Outro,49,2,1,1,1600,0,1600,32.65306
5271,Móoca,80,2,1,1,1650,920,2570,32.125
5272,Ipiranga,54,2,1,1,1800,479,2279,42.203705
5273,Outro,80,3,2,2,2800,862,3662,45.775
5274,Alto de Pinheiros,208,3,4,3,14000,2000,16000,76.92308
5275,Campo Belo,90,2,2,1,1500,1500,3000,33.333332
5276,Itaim Bibi,136,3,4,2,6000,1500,7500,55.14706
5277,Vila Mariana,123,3,5,3,5600,1198,6798,55.26829
5278,Brooklin,66,1,2,1,7500,652,8152,123.51515
5279,Itaim Bibi,140,3,4,1,16000,1890,17890,127.78571
5280,Outro,143,4,4,2,3900,1000,4900,34.265736
5281,Paraíso,66,2,2,1,4000,700,4700,71.21212
5282,Vila Andrade,75,3,2,2,2300,676,2976,39.68
5283,Outro,50,2,1,1,1000,510,1510,30.2
5284,Pompeia,65,2,1,0,1900,200,2100,32.307693
5285,Saúde,70,3,2,1,1450,900,2350,33.57143
5286,Butantã,95,2,2,2,4100,810,4910,51.68421
5287,Outro,53,1,1,1,3000,1330,4330,81.69811
5288,Vila Gomes Cardim,165,4,4,3,4500,1100,5600,33.939392
5289,Brooklin,147,3,3,3,8000,1573,9573,65.12245
5290,Itaim Bibi,53,1,2,1,2500,822,3322,62.679245
5291,Cambuci,86,2,3,2,2900,885,3785,44.011627
5292,Brooklin,35,1,1,1,2600,325,2925,83.57143
5293,Outro,54,2,2,1,2100,500,2600,48.148148
5294,Vila Mariana,222,4,6,4,20000,2369,22369,100.76126
5295,Bela Vista,42,1,1,1,2000,431,2431,57.88095
5296,Outro,35,1,1,0,1000,200,1200,34.285713
5297,Consolação,62,2,2,1,3500,645,4145,66.854836
5298,Itaim Bibi,100,3,3,1,4000,1250,5250,52.5
5299,Itaim Bibi,146,3,4,2,19500,1708,21208,145.26027
5300,Vila Madalena,18,1,1,0,1300,0,1300,72.22222
5301,Santa Cecília,72,2,2,1,2900,982,3882,53.916668
5302,Liberdade,62,1,1,0,1190,375,1565,25.241936
5303,Pinheiros,80,2,2,1,3650,1283,4933,61.6625
5304,Vila Olímpia,55,2,1,1,2300,863,3163,57.50909
5305,Outro,42,2,1,0,1400,180,1580,37.61905
5306,Itaim Bibi,50,1,1,1,5000,1289,6289,125.78
5307,Moema,125,3,5,2,8500,1250,9750,78.0
5308,Consolação,35,1,1,1,1300,576,1876,53.6
5309,Mirandópolis,62,2,1,1,2000,580,2580,41.612904
5310,Chácara Santo Antônio,80,3,2,1,3300,835,4135,51.6875
5311,Bela Vista,50,2,1,0,1500,300,1800,36.0
5312,Brooklin,49,1,1,1,3000,645,3645,74.38776
5313,Jabaquara,38,1,1,1,1700,349,2049,53.92105
5314,Jardim Paulista,41,1,1,0,1350,422,1772,43.219513
5315,Morumbi,70,2,2,2,3600,1090,4690,67.0
5316,Brooklin,120,2,2,2,6000,1050,7050,58.75
5317,Bela Vista,75,3,3,1,3500,910,4410,58.8
5318,Brooklin,65,2,2,2,4100,685,4785,73.61539
5319,Cambuci,80,2,2,0,1800,668,2468,30.85
5320,Pinheiros,44,1,1,1,3800,600,4400,100.0
5321,Campo Belo,80,1,2,2,5500,1036,6536,81.7
5322,Outro,55,2,1,0,1000,160,1160,21.09091
5323,Itaim Bibi,63,1,1,1,3200,1250,4450,70.63492
5324,Brooklin,40,1,1,1,2000,670,2670,66.75
5325,Pinheiros,90,2,2,1,2900,780,3680,40.88889
5326,Ipiranga,111,3,4,2,5500,1100,6600,59.45946
5327,Brooklin,64,2,2,1,3200,730,3930,61.40625
5328,Paraíso,66,2,2,1,4500,865,5365,81.28788
5329,Santa Ifigênia,44,1,1,1,2600,624,3224,73.27273
5330,Itaim Bibi,97,3,3,2,4200,1419,5619,57.927834
5331,Brooklin,45,1,1,1,3999,586,4585,101.888885
5332,Saúde,130,4,2,3,5700,750,6450,49.615383
5333,Moema,50,1,1,1,2300,780,3080,61.6
5334,Jabaquara,85,3,2,1,1400,800,2200,25.882353
5335,Pirituba,70,2,2,2,1950,660,2610,37.285713
5336,Pinheiros,110,3,3,2,4500,1350,5850,53.18182
5337,Brooklin,36,1,1,1,2500,420,2920,81.111115
5338,Vila Mariana,105,3,3,2,4500,1500,6000,57.142857
5339,Vila Andrade,41,2,1,0,1580,290,1870,45.609756
5340,Paraíso,71,2,2,0,1700,713,2413,33.985916
5341,Jardim Paulista,196,4,5,3,8000,2895,10895,55.586735
5342,Outro,61,3,1,2,1700,624,2324,38.098362
5343,Vila Mariana,90,2,2,1,2250,950,3200,35.555557
5344,Consolação,56,2,1,1,2900,918,3818,68.17857
5345,Aclimação,34,1,1,1,2100,490,2590,76.17647
5346,Outro,52,2,1,1,1300,0,1300,25.0
5347,Jardim Marajoara,233,4,5,3,8500,1884,10384,44.566525
5348,Morumbi,72,2,2,2,2000,1500,3500,48.61111
5349,Chácara Santo Antônio,95,2,3,2,5900,700,6600,69.47369
5350,Pinheiros,133,1,3,2,11000,1775,12775,96.052635
5351,Vila Mariana,82,2,2,0,1400,350,1750,21.341463
5352,Vila Clementino,38,1,1,1,2200,680,2880,75.789474
5353,Alto de Pinheiros,364,4,6,5,26000,5150,31150,85.57692
5354,Morumbi,80,3,1,1,1500,485,1985,24.8125
5355,Vila Uberabinha,75,2,1,1,2200,1270,3470,46.266666
5356,Santana,70,2,1,1,1400,390,1790,25.571428
5357,Chácara Santo Antônio,48,2,1,1,2450,580,3030,63.125
5358,Pinheiros,60,2,1,1,3500,880,4380,73.0
5359,Aclimação,67,2,2,1,2900,990,3890,58.0597
5360,Vila Mariana,90,2,1,0,2200,250,2450,27.222221
5361,Outro,410,4,4,6,17000,6500,23500,57.317074
5362,Outro,50,2,1,1,1300,100,1400,28.0
5363,Vila Clementino,43,1,1,0,2360,457,2817,65.51163
5364,Brooklin,155,4,5,2,9700,1800,11500,74.19355
5365,Móoca,52,2,1,1,2500,450,2950,56.73077
5366,Cidade Monções,49,1,2,1,2000,1200,3200,65.30612
5367,Vila Mariana,79,2,2,1,1950,1030,2980,37.72152
5368,Higienópolis,347,4,6,5,20000,10549,30549,88.03746
5369,Bela Vista,46,1,1,1,3100,381,3481,75.67391
5370,Moema,70,2,2,1,3000,850,3850,55.0
5371,Outro,74,2,1,1,1500,10,1510,20.405405
5372,Vila Buarque,50,2,1,0,1550,524,2074,41.48
5373,Jardim Paulista,50,1,2,0,1800,130,1930,38.6
5374,Jardim América,117,2,3,1,5500,1895,7395,63.205128
5375,Brás,49,2,1,1,1800,460,2260,46.122448
5376,Vila Mariana,23,1,1,0,1650,0,1650,71.73913
5377,Itaim Bibi,42,1,1,1,2100,1200,3300,78.57143
5378,Pinheiros,45,1,1,1,2100,682,2782,61.822224
5379,Outro,83,2,3,2,4500,699,5199,62.638554
5380,Vila Madalena,100,3,3,2,2500,1050,3550,35.5
5381,Vila Clementino,107,3,2,0,2500,1343,3843,35.91589
5382,Vila Clementino,65,2,2,1,4200,830,5030,77.38461
5383,Cambuci,36,1,1,1,1700,388,2088,58.0
5384,Paraíso,54,2,1,1,3000,0,3000,55.555557
5385,Vila Mariana,41,1,1,1,2000,487,2487,60.658535
5386,Jardim América,190,3,5,1,8500,2200,10700,56.31579
5387,Outro,70,2,2,1,1800,492,2292,32.74286
5388,Outro,48,2,1,1,1645,458,2103,43.8125
5389,Outro,50,2,1,1,1500,350,1850,37.0
5390,Mirandópolis,27,1,1,0,1650,280,1930,71.48148
5391,Paraíso,110,3,3,1,2500,1280,3780,34.363636
5392,Saúde,43,1,1,1,2000,425,2425,56.395348
5393,Vila Olímpia,33,1,1,1,1600,1300,2900,87.878784
5394,Santana,40,1,1,1,2200,486,2686,67.15
5395,Jardim Prudência,59,2,2,1,2500,550,3050,51.694916
5396,Vila Mascote,65,3,2,1,3000,615,3615,55.615383
5397,Vila Mariana,45,1,1,1,3270,830,4100,91.111115
5398,Aclimação,81,2,1,1,3000,208,3208,39.60494
5399,Brooklin,45,1,1,1,3300,537,3837,85.26667
5400,Liberdade,38,1,1,0,1850,350,2200,57.894737
5401,Jardim América,100,2,3,2,9000,1801,10801,108.01
5402,Outro,95,3,3,2,3400,1000,4400,46.31579
5403,Vila Guarani,55,2,1,1,1550,669,2219,40.345455
5404,Outro,41,2,1,1,1500,300,1800,43.90244
5405,Pompeia,72,3,2,1,2800,872,3672,51.0
5406,Outro,120,3,2,2,2600,1722,4322,36.016666
5407,Outro,74,3,2,1,2500,0,2500,33.783783
5408,Outro,45,1,1,0,1300,243,1543,34.288887
5409,Outro,55,2,1,1,1300,550,1850,33.636364
5410,Campo Belo,50,1,1,1,3000,578,3578,71.56
5411,Outro,75,2,2,2,1600,840,2440,32.533333
5412,Outro,433,4,6,6,25000,3643,28643,66.150116
5413,Jardim Marajoara,55,2,1,1,1900,580,2480,45.090908
5414,Perdizes,90,2,2,1,2400,321,2721,30.233334
5415,Outro,50,2,1,1,1600,350,1950,39.0
5416,Bela Vista,47,2,1,1,2800,0,2800,59.574467
5417,Vila Mascote,116,3,4,2,3470,1350,4820,41.551723
5418,Brooklin,70,1,2,1,6800,778,7578,108.25714
5419,Jardim Paulista,345,4,4,5,15000,5111,20111,58.292755
5420,Vila Olímpia,65,2,2,0,3500,755,4255,65.46154
5421,Vila Buarque,59,2,2,1,3000,490,3490,59.152542
5422,Outro,74,3,2,1,2177,760,2937,39.68919
5423,Campo Belo,36,1,1,1,2300,490,2790,77.5
5424,Liberdade,26,1,1,0,1800,335,2135,82.11539
5425,Consolação,41,1,1,0,1800,398,2198,53.609756
5426,Cambuci,72,2,2,1,2750,799,3549,49.291668
5427,Santana,75,3,2,1,2330,718,3048,40.64
5428,Jabaquara,46,2,1,1,1300,470,1770,38.47826
5429,Vila Madalena,61,2,2,1,5100,850,5950,97.540985
5430,Vila Santa Catarina,51,2,1,1,1300,571,1871,36.686275
5431,Outro,50,2,1,0,1600,350,1950,39.0
5432,Brooklin,100,2,2,1,3500,1615,5115,51.15
5433,Perdizes,224,3,4,2,6000,2000,8000,35.714287
5434,Itaim Bibi,117,2,2,2,8500,2100,10600,90.59829
5435,Aclimação,85,3,2,1,3000,813,3813,44.85882
5436,Jardim Marajoara,63,3,1,1,1800,450,2250,35.714287
5437,Higienópolis,130,3,2,1,6000,1300,7300,56.153847
5438,Vila Mariana,125,3,4,3,3600,1960,5560,44.48
5439,Pompeia,58,2,2,1,3150,735,3885,66.98276
5440,Saúde,70,2,2,1,2000,747,2747,39.24286
5441,Brooklin,70,2,1,1,4000,706,4706,67.22857
5442,Outro,243,4,5,4,12000,2000,14000,57.61317
5443,Outro,40,2,1,0,1450,0,1450,36.25
5444,Brooklin,60,2,2,2,5300,806,6106,101.76667
5445,Outro,18,1,1,0,1500,0,1500,83.333336
5446,Moema,245,4,4,4,25000,3500,28500,116.32653
5447,Vila Romana,61,2,2,1,2500,952,3452,56.590164
5448,Moema,46,1,2,1,1900,529,2429,52.804348
5449,Moema,98,3,3,1,3800,1191,4991,50.92857
5450,Jardim Prudência,70,3,2,1,2200,750,2950,42.142857
5451,Outro,63,2,2,1,4800,805,5605,88.968254
5452,Outro,62,2,1,1,1850,590,2440,39.35484
5453,Vila Romana,94,3,3,2,3499,736,4235,45.053192
5454,Brooklin,49,1,2,1,3200,546,3746,76.44898
5455,Higienópolis,48,1,1,1,1580,760,2340,48.75
5456,Vila Nova Conceição,40,1,1,1,3200,0,3200,80.0
5457,Pinheiros,110,3,1,0,2000,395,2395,21.772728
5458,Moema,72,2,2,2,5500,790,6290,87.361115
5459,Brooklin,68,1,2,1,3982,1100,5082,74.73529
5460,Pinheiros,62,2,2,0,3800,0,3800,61.29032
5461,Bela Vista,98,3,2,1,3300,995,4295,43.82653
5462,Consolação,50,2,1,1,3700,650,4350,87.0
5463,Centro,90,2,1,0,1800,0,1800,20.0
5464,Móoca,60,2,2,2,2100,641,2741,45.683334
5465,Butantã,82,3,2,1,2550,539,3089,37.67073
5466,Moema,55,2,2,2,3150,950,4100,74.545456
5467,Moema,66,2,2,1,2100,936,3036,46.0
5468,Chácara Klabin,90,3,1,2,3200,789,3989,44.322224
5469,Consolação,37,1,1,1,2200,533,2733,73.86487
5470,Outro,61,3,2,1,1300,600,1900,31.147541
5471,Cambuci,200,3,2,3,4000,2400,6400,32.0
5472,Campo Belo,222,3,5,4,15000,2020,17020,76.666664
5473,Moema,120,2,4,2,14000,1500,15500,129.16667
5474,Santana,123,3,2,2,4300,0,4300,34.95935
5475,Pinheiros,60,2,1,0,2500,530,3030,50.5
5476,Outro,72,2,2,2,4200,750,4950,68.75
5477,Barra Funda,42,1,1,1,2600,750,3350,79.7619
5478,Bela Vista,51,2,1,0,2300,583,2883,56.52941
5479,Bom Retiro,58,2,2,2,1950,485,2435,41.982758
5480,Pinheiros,30,1,1,0,2500,600,3100,103.333336
5481,Outro,90,3,2,1,1048,564,1612,17.911112
5482,Vila Mascote,85,2,3,2,4500,693,5193,61.094116
5483,Higienópolis,170,3,3,3,8000,5400,13400,78.82353
5484,Vila Anastácio,96,3,3,2,4300,650,4950,51.5625
5485,Itaim Bibi,103,2,3,1,4700,1003,5703,55.36893
5486,Vila Buarque,62,1,1,0,1300,427,1727,27.85484
5487,Móoca,64,2,2,1,2700,800,3500,54.6875
5488,Tatuapé,49,1,1,0,1000,390,1390,28.367348
5489,Moema,137,4,5,3,10500,1900,12400,90.51095
5490,Bela Vista,31,1,1,0,1500,494,1994,64.32258
5491,Santa Cecília,35,1,1,0,800,350,1150,32.857143
5492,Centro,26,1,1,0,1300,335,1635,62.884617
5493,Vila Mariana,80,2,3,1,2500,902,3402,42.525
5494,Paraíso,180,4,4,2,4500,2000,6500,36.11111
5495,Jardim Paulista,87,2,2,2,7500,1670,9170,105.4023
5496,Cambuci,64,2,2,1,2860,560,3420,53.4375
5497,Santa Ifigênia,40,1,1,1,2500,450,2950,73.75
5498,Perdizes,65,2,2,2,3100,800,3900,60.0
5499,Tatuapé,63,3,2,1,2200,380,2580,40.95238
5500,Vila Mariana,75,2,2,1,2300,950,3250,43.333332
5501,Perdizes,48,1,1,1,1800,640,2440,50.833332
5502,Pinheiros,49,2,1,1,2900,657,3557,72.591835
5503,Outro,55,2,1,1,1500,495,1995,36.272728
5504,Barra Funda,54,2,2,1,2250,572,2822,52.25926
5505,Consolação,45,1,1,1,2500,800,3300,73.333336
5506,Vila Romana,85,2,2,1,2450,700,3150,37.058823
5507,Santa Cecília,50,1,1,1,2500,827,3327,66.54
5508,Outro,50,2,1,1,2600,0,2600,52.0
5509,Outro,48,2,1,1,1760,440,2200,45.833332
5510,Bela Vista,40,1,1,1,2800,0,2800,70.0
5511,Vila Olímpia,93,2,3,2,10000,1100,11100,119.354836
5512,Brás,48,2,1,1,1200,460,1660,34.583332
5513,Santo Amaro,65,2,1,1,3200,0,3200,49.23077
5514,Vila Mariana,68,2,2,1,4000,565,4565,67.132355
5515,Pompeia,65,2,3,1,2250,840,3090,47.53846
5516,Outro,44,2,1,0,1000,200,1200,27.272728
5517,Vila Nova Conceição,96,3,3,1,6000,1320,7320,76.25
5518,Butantã,88,3,2,2,2280,750,3030,34.43182
5519,Vila Clementino,81,3,1,1,2500,1450,3950,48.76543
5520,Outro,76,2,2,1,2700,640,3340,43.94737
5521,Vila Clementino,60,2,2,1,1500,1046,2546,42.433334
5522,Itaim Bibi,57,1,1,1,3000,980,3980,69.82456
5523,Pinheiros,78,2,2,1,3100,1233,4333,55.55128
5524,Moema,93,2,2,2,4500,1083,5583,60.032257
5525,Santa Cecília,129,3,3,0,3100,644,3744,29.023256
5526,Outro,100,3,2,1,1500,786,2286,22.86
5527,Santa Ifigênia,44,1,1,1,2600,624,3224,73.27273
5528,Jardim Marajoara,63,3,2,1,1400,680,2080,33.015873
5529,Vila Olímpia,72,3,2,1,4200,1000,5200,72.22222
5530,Jardins,91,1,1,1,3970,3320,7290,80.10989
5531,Moema,170,4,6,3,12800,1999,14799,87.05294
5532,Pompeia,72,2,3,2,2799,844,3643,50.59722
5533,Vila Nova Conceição,311,4,4,4,20000,4100,24100,77.49196
5534,Tatuapé,45,1,1,1,2100,517,2617,58.155556
5535,Cerqueira César,73,2,2,1,5950,815,6765,92.671234
5536,Outro,60,2,1,1,1500,700,2200,36.666668
5537,Vila Olímpia,61,2,1,1,3900,119,4019,65.88525
5538,Itaim Bibi,275,4,1,5,28000,4756,32756,119.112724
5539,Outro,45,2,1,1,1100,500,1600,35.555557
5540,Outro,117,2,2,0,1700,300,2000,17.094017
5541,Outro,78,3,2,1,2600,925,3525,45.192307
5542,Higienópolis,41,1,1,1,2500,732,3232,78.82927
5543,Perdizes,127,3,2,2,3700,1522,5222,41.11811
5544,Outro,65,2,2,1,1900,960,2860,44.0
5545,República,35,1,1,0,1500,294,1794,51.25714
5546,Outro,50,2,1,1,1400,360,1760,35.2
5547,Pinheiros,50,1,1,1,2200,840,3040,60.8
5548,Consolação,46,1,1,1,3000,550,3550,77.17391
5549,Vila Buarque,29,1,1,0,1100,360,1460,50.344826
5550,Pinheiros,62,2,2,1,4000,830,4830,77.90323
5551,Vila Mariana,36,1,1,1,2650,0,2650,73.611115
5552,Itaim Bibi,71,1,2,1,7750,1200,8950,126.056335
5553,Jardim Paulista,197,4,5,3,7900,2895,10795,54.796955
5554,Moema,84,2,2,2,1600,1880,3480,41.42857
5555,Perdizes,43,2,1,1,1800,871,2671,62.11628
5556,Outro,55,2,1,1,1100,508,1608,29.236364
5557,Outro,42,2,1,0,900,260,1160,27.619047
5558,Outro,44,2,1,0,1000,0,1000,22.727272
5559,Vila Nova Conceição,50,1,1,1,2000,680,2680,53.6
5560,Moema,70,2,2,1,4000,750,4750,67.85714
5561,Móoca,25,1,1,0,900,60,960,38.4
5562,Moema,125,3,4,2,8500,1250,9750,78.0
5563,Outro,50,2,1,1,1150,480,1630,32.6
5564,Outro,35,1,1,1,1900,610,2510,71.71429
5565,Alto Da Boa Vista,160,4,4,2,3950,1530,5480,34.25
5566,Paraíso,90,3,1,1,3500,1218,4718,52.422222
5567,Liberdade,25,1,1,0,2000,380,2380,95.2
5568,Vila Olímpia,44,1,1,2,3800,850,4650,105.681816
5569,Vila Mariana,89,2,2,1,2000,890,2890,32.47191
5570,Vila Mascote,65,2,2,1,3000,850,3850,59.23077
5571,Pinheiros,52,2,2,1,4200,820,5020,96.53846
5572,Perdizes,126,3,3,2,3200,1606,4806,38.142857
5573,Sumaré,65,2,1,1,2200,740,2940,45.23077
5574,Pompeia,75,2,1,1,1800,672,2472,32.96
5575,Perdizes,81,2,2,1,2300,590,2890,35.679012
5576,Morumbi,94,3,2,1,3020,1200,4220,44.893616
5577,Moema,51,2,2,1,2500,520,3020,59.215687
5578,Aclimação,41,1,1,1,2500,700,3200,78.04878
5579,Paraíso,68,2,2,1,1600,1422,3022,44.441177
5580,Outro,60,3,1,1,1400,600,2000,33.333332
5581,Liberdade,61,2,1,1,1100,900,2000,32.786884
5582,Brooklin,113,3,4,2,6000,905,6905,61.106194
5583,Moema,55,1,1,1,2793,571,3364,61.163635
5584,Butantã,57,3,1,1,1600,536,2136,37.473682
5585,Jardim Paulista,100,3,1,1,3500,994,4494,44.94
5586,Cerqueira César,55,1,1,2,4800,850,5650,102.72727
5587,Tatuapé,56,2,2,1,1750,700,2450,43.75
5588,Campo Belo,72,2,2,2,3900,881,4781,66.40278
5589,Vila Olímpia,81,2,2,1,4500,1250,5750,70.987656
5590,Brooklin,70,2,2,1,2000,680,2680,38.285713
5591,Perdizes,64,2,2,1,2790,860,3650,57.03125
5592,Tatuapé,65,2,1,2,2200,576,2776,42.70769
5593,Perdizes,250,4,4,4,7350,3357,10707,42.828
5594,Outro,100,2,2,1,1300,450,1750,17.5
5595,Campo Belo,276,2,5,3,7000,3117,10117,36.655796
5596,Vila Sônia,65,2,1,1,1600,850,2450,37.692307
5597,Outro,98,2,3,2,2300,1200,3500,35.714287
5598,Chácara Santo Antônio,50,2,1,1,2800,510,3310,66.2
5599,Outro,47,2,1,1,1400,435,1835,39.042553
5600,Outro,35,1,1,1,2600,500,3100,88.57143
5601,Outro,50,2,1,1,1200,470,1670,33.4
5602,Vila Guarani,78,2,3,1,2000,780,2780,35.641026
5603,Outro,60,2,2,1,2100,550,2650,44.166668
5604,Outro,61,3,2,1,1400,350,1750,28.688524
5605,Vila Andrade,95,3,3,2,4100,805,4905,51.63158
5606,Ipiranga,40,1,1,1,2200,567,2767,69.175
5607,Brooklin,67,2,2,1,4300,923,5223,77.95522
5608,Tatuapé,48,2,1,1,1500,495,1995,41.5625
5609,Alto de Pinheiros,208,4,4,3,13900,2205,16105,77.42789
5610,Brooklin,51,1,1,1,2800,596,3396,66.588234
5611,Vila Olímpia,150,3,4,2,5000,1800,6800,45.333332
5612,Higienópolis,230,3,4,1,5600,1950,7550,32.826088
5613,Outro,48,1,1,1,1000,632,1632,34.0
5614,Consolação,30,1,1,1,1750,680,2430,81.0
5615,Pinheiros,71,2,2,2,4200,864,5064,71.323944
5616,Jardim Paulista,75,2,2,1,3000,1200,4200,56.0
5617,Chácara Santo Antônio,93,3,3,0,3600,972,4572,49.16129
5618,Vila Olímpia,65,2,2,1,5000,880,5880,90.46154
5619,Vila Nova Conceição,57,1,1,0,5000,950,5950,104.38596
5620,Campo Belo,145,3,5,4,8499,1400,9899,68.26897
5621,Pinheiros,101,3,1,2,5500,1014,6514,64.49505
5622,Jardim Paulista,85,2,2,1,6000,2436,8436,99.247055
5623,Itaim Bibi,60,1,1,1,2100,1100,3200,53.333332
5624,Vila Mariana,42,1,1,1,1800,690,2490,59.285713
5625,Vila Clementino,84,3,3,2,3490,1150,4640,55.238094
5626,Outro,55,2,2,1,1700,600,2300,41.81818
5627,Vila Olímpia,80,2,1,1,2900,750,3650,45.625
5628,Jaguaré,64,2,2,1,1200,448,1648,25.75
5629,Brooklin,38,1,1,1,3200,525,3725,98.02631
5630,Vila Olímpia,53,2,1,1,2500,890,3390,63.962265
5631,Moema,204,4,5,3,16500,2866,19366,94.93137
5632,Vila Mascote,133,3,5,3,5900,1350,7250,54.51128
5633,Santa Cecília,36,1,1,1,1500,706,2206,61.27778
5634,Bela Vista,108,3,2,1,3500,1037,4537,42.00926
5635,Santana,60,2,1,1,1750,750,2500,41.666668
5636,Jardim Paulista,52,1,1,1,3800,540,4340,83.46154
5637,Barra Funda,95,2,1,0,1800,100,1900,20.0
5638,Outro,50,2,1,1,1300,0,1300,26.0
5639,Outro,65,2,2,1,3500,800,4300,66.15385
5640,Brooklin,34,1,1,1,2800,350,3150,92.64706
5641,Liberdade,28,1,1,0,1700,272,1972,70.42857
5642,Pirituba,54,2,1,1,1600,550,2150,39.814816
5643,Moema,110,3,2,2,3995,1055,5050,45.909092
5644,Vila Anastácio,96,3,1,2,4200,922,5122,53.354168
5645,Sumaré,215,3,5,4,10800,3567,14367,66.82326
5646,Pinheiros,148,4,2,2,4500,1570,6070,41.01351
5647,Itaim Bibi,462,4,6,6,65000,10000,75000,162.33766
5648,Vila Cruzeiro,55,1,1,1,1500,507,2007,36.49091
5649,Outro,51,2,1,1,1200,450,1650,32.35294
5650,Jardim América,75,1,2,2,10000,1270,11270,150.26666
5651,Jardim Europa,405,3,5,5,75000,6500,81500,201.23457
5652,Itaim Bibi,60,1,1,1,1900,757,2657,44.283333
5653,Vila Prudente,65,3,2,1,1800,460,2260,34.76923
5654,Vila Nova Conceição,128,3,3,1,7000,1220,8220,64.21875
5655,Outro,215,3,4,2,3500,4100,7600,35.34884
5656,Moema,140,3,5,2,5500,1650,7150,51.07143
5657,Móoca,50,2,1,0,1100,309,1409,28.18
5658,Pinheiros,111,2,4,2,9900,1600,11500,103.60361
5659,Chácara Santo Antônio,38,1,1,1,2000,380,2380,62.63158
5660,Vila Mariana,50,1,1,1,1800,582,2382,47.64
5661,Outro,310,4,6,4,22000,4345,26345,84.98387
5662,Outro,62,1,2,1,3950,750,4700,75.80645
5663,Itaim Bibi,38,1,1,1,2400,497,2897,76.23684
5664,Moema,38,1,1,1,2300,1000,3300,86.8421
5665,Outro,60,2,1,1,1000,310,1310,21.833334
5666,Outro,45,2,1,1,1650,353,2003,44.511112
5667,Santana,35,1,1,1,1350,1300,2650,75.71429
5668,Jardim Paulista,45,1,1,1,3000,950,3950,87.77778
5669,Vila Gomes Cardim,137,3,4,3,3200,1394,4594,33.53285
5670,Brooklin,24,1,1,1,2450,1,2451,102.125
5671,Brooklin,113,3,4,2,5200,1428,6628,58.65487
5672,Pinheiros,72,2,2,1,6300,1100,7400,102.77778
5673,Vila Leopoldina,172,3,4,3,6200,1700,7900,45.930233
5674,Alto da Lapa,230,4,6,3,10500,3500,14000,60.869564
5675,Outro,50,2,1,1,1450,350,1800,36.0
5676,Moema,45,1,1,1,2500,778,3278,72.844444
5677,Higienópolis,68,1,2,0,3200,1331,4531,66.632355
5678,Outro,88,1,2,2,8500,2274,10774,122.431816
5679,Higienópolis,33,1,1,1,1500,348,1848,56.0
5680,Perdizes,40,1,1,1,1800,595,2395,59.875
5681,Jabaquara,60,2,1,0,1800,0,1800,30.0
5682,Outro,126,3,3,3,2000,1980,3980,31.587301
5683,Outro,70,2,2,1,1300,482,1782,25.457144
5684,Chácara Santo Antônio,104,3,3,3,4400,765,5165,49.66346
5685,Campo Belo,93,3,3,2,3850,1778,5628,60.51613
5686,Bela Vista,45,1,1,1,1600,660,2260,50.22222
5687,Perdizes,57,2,2,2,2750,850,3600,63.157894
5688,Brooklin,35,1,1,1,2900,600,3500,100.0
5689,Mirandópolis,41,1,1,1,1900,511,2411,58.80488
5690,Vila Mascote,65,2,2,1,1850,1100,2950,45.384617
5691,Moema,80,2,2,1,5000,0,5000,62.5
5692,Jardim Paulista,42,1,1,1,4500,0,4500,107.14286
5693,Outro,49,2,1,1,1160,477,1637,33.408165
5694,Indianópolis,43,1,1,0,1800,730,2530,58.837208
5695,Brooklin,66,2,2,1,2000,750,2750,41.666668
5696,Perdizes,130,3,4,3,5300,1390,6690,51.46154
5697,Outro,62,2,1,1,1800,518,2318,37.387096
5698,Vila Mariana,36,1,1,1,2800,780,3580,99.44444
5699,Pinheiros,45,1,2,1,2700,780,3480,77.333336
5700,Perdizes,75,2,1,1,2300,900,3200,42.666668
5701,Pinheiros,71,2,2,1,5000,800,5800,81.69014
5702,Brooklin,290,4,3,3,15500,1900,17400,60.0
5703,Casa Verde,55,2,1,3,1200,90,1290,23.454546
5704,Vila Mariana,47,1,1,1,2700,580,3280,69.78723
5705,Moema,61,2,2,1,4200,715,4915,80.57377
5706,Outro,56,2,1,1,1215,585,1800,32.142857
5707,Outro,72,3,1,1,1510,690,2200,30.555555
5708,Moema,70,2,3,2,3500,1300,4800,68.57143
5709,Cerqueira César,130,2,3,2,9800,1490,11290,86.84615
5710,Moema,31,1,1,0,2700,486,3186,102.77419
5711,Liberdade,52,2,1,1,1900,310,2210,42.5
5712,Outro,49,2,1,1,1650,0,1650,33.67347
5713,Bela Vista,60,2,1,1,2600,792,3392,56.533333
5714,Mirandópolis,82,2,2,1,1800,773,2573,31.378048
5715,Vila Mariana,84,2,2,1,2000,920,2920,34.761906
5716,Outro,100,3,2,2,2500,1077,3577,35.77
5717,Jardim Anália Franco,148,4,5,3,4000,1700,5700,38.51351
5718,Tatuapé,35,1,1,1,1900,411,2311,66.02857
5719,Santana,70,2,2,0,1350,470,1820,26.0
5720,Campo Belo,50,1,2,1,4315,430,4745,94.9
5721,Vila Buarque,30,1,1,0,1090,408,1498,49.933334
5722,Moema,75,2,3,2,4100,1250,5350,71.333336
5723,Jardim Anália Franco,55,1,1,1,3200,470,3670,66.72727
5724,Higienópolis,180,2,4,2,12000,1868,13868,77.04444
5725,Santa Cecília,59,1,1,0,1400,560,1960,33.22034
5726,Vila Uberabinha,80,2,3,2,4600,890,5490,68.625
5727,Outro,125,3,4,3,3100,1430,4530,36.24
5728,Outro,165,3,4,3,5500,2500,8000,48.484848
5729,Outro,76,2,1,0,2000,467,2467,32.460526
5730,Vila Mariana,145,3,3,3,5000,1063,6063,41.813793
5731,Outro,70,3,2,1,1800,580,2380,34.0
5732,Vila Gomes Cardim,130,3,4,2,3900,1350,5250,40.384617
5733,Paraíso,66,2,2,1,3500,880,4380,66.36364
5734,Centro,44,1,1,1,2300,700,3000,68.181816
5735,Moema,74,2,3,1,5500,865,6365,86.01351
5736,Vila Nova Conceição,153,2,3,3,22000,0,22000,143.79085
5737,Bela Vista,62,1,1,0,2500,413,2913,46.98387
5738,Outro,31,1,1,0,1200,0,1200,38.70968
5739,Outro,51,1,1,1,3200,620,3820,74.90196
5740,Vila Mariana,51,2,1,0,3000,580,3580,70.196075
5741,Vila Sônia,52,2,1,1,2300,310,2610,50.192307
5742,Moema,80,2,3,1,3800,1030,4830,60.375
5743,Vila Madalena,55,1,1,2,4300,1408,5708,103.781815
5744,Campo Belo,50,1,2,1,2650,600,3250,65.0
5745,Brooklin,51,1,1,1,3700,600,4300,84.31373
5746,Barra Funda,94,3,3,2,3200,750,3950,42.02128
5747,Vila Uberabinha,60,2,1,1,3100,907,4007,66.78333
5748,Vila Mariana,21,1,1,0,2000,350,2350,111.90476
5749,Bela Vista,74,2,1,1,2500,773,3273,44.22973
5750,Perdizes,130,3,2,3,5000,2200,7200,55.384617
5751,Vila Leopoldina,35,2,1,0,2250,350,2600,74.28571
5752,Moema,172,4,5,2,5500,2035,7535,43.80814
5753,Tatuapé,65,3,1,1,2400,610,3010,46.307693
5754,Outro,60,2,1,1,2000,597,2597,43.283333
5755,Perdizes,80,2,3,2,5000,1350,6350,79.375
5756,Vila Nova Conceição,36,1,1,1,2800,1000,3800,105.55556
5757,Vila Leopoldina,104,3,4,2,6000,885,6885,66.20192
5758,Cambuci,68,2,1,1,3600,800,4400,64.70588
5759,Indianópolis,65,2,2,1,2000,880,2880,44.307693
5760,Vila Olímpia,100,3,3,2,2500,1350,3850,38.5
5761,Outro,71,3,2,2,2500,618,3118,43.915493
5762,Consolação,42,1,1,1,1480,492,1972,46.95238
5763,Brooklin,240,4,5,4,15000,3443,18443,76.84583
5764,Perdizes,78,2,2,1,3000,1100,4100,52.564102
5765,Vila Mariana,34,1,1,1,1200,554,1754,51.588234
5766,Itaim Bibi,107,3,2,2,4300,2700,7000,65.42056
5767,República,35,1,1,0,1300,555,1855,53.0
5768,Outro,52,2,1,1,1000,375,1375,26.442308
5769,Outro,34,1,1,0,1800,0,1800,52.941177
5770,Saúde,43,1,2,1,1700,476,2176,50.604652
5771,Vila Andrade,61,3,1,1,1700,660,2360,38.688526
5772,Vila Leopoldina,121,3,3,2,5700,880,6580,54.380165
5773,Vila Leopoldina,187,3,4,3,9500,1800,11300,60.427807
5774,Paraíso,36,1,1,1,1690,1280,2970,82.5
5775,Perdizes,160,4,4,2,5400,1586,6986,43.6625
5776,Perdizes,60,2,2,1,3500,1101,4601,76.683334
5777,Brooklin,88,2,2,2,5900,1300,7200,81.818184
5778,Vila Mariana,50,1,1,1,2800,856,3656,73.12
5779,Outro,328,3,6,5,19000,7000,26000,79.268295
5780,Cerqueira César,60,1,1,2,3000,833,3833,63.883335
5781,Cerqueira César,170,3,5,3,7000,2175,9175,53.97059
5782,Vila Nova Conceição,95,2,2,1,5000,0,5000,52.63158
5783,Vila Nova Conceição,41,1,1,1,6000,900,6900,168.29268
5784,Vila Leopoldina,70,2,1,1,2700,710,3410,48.714287
5785,Jardim América,127,2,3,1,5800,1640,7440,58.582676
5786,Outro,45,2,1,1,1650,303,1953,43.4
5787,Jardim Paulista,100,3,3,2,3500,1154,4654,46.54
5788,Vila Nova Conceição,141,2,3,2,20000,2500,22500,159.57446
5789,Alto Da Boa Vista,87,2,2,1,2000,621,2621,30.126436
5790,Outro,80,3,2,1,2000,500,2500,31.25
5791,Alto de Pinheiros,57,2,1,2,2300,655,2955,51.842106
5792,Jardim Europa,277,3,2,3,22000,3000,25000,90.25271
5793,Centro,49,1,2,1,2950,790,3740,76.32653
5794,Jardim América,150,3,5,4,15000,0,15000,100.0
5795,Campos Eliseos,110,3,1,0,2200,600,2800,25.454546
5796,Jardim Prudência,72,2,2,1,3500,680,4180,58.055557
5797,Outro,28,1,1,1,1800,568,2368,84.57143
5798,Perdizes,73,2,1,1,3500,832,4332,59.342464
5799,Vila Mariana,46,1,1,0,2000,230,2230,48.47826
5800,Pinheiros,30,1,1,0,3200,0,3200,106.666664
5801,Outro,56,2,1,1,1880,0,1880,33.57143
5802,Móoca,279,3,3,2,6200,1180,7380,26.451612
5803,Outro,47,2,1,1,1140,360,1500,31.914894
5804,Vila Nova Conceição,95,2,2,1,5000,1190,6190,65.1579
5805,Consolação,53,2,2,1,3000,560,3560,67.169815
5806,Perdizes,70,2,1,1,1600,1000,2600,37.142857
5807,Brooklin,70,2,2,1,2100,1020,3120,44.57143
5808,Casa Verde,49,2,1,0,2200,300,2500,51.02041
5809,Vila Andrade,48,1,2,1,2650,700,3350,69.791664
5810,Vila Leopoldina,50,2,2,1,2000,600,2600,52.0
5811,Moema,70,2,2,1,4800,750,5550,79.28571
5812,Panamby,607,4,6,6,45000,7894,52894,87.14003
5813,Brooklin,116,3,3,2,6200,1350,7550,65.086205
5814,Vila Nova Conceição,163,2,2,3,23990,2787,26777,164.27608
5815,Bela Vista,48,2,2,1,2500,520,3020,62.916668
5816,Vila Olímpia,125,2,3,2,14500,1100,15600,124.8
5817,Móoca,70,2,2,2,2500,850,3350,47.857143
5818,Butantã,60,2,1,1,2100,388,2488,41.466667
5819,Jardim Paulista,100,2,3,1,4500,1150,5650,56.5
5820,Moema,37,1,1,1,2100,980,3080,83.24324
5821,Moema,76,2,2,1,2900,810,3710,48.81579
5822,Jardim Paulista,168,4,4,2,12000,2020,14020,83.45238
5823,Santa Cecília,90,3,2,1,2600,750,3350,37.22222
5824,Outro,95,3,2,3,2900,950,3850,40.526318
5825,Vila Mariana,222,4,6,4,20000,2369,22369,100.76126
5826,Aclimação,35,1,1,1,2100,455,2555,73.0
5827,Casa Verde,100,3,1,0,1700,220,1920,19.2
5828,Jardim Paulista,130,2,4,2,8000,1680,9680,74.46154
5829,Ipiranga,63,2,2,1,2500,535,3035,48.174603
5830,Campo Belo,49,2,1,1,2500,700,3200,65.30612
5831,Brooklin,29,1,1,0,2500,489,2989,103.06896
5832,Outro,50,2,1,1,1620,580,2200,44.0
5833,Santa Cecília,60,2,1,1,2000,828,2828,47.133335
5834,Água Branca,35,1,1,0,1505,439,1944,55.54286
5835,Perdizes,240,4,5,3,14000,2800,16800,70.0
5836,Pompeia,74,2,1,2,3400,800,4200,56.756756
5837,Chácara Santo Antônio,104,3,3,2,3900,980,4880,46.923077
5838,Moema,54,2,3,1,3800,718,4518,83.666664
5839,Vila Madalena,72,1,2,1,3850,700,4550,63.194443
5840,Saúde,33,1,1,1,1150,425,1575,47.727272
5841,Campos Eliseos,48,1,1,1,1800,0,1800,37.5
5842,Casa Verde,55,2,1,1,1200,480,1680,30.545454
5843,Bela Vista,58,2,1,1,2400,633,3033,52.293102
5844,Moema,70,1,1,1,3900,1474,5374,76.77143
5845,Paraíso,55,2,1,1,3500,700,4200,76.36364
5846,Vila Nova Conceição,48,1,1,1,4837,1193,6030,125.625
5847,Vila Andrade,40,1,1,0,1300,639,1939,48.475
5848,Jardim Paulista,90,2,2,1,2600,1050,3650,40.555557
5849,Itaim Bibi,90,2,2,1,4100,765,4865,54.055557
5850,Perdizes,25,1,1,1,2300,330,2630,105.2
5851,Centro,40,1,1,1,1800,397,2197,54.925
5852,Vila Olímpia,63,1,2,1,6000,1350,7350,116.666664
5853,Jardim Paulista,118,3,3,2,5000,1280,6280,53.22034
5854,Liberdade,28,1,1,0,1900,270,2170,77.5
5855,Jardim Marajoara,69,3,2,2,1850,705,2555,37.028984
5856,Barra Funda,62,2,2,1,3000,355,3355,54.112904
5857,Vila Olímpia,65,2,1,1,3500,875,4375,67.30769
5858,Vila Nova Conceição,50,1,1,1,6197,1370,7567,151.34
5859,Vila Mariana,59,2,1,1,2000,802,2802,47.491524
5860,Outro,50,1,1,1,2550,590,3140,62.8
5861,Moema,66,2,2,1,2100,936,3036,46.0
5862,Jardim América,90,2,2,1,3200,1032,4232,47.02222
5863,Outro,74,2,2,1,1800,939,2739,37.01351
5864,Saúde,49,2,1,1,1300,673,1973,40.265305
5865,Barra Funda,85,2,2,1,1780,565,2345,27.588236
5866,Vila Leopoldina,57,2,2,1,2150,1080,3230,56.666668
5867,Cerqueira César,40,1,1,0,1800,704,2504,62.6
5868,Moema,170,3,4,3,14000,2314,16314,95.96471
5869,Outro,75,3,1,1,1800,380,2180,29.066668
5870,Outro,86,2,5,2,4300,820,5120,59.534885
5871,Aclimação,39,1,1,1,2260,530,2790,71.53846
5872,Outro,55,2,1,1,1200,450,1650,30.0
5873,Pinheiros,50,1,1,1,3500,750,4250,85.0
5874,Outro,146,3,3,3,2800,1600,4400,30.136986
5875,Outro,80,2,2,2,3500,1180,4680,58.5
5876,Vila Andrade,238,4,6,4,9000,1535,10535,44.264706
5877,Perdizes,55,1,2,1,1700,350,2050,37.272728
5878,Santana,90,2,1,1,1300,730,2030,22.555555
5879,Saúde,52,2,2,1,1500,720,2220,42.692307
5880,Bela Vista,32,1,1,1,1200,1000,2200,68.75
5881,Granja Julieta,105,2,3,2,5000,750,5750,54.761906
5882,Vila Olímpia,68,2,1,1,3000,594,3594,52.85294
5883,Cerqueira César,35,1,1,1,5435,480,5915,169.0
5884,Outro,58,2,1,1,1281,548,1829,31.534483
5885,Lapa,60,2,2,2,2200,765,2965,49.416668
5886,Pinheiros,50,1,1,0,1650,685,2335,46.7
5887,Outro,48,1,1,1,3200,600,3800,79.166664
5888,Bela Vista,45,1,1,1,3400,544,3944,87.64445
5889,Outro,170,3,5,3,10500,1650,12150,71.47059
5890,Vila Mariana,65,2,2,1,2500,850,3350,51.53846
5891,Itaim Bibi,98,2,3,1,5450,1346,6796,69.34694
5892,Barra Funda,132,2,1,2,5000,1339,6339,48.022728
5893,Pinheiros,48,1,1,2,3300,740,4040,84.166664
5894,Bela Vista,126,3,3,1,3000,1214,4214,33.444443
5895,Outro,42,1,1,1,1380,620,2000,47.61905
5896,Campo Belo,38,1,1,1,2800,505,3305,86.97369
5897,Outro,100,2,3,2,3700,1100,4800,48.0
5898,Tatuapé,130,2,4,2,5700,800,6500,50.0
5899,Outro,100,3,2,2,2700,700,3400,34.0
5900,Santa Cecília,34,1,1,1,1400,500,1900,55.882355
5901,Paraíso,110,3,3,1,3400,925,4325,39.31818
5902,Moema,97,3,3,2,3650,1051,4701,48.463917
5903,Vila Buarque,90,2,2,1,3500,885,4385,48.72222
5904,Santa Cecília,38,1,1,1,1650,524,2174,57.210526
5905,Perdizes,218,3,5,4,8500,2660,11160,51.19266
5906,Chácara Santo Antônio,96,2,2,0,4400,509,4909,51.135418
5907,Bela Vista,40,1,1,0,1200,552,1752,43.8
5908,Ipiranga,58,2,1,1,2000,700,2700,46.551723
5909,Moema,52,2,2,1,2300,581,2881,55.403847
5910,Vila Nova Conceição,95,2,2,1,5000,1190,6190,65.1579
5911,Jardim Paulista,337,3,5,2,19000,3780,22780,67.596436
5912,Santana,100,3,3,2,2500,1300,3800,38.0
5913,Vila Mariana,34,1,1,1,1300,877,2177,64.02941
5914,Jardim Marajoara,118,4,3,2,2800,1326,4126,34.966103
5915,Campo Belo,90,2,2,1,1500,1500,3000,33.333332
5916,Vila Nova Conceição,226,4,3,4,22000,2959,24959,110.43805
5917,Outro,67,2,1,0,1700,0,1700,25.373135
5918,Itaim Bibi,140,3,2,1,5000,945,5945,42.464287
5919,Higienópolis,50,2,2,1,2500,481,2981,59.62
5920,Moema,15,1,1,1,1590,295,1885,125.666664
5921,Pinheiros,35,1,1,1,3150,500,3650,104.28571
5922,Campo Belo,50,1,1,0,3300,587,3887,77.74
5923,Outro,165,3,4,2,6500,2700,9200,55.757576
5924,Jardim Europa,158,3,2,1,10500,2000,12500,79.11392
5925,Vila Madalena,40,1,1,1,2600,695,3295,82.375
5926,Jardins,46,1,1,1,1900,550,2450,53.260868
5927,Jardim Paulista,42,1,1,1,1230,1150,2380,56.666668
5928,Brooklin,225,3,5,4,9000,3900,12900,57.333332
5929,Ipiranga,86,2,2,2,2600,975,3575,41.569767
5930,Santa Cecília,50,1,1,0,2000,190,2190,43.8
5931,Chácara Santo Antônio,106,2,4,2,5000,1110,6110,57.64151
5932,Morumbi,78,2,1,1,1640,787,2427,31.115385
5933,Vila Olímpia,81,1,3,0,8000,1150,9150,112.96296
5934,Vila Olímpia,82,2,2,2,6300,1200,7500,91.46342
5935,Vila Mariana,80,3,2,1,2800,990,3790,47.375
5936,Tatuapé,90,2,2,1,1100,600,1700,18.88889
5937,Pompeia,70,2,2,1,1700,858,2558,36.54286
5938,Vila Guarani,75,3,2,2,3500,599,4099,54.65333
5939,Vila Mariana,97,3,2,2,2600,1001,3601,37.12371
5940,Aclimação,37,1,1,1,2160,530,2690,72.702705
5941,Perdizes,50,1,1,1,2000,575,2575,51.5
5942,Outro,66,3,2,1,1600,524,2124,32.18182
5943,Vila Olímpia,93,2,4,2,9000,1120,10120,108.81721
5944,Liberdade,40,1,1,0,1000,548,1548,38.7
5945,Bela Vista,57,1,1,0,1350,500,1850,32.45614
5946,Alto de Pinheiros,55,2,1,1,1900,640,2540,46.18182
5947,Santo Amaro,65,3,2,0,2100,920,3020,46.46154
5948,República,26,1,1,0,810,232,1042,40.076923
5949,Vila Nova Conceição,79,2,1,1,4000,834,4834,61.189873
5950,Outro,70,2,2,1,2400,800,3200,45.714287
5951,Jardim Marajoara,280,4,6,4,7500,2263,9763,34.86786
5952,República,391,2,4,2,15000,3000,18000,46.035805
5953,Jardim Paulista,45,1,1,1,3900,760,4660,103.55556
5954,Outro,51,1,1,1,1300,605,1905,37.35294
5955,Perdizes,98,3,3,1,3400,899,4299,43.867348
5956,Itaim Bibi,65,1,2,1,4000,1090,5090,78.30769
5957,Vila Carrão,70,3,2,2,3000,680,3680,52.57143
5958,Aclimação,37,1,1,1,2160,530,2690,72.702705
5959,Vila Carrão,56,2,1,1,2500,0,2500,44.642857
5960,Brooklin,95,3,3,2,3200,1300,4500,47.36842
5961,Outro,46,2,1,1,1500,400,1900,41.304348
5962,Brooklin,98,3,3,3,4500,1000,5500,56.122448
5963,Pinheiros,80,3,3,2,3500,1136,4636,57.95
5964,Consolação,50,1,1,0,2000,381,2381,47.62
5965,Outro,143,3,5,3,2400,2200,4600,32.16783
5966,Paraíso,185,4,5,4,12000,1800,13800,74.5946
5967,Vila Mascote,60,2,2,1,1300,580,1880,31.333334
5968,Higienópolis,60,2,2,2,4000,680,4680,78.0
5969,Outro,103,2,3,2,6000,780,6780,65.82524
5970,Outro,48,2,1,1,1700,0,1700,35.416668
5971,Outro,40,2,1,1,1270,120,1390,34.75
5972,Vila Olímpia,75,2,2,1,2200,1106,3306,44.08
5973,Bela Vista,37,1,1,0,900,290,1190,32.162163
5974,Outro,62,3,2,2,2200,470,2670,43.064518
5975,Jardim Paulista,75,2,2,1,3000,811,3811,50.81333
5976,Cambuci,40,2,1,0,1300,300,1600,40.0
5977,Tatuapé,50,2,1,1,2200,290,2490,49.8
5978,Granja Julieta,82,3,1,1,3500,752,4252,51.853657
5979,Perdizes,142,3,3,2,3950,1580,5530,38.94366
5980,Saúde,42,2,1,1,1990,0,1990,47.38095
5981,Vila Olímpia,40,1,1,1,3404,903,4307,107.675
5982,Brooklin,30,1,1,1,2420,502,2922,97.4
5983,Vila Guarani,55,2,1,1,1550,558,2108,38.327274
5984,Ipiranga,69,2,1,2,2690,605,3295,47.753624
5985,Vila Mariana,75,2,3,1,2400,980,3380,45.066666
5986,Pinheiros,100,3,4,2,3300,1639,4939,49.39
5987,Santa Ifigênia,44,1,1,1,2550,624,3174,72.13636
5988,Jardins,40,1,1,1,2500,800,3300,82.5
5989,Água Branca,115,3,1,0,2300,0,2300,20.0
5990,Mirandópolis,34,1,1,1,1450,481,1931,56.794117
5991,Liberdade,85,2,2,1,1500,1246,2746,32.30588
5992,Outro,54,2,1,1,1600,480,2080,38.51852
5993,Santa Cecília,76,2,2,1,3300,850,4150,54.605263
5994,Outro,110,3,4,3,7500,1720,9220,83.818184
5995,Vila Nova Conceição,43,1,1,1,2500,800,3300,76.74419
5996,Jabaquara,67,3,2,1,1800,744,2544,37.97015
5997,Outro,52,2,1,1,1400,529,1929,37.096153
5998,Jardim Paulista,176,3,3,1,5000,1630,6630,37.670456
5999,Vila Santa Catarina,73,2,2,2,3700,555,4255,58.28767
6000,Itaim Bibi,39,1,1,1,4234,583,4817,123.51282
6001,Consolação,66,2,2,1,6500,550,7050,106.818184
6002,Ipiranga,34,1,1,1,2200,400,2600,76.47059
6003,Vila Mariana,49,2,2,0,2000,100,2100,42.857143
6004,Brooklin,120,3,3,1,4000,1200,5200,43.333332
6005,Paraíso,83,3,3,2,3590,1200,4790,57.710842
6006,Vila Sônia,40,2,1,0,1280,206,1486,37.15
6007,Pompeia,41,1,1,1,2300,590,2890,70.48781
6008,Tatuapé,63,2,2,2,2600,592,3192,50.666668
6009,Outro,58,2,1,1,2000,707,2707,46.672413
6010,Vila Mariana,41,1,1,0,3500,981,4481,109.29269
6011,Outro,66,2,2,1,1900,1000,2900,43.939392
6012,Outro,40,1,1,1,1100,400,1500,37.5
6013,Santana,63,2,2,2,1850,800,2650,42.06349
6014,Outro,40,2,1,1,2300,400,2700,67.5
6015,Jardim América,180,3,3,1,12300,1580,13880,77.111115
6016,Bela Vista,105,2,2,1,3000,850,3850,36.666668
6017,Vila Guarani,59,2,1,1,1700,800,2500,42.372883
6018,Vila Carrão,36,2,1,0,1600,0,1600,44.444443
6019,Higienópolis,100,2,2,1,3500,3419,6919,69.19
6020,Cambuci,50,1,1,1,1300,526,1826,36.52
6021,Liberdade,50,1,1,0,1100,390,1490,29.8
6022,Outro,45,2,1,1,1100,500,1600,35.555557
6023,Jardim Paulista,50,1,2,1,2655,950,3605,72.1
6024,Ipiranga,30,1,1,0,1700,0,1700,56.666668
6025,Vila Olímpia,38,1,1,1,3970,800,4770,125.52631
6026,Vila Olímpia,55,2,1,1,5500,913,6413,116.6
6027,Paraíso,120,3,2,2,5900,1100,7000,58.333332
6028,Morumbi,60,2,2,1,1500,600,2100,35.0
6029,Alto Da Boa Vista,126,2,3,2,7500,920,8420,66.82539
6030,Brás,54,2,1,1,1500,450,1950,36.11111
6031,Pinheiros,67,2,2,1,2400,781,3181,47.47761
6032,Aclimação,105,2,3,2,5500,1323,6823,64.98095
6033,Outro,47,2,1,0,700,270,970,20.638298
6034,Vila Nova Conceição,50,2,1,1,2300,930,3230,64.6
6035,Moema,102,2,4,2,6200,850,7050,69.117645
6036,Vila Nova Conceição,72,2,2,2,5400,1095,6495,90.208336
6037,Outro,60,2,1,1,1500,413,1913,31.883333
6038,Centro,28,1,1,0,1500,568,2068,73.85714
6039,Móoca,54,2,1,1,1500,630,2130,39.444443
6040,Ipiranga,126,3,2,1,2100,230,2330,18.492064
6041,Perdizes,89,3,2,1,2900,800,3700,41.573032
6042,Vila Mariana,69,2,2,1,2200,1200,3400,49.275364
6043,Consolação,50,1,1,0,1800,390,2190,43.8
6044,Sumaré,111,3,2,1,3000,720,3720,33.51351
6045,Vila Santa Catarina,70,1,1,0,1900,0,1900,27.142857
6046,Outro,626,4,5,5,18000,5800,23800,38.01917
6047,Indianópolis,97,3,4,2,5000,1153,6153,63.43299
6048,Saúde,69,3,2,1,2200,481,2681,38.855072
6049,Ipiranga,213,3,5,3,9800,2000,11800,55.39906
6050,Pinheiros,70,1,2,1,4950,758,5708,81.542854
6051,Vila Sônia,106,2,2,2,3800,1018,4818,45.45283
6052,Cambuci,90,2,1,2,2900,961,3861,42.9
6053,Outro,50,2,1,1,1200,402,1602,32.04
6054,Perdizes,80,3,3,2,2900,1200,4100,51.25
6055,Jardim Prudência,59,2,2,1,2300,609,2909,49.305084
6056,Centro,39,1,1,1,1600,608,2208,56.615383
6057,Itaim Bibi,130,3,3,2,6500,2250,8750,67.30769
6058,Moema,155,4,6,3,3500,3400,6900,44.51613
6059,Moema,50,1,1,1,2200,600,2800,56.0
6060,Santana,69,3,2,1,1800,745,2545,36.884056
6061,Itaim Bibi,140,3,4,1,12000,1890,13890,99.21429
6062,Vila Romana,62,2,2,1,2900,628,3528,56.903225
6063,Vila Romana,105,2,2,1,2500,1140,3640,34.666668
6064,Outro,55,3,1,1,1000,260,1260,22.90909
6065,Higienópolis,323,4,5,4,10000,4095,14095,43.63777
6066,Brooklin,34,1,1,1,2800,400,3200,94.117645
6067,Vila Guarani,55,2,1,1,2000,510,2510,45.636364
6068,Outro,67,2,2,1,2299,730,3029,45.208954
6069,Vila Anastácio,69,2,2,2,3200,700,3900,56.52174
6070,Moema,138,3,4,2,7500,1388,8888,64.4058
6071,Jardim Paulista,230,4,5,3,10990,3681,14671,63.786957
6072,Outro,57,2,1,1,1372,570,1942,34.070175
6073,Lapa,38,1,1,0,1000,207,1207,31.763159
6074,Outro,50,2,1,1,1100,551,1651,33.02
6075,Jabaquara,90,2,1,1,1300,0,1300,14.444445
6076,Ipiranga,64,2,2,2,2800,800,3600,56.25
6077,Jardim América,90,2,2,1,3100,1198,4298,47.755554
6078,Outro,65,2,2,1,1600,845,2445,37.615383
6079,Jardim Paulista,190,5,6,3,18000,0,18000,94.73684
6080,Vila Uberabinha,80,2,2,1,4500,1168,5668,70.85
6081,Vila Clementino,80,2,3,1,2600,817,3417,42.7125
6082,Pinheiros,87,1,2,0,2200,421,2621,30.126436
6083,Santa Cecília,257,3,3,2,6500,2526,9026,35.12062
6084,Jardim Paulista,100,2,3,1,6500,1150,7650,76.5
6085,Jaguaré,50,2,1,1,1200,583,1783,35.66
6086,Vila Leopoldina,83,2,3,2,2900,1113,4013,48.349396
6087,Outro,124,3,2,0,1900,300,2200,17.741936
6088,Tatuapé,45,1,1,1,1800,680,2480,55.11111
6089,Vila Madalena,153,4,5,3,6000,2256,8256,53.960785
6090,Itaim Bibi,97,2,2,1,3900,1090,4990,51.4433
6091,Perdizes,36,1,1,1,1800,798,2598,72.166664
6092,Chácara Santo Antônio,37,1,1,1,1850,577,2427,65.5946
6093,Cambuci,26,1,1,0,1600,150,1750,67.30769
6094,Pompeia,90,3,3,2,4000,772,4772,53.02222
6095,Vila Olímpia,70,2,2,1,2300,895,3195,45.642857
6096,Vila Nova Conceição,65,2,2,1,2600,629,3229,49.67692
6097,Bela Vista,29,1,1,1,1400,725,2125,73.27586
6098,Outro,50,2,2,2,1900,574,2474,49.48
6099,Campo Belo,42,1,1,1,2150,558,2708,64.47619
6100,Jabaquara,50,2,2,1,2500,552,3052,61.04
6101,Outro,65,2,2,1,2800,691,3491,53.70769
6102,Outro,70,3,3,2,2000,1000,3000,42.857143
6103,Outro,38,2,1,1,1200,150,1350,35.526318
6104,Higienópolis,60,2,2,1,2000,830,2830,47.166668
6105,Outro,49,1,2,1,3300,550,3850,78.57143
6106,Outro,50,2,1,1,1000,680,1680,33.6
6107,Vila Mariana,82,2,3,1,2800,751,3551,43.30488
6108,Itaim Bibi,70,2,2,1,3490,1700,5190,74.14286
6109,Vila Nova Conceição,160,2,3,3,25000,2000,27000,168.75
6110,Vila Santa Catarina,77,2,2,1,4000,550,4550,59.090908
6111,Pinheiros,43,1,1,1,3400,647,4047,94.11628
6112,Outro,56,2,1,1,2190,570,2760,49.285713
6113,Outro,68,2,1,1,1150,350,1500,22.058823
6114,Consolação,30,1,1,0,1200,344,1544,51.466667
6115,Chácara Inglesa,90,2,2,2,4900,700,5600,62.22222
6116,Móoca,110,3,3,3,3500,800,4300,39.090908
6117,Pinheiros,86,3,3,1,3300,1080,4380,50.930233
6118,Vila Mariana,56,2,2,2,2500,799,3299,58.910713
6119,Bela Vista,114,3,3,2,7485,1015,8500,74.5614
6120,Vila Olímpia,60,2,2,2,4500,1350,5850,97.5
6121,Santa Cecília,77,2,2,0,2300,716,3016,39.16883
6122,República,170,2,1,0,2600,650,3250,19.117647
6123,Vila Andrade,340,4,5,5,3900,3050,6950,20.441177
6124,Jardins,61,2,1,2,2740,1089,3829,62.770493
6125,Brooklin,39,1,1,1,3000,310,3310,84.871796
6126,Morumbi,74,3,2,2,2100,550,2650,35.81081
6127,Vila Clementino,100,2,2,2,2500,921,3421,34.21
6128,Pinheiros,48,1,1,1,2500,660,3160,65.833336
6129,Moema,46,1,1,1,3700,706,4406,95.78261
6130,Sumaré,81,2,2,1,2700,720,3420,42.22222
6131,Centro,35,1,1,1,1000,466,1466,41.885715
6132,Vila Clementino,180,3,3,1,1900,1800,3700,20.555555
6133,Higienópolis,130,2,2,1,3500,2283,5783,44.484615
6134,Outro,31,1,1,1,2900,400,3300,106.451614
6135,Brooklin,80,2,2,2,6500,758,7258,90.725
6136,Vila Olímpia,40,1,1,1,3800,0,3800,95.0
6137,Brooklin,60,2,2,1,4900,983,5883,98.05
6138,Vila Carrão,68,3,2,1,2600,0,2600,38.235294
6139,Sumaré,90,2,1,1,2400,920,3320,36.88889
6140,Pinheiros,135,3,4,2,6300,1650,7950,58.88889
6141,Casa Verde,65,2,2,1,2500,693,3193,49.123077
6142,Morumbi,55,1,1,1,2500,403,2903,52.78182
6143,Tatuapé,117,3,3,3,3100,960,4060,34.700855
6144,Casa Verde,49,1,1,1,2400,456,2856,58.285713
6145,Outro,35,1,1,0,650,0,650,18.571428
6146,Bela Vista,40,1,1,0,1300,590,1890,47.25
6147,Pinheiros,72,2,2,1,2500,880,3380,46.944443
6148,Vila Prudente,50,2,1,1,1800,436,2236,44.72
6149,Outro,70,2,2,2,2600,975,3575,51.07143
6150,Paraíso,80,2,1,1,2500,980,3480,43.5
6151,Ipiranga,80,3,2,1,3100,505,3605,45.0625
6152,Vila Nova Conceição,35,1,1,1,2900,750,3650,104.28571
6153,Consolação,42,1,1,0,2700,550,3250,77.38095
6154,Campo Belo,55,1,1,1,2200,513,2713,49.327274
6155,Outro,27,1,1,0,775,85,860,31.851852
6156,Outro,42,2,1,0,1300,0,1300,30.952381
6157,Ipiranga,83,3,2,0,1750,769,2519,30.349398
6158,Vila Mascote,58,1,1,0,1200,400,1600,27.586206
6159,Tatuapé,50,2,2,1,2000,0,2000,40.0
6160,Itaim Bibi,45,1,1,0,1500,390,1890,42.0
6161,Vila Andrade,54,2,1,2,1200,840,2040,37.77778
6162,Panamby,56,2,1,2,2000,760,2760,49.285713
6163,Itaim Bibi,65,1,1,1,5900,930,6830,105.07692
6164,Morumbi,157,3,6,3,3000,2400,5400,34.394905
6165,Aclimação,20,1,1,0,990,267,1257,62.85
6166,Moema,240,4,4,4,8500,2700,11200,46.666668
6167,Vila Mariana,110,3,3,1,1900,1200,3100,28.181818
6168,Higienópolis,104,2,2,1,3000,705,3705,35.625
6169,Panamby,320,4,6,4,16000,4200,20200,63.125
6170,Paraíso,180,3,2,3,12000,0,12000,66.666664
6171,Paraíso,72,2,2,1,2100,779,2879,39.98611
6172,Aclimação,34,1,1,1,1200,837,2037,59.911766
6173,Vila Buarque,70,2,2,2,3100,800,3900,55.714287
6174,Moema,46,1,1,1,1765,684,2449,53.239132
6175,Bela Vista,68,2,1,1,1500,684,2184,32.117645
6176,Outro,52,1,1,0,1400,290,1690,32.5
6177,Bela Vista,60,2,1,1,2100,800,2900,48.333332
6178,Outro,40,2,1,0,900,100,1000,25.0
6179,Consolação,63,2,1,1,1900,556,2456,38.984127
6180,Outro,57,2,2,2,2350,511,2861,50.19298
6181,Bela Vista,32,1,1,0,1200,325,1525,47.65625
6182,Brás,70,2,2,0,1700,200,1900,27.142857
6183,Saúde,68,2,2,1,3500,547,4047,59.514706
6184,Outro,49,2,1,1,700,187,887,18.102041
6185,Bela Vista,110,3,3,1,2900,807,3707,33.7
6186,Vila Clementino,51,2,1,1,3700,650,4350,85.29412
6187,Indianópolis,140,3,3,2,7000,1764,8764,62.6
6188,Outro,236,3,4,4,35000,5000,40000,169.49153
6189,Vila Mariana,21,1,1,0,2100,350,2450,116.666664
6190,Santana,104,3,3,2,3000,1241,4241,40.778847
6191,Outro,75,2,1,1,1900,798,2698,35.97333
6192,Moema,196,4,5,3,14000,3960,17960,91.63265
6193,Outro,60,2,2,1,1700,700,2400,40.0
6194,Tatuapé,46,2,1,0,1400,320,1720,37.391304
6195,Vila Mariana,77,3,1,2,3800,761,4561,59.233765
6196,Jardim Paulista,130,3,3,2,5000,1106,6106,46.96923
6197,Brás,72,3,2,1,2300,707,3007,41.76389
6198,Saúde,40,1,1,1,1700,425,2125,53.125
6199,Brás,72,3,2,0,2300,450,2750,38.194443
6200,Outro,178,3,4,3,3600,1890,5490,30.842697
6201,Pinheiros,54,2,1,0,2400,451,2851,52.796295
6202,Jardim Paulista,58,1,1,1,2700,762,3462,59.689655
6203,Chácara Inglesa,68,2,2,1,2500,1000,3500,51.47059
6204,Outro,43,2,1,1,1100,348,1448,33.67442
6205,Outro,110,3,4,2,4000,850,4850,44.090908
6206,Cambuci,26,1,1,0,1350,150,1500,57.692307
6207,Bela Vista,42,1,1,1,1700,462,2162,51.47619
6208,Vila Mariana,40,1,1,0,1500,497,1997,49.925
6209,Liberdade,30,1,1,0,2200,250,2450,81.666664
6210,Moema,40,1,1,1,2550,750,3300,82.5
6211,Consolação,39,1,1,1,2200,370,2570,65.89744
6212,Panamby,715,4,8,10,65000,0,65000,90.90909
6213,Vila Carrão,40,2,1,0,1300,150,1450,36.25
6214,Mirandópolis,41,1,1,1,2000,511,2511,61.243904
6215,Alto Da Boa Vista,75,2,2,2,3600,902,4502,60.02667
6216,Outro,82,3,2,1,2600,538,3138,38.26829
6217,Pinheiros,71,2,2,2,5500,1007,6507,91.64789
6218,Chácara Santo Antônio,73,2,1,1,4500,710,5210,71.369865
6219,Brooklin,96,3,2,1,4500,1350,5850,60.9375
6220,Jardim Paulista,48,1,1,1,2045,950,2995,62.395832
6221,Higienópolis,425,2,3,3,22900,4900,27800,65.411766
6222,Vila Mariana,185,3,5,3,11000,1800,12800,69.189186
6223,Cambuci,115,3,2,2,3500,1096,4596,39.965218
6224,Vila Carrão,80,3,2,1,2100,0,2100,26.25
6225,Alto Da Boa Vista,53,2,1,1,3200,400,3600,67.92453
6226,Móoca,64,2,2,1,2700,800,3500,54.6875
6227,Vila Olímpia,95,1,2,2,6500,1708,8208,86.4
6228,Outro,53,1,1,0,1600,914,2514,47.433964
6229,Outro,69,2,2,1,3500,474,3974,57.594204
6230,Vila Carrão,69,3,1,1,1500,600,2100,30.434782
6231,Vila Nova Conceição,105,2,2,1,6000,1450,7450,70.95238
6232,Vila Buarque,60,2,1,0,1800,563,2363,39.383335
6233,Vila Mariana,45,1,1,1,1900,662,2562,56.933334
6234,Ipiranga,71,3,2,1,1850,614,2464,34.704224
6235,Vila Clementino,65,2,2,1,4300,678,4978,76.58462
6236,Santa Cecília,210,3,1,3,4500,2382,6882,32.771427
6237,Paraíso,40,1,1,1,1600,875,2475,61.875
6238,Moema,55,1,1,1,1800,1400,3200,58.18182
6239,Vila Romana,90,2,2,2,3360,979,4339,48.211113
6240,Brás,75,2,1,0,1500,0,1500,20.0
6241,Outro,52,2,1,1,1450,269,1719,33.057693
6242,Morumbi,65,3,1,1,1700,485,2185,33.615383
6243,Vila Prudente,33,1,1,0,1350,75,1425,43.18182
6244,Perdizes,110,3,3,2,3600,1595,5195,47.227272
6245,Brás,50,1,1,0,690,454,1144,22.88
6246,Vila Leopoldina,88,3,3,2,3499,800,4299,48.852272
6247,Vila Nova Conceição,274,3,4,4,22000,4400,26400,96.350365
6248,Pompeia,38,1,1,1,1900,630,2530,66.57895
6249,Saúde,55,2,1,1,2300,562,2862,52.036366
6250,Consolação,61,1,2,0,2080,461,2541,41.65574
6251,Itaim Bibi,137,3,3,1,4500,1361,5861,42.78102
6252,Bela Vista,55,2,2,1,3100,844,3944,71.70909
6253,Alto de Pinheiros,300,4,4,4,6000,5000,11000,36.666668
6254,Vila Cruzeiro,66,1,2,2,3800,600,4400,66.666664
6255,Granja Julieta,95,3,3,2,4100,650,4750,50.0
6256,Itaim Bibi,80,3,2,1,3250,1030,4280,53.5
6257,Consolação,94,2,2,1,2000,1050,3050,32.446808
6258,Outro,63,3,2,1,1300,575,1875,29.761906
6259,Jardim Paulista,64,2,1,2,4000,850,4850,75.78125
6260,Jardim Europa,240,3,3,2,13000,3000,16000,66.666664
6261,Campo Belo,428,4,7,3,29500,3400,32900,76.869156
6262,Barra Funda,70,2,2,2,2500,575,3075,43.92857
6263,Bela Vista,48,1,1,0,2200,900,3100,64.583336
6264,Pinheiros,84,1,2,2,6800,1400,8200,97.61905
6265,Barra Funda,33,1,1,1,1950,393,2343,71.0
6266,Jardim Paulista,98,3,3,0,2600,1391,3991,40.72449
6267,Jardim Paulista,186,2,3,1,7700,2151,9851,52.962364
6268,Aclimação,50,1,1,1,1450,492,1942,38.84
6269,Outro,48,2,1,1,1499,0,1499,31.229166
6270,Tatuapé,27,1,1,1,1700,345,2045,75.74074
6271,Santa Cecília,31,1,1,0,1200,350,1550,50.0
6272,Vila Clementino,65,2,2,1,3500,980,4480,68.92308
6273,Outro,87,3,3,2,3100,820,3920,45.057472
6274,Higienópolis,25,1,1,0,1650,230,1880,75.2
6275,Bela Vista,47,1,1,1,1850,817,2667,56.744682
6276,Chácara Klabin,64,2,2,1,4200,1000,5200,81.25
6277,Outro,70,2,2,1,2500,848,3348,47.82857
6278,Moema,37,1,1,1,1600,1001,2601,70.297295
6279,Campo Belo,43,1,2,1,3100,352,3452,80.27907
6280,Vila Mariana,63,2,2,1,2500,770,3270,51.904762
6281,Vila Nova Conceição,50,1,1,1,3950,1375,5325,106.5
6282,Vila Mariana,94,3,2,1,3700,575,4275,45.47872
6283,Vila Olímpia,55,2,1,1,2500,748,3248,59.054546
6284,Vila Mariana,64,2,1,1,3500,750,4250,66.40625
6285,Outro,65,3,2,1,1750,450,2200,33.846153
6286,Outro,55,2,1,1,1400,320,1720,31.272728
6287,Outro,55,2,1,0,1500,100,1600,29.09091
6288,Brás,96,3,2,1,1500,800,2300,23.958334
6289,Vila Olímpia,120,3,3,2,4500,1160,5660,47.166668
6290,Pinheiros,85,1,1,1,5150,1400,6550,77.05882
6291,Bela Vista,28,1,1,0,1100,374,1474,52.642857
6292,Aclimação,50,2,2,1,2500,642,3142,62.84
6293,Santana,60,2,1,1,1350,305,1655,27.583334
6294,Itaim Bibi,100,3,2,1,2700,1300,4000,40.0
6295,Vila Mariana,70,2,2,1,2800,1270,4070,58.142857
6296,Casa Verde,80,3,2,1,1200,615,1815,22.6875
6297,Bela Vista,113,3,2,0,2800,514,3314,29.327435
6298,Vila Prudente,45,2,1,1,1350,300,1650,36.666668
6299,Pinheiros,30,1,1,1,3000,550,3550,118.333336
6300,Vila Prudente,86,3,2,1,2000,650,2650,30.813953
6301,Pinheiros,60,2,2,1,4500,830,5330,88.833336
6302,Itaim Bibi,100,1,2,2,8600,1365,9965,99.65
6303,Liberdade,82,2,2,1,1850,907,2757,33.621952
6304,Brooklin,41,1,1,1,3800,630,4430,108.04878
6305,Moema,287,5,5,4,8500,2250,10750,37.456448
6306,Lapa,50,2,1,1,1900,600,2500,50.0
6307,Jardim América,190,3,3,1,5500,3800,9300,48.94737
6308,Vila Cruzeiro,49,1,1,1,3000,0,3000,61.22449
6309,Outro,42,1,1,1,1600,535,2135,50.833332
6310,Butantã,60,2,1,1,1350,730,2080,34.666668
6311,Campos Eliseos,51,2,1,1,2500,640,3140,61.568626
6312,Vila Leopoldina,76,2,2,1,3600,700,4300,56.57895
6313,Liberdade,52,2,2,1,1500,620,2120,40.76923
6314,Vila Mariana,155,3,5,3,9000,1300,10300,66.451614
6315,Campo Belo,49,1,1,1,2850,550,3400,69.38776
6316,Freguesia do Ó,50,2,1,1,1500,410,1910,38.2
6317,Consolação,24,1,1,1,3300,300,3600,150.0
6318,Paraíso,112,2,2,1,3900,1100,5000,44.642857
6319,Vila Nova Conceição,109,1,1,2,10600,1400,12000,110.09174
6320,Vila Mariana,75,3,2,1,3800,750,4550,60.666668
6321,Saúde,65,2,1,1,1800,750,2550,39.23077
6322,Vila Mariana,42,1,1,0,2400,390,2790,66.42857
6323,Moema,44,1,1,1,3300,505,3805,86.47727
6324,Vila Leopoldina,56,2,2,1,2600,550,3150,56.25
6325,Vila Madalena,30,1,1,0,2300,550,2850,95.0
6326,Chácara Santo Antônio,104,3,4,2,3900,980,4880,46.923077
6327,Vila Andrade,95,3,3,2,3500,1017,4517,47.547367
6328,Morumbi,67,2,2,2,2750,700,3450,51.49254
6329,Jardim Anália Franco,55,1,1,2,3800,500,4300,78.181816
6330,Vila Madalena,61,2,2,1,5100,850,5950,97.540985
6331,Campo Belo,100,3,3,2,4222,1278,5500,55.0
6332,Outro,22,1,1,0,2700,340,3040,138.18182
6333,Itaim Bibi,96,2,2,2,7000,1750,8750,91.145836
6334,Tatuapé,38,2,1,0,1500,400,1900,50.0
6335,Jardim Paulista,42,1,1,1,2500,1300,3800,90.47619
6336,Brás,48,2,1,1,1200,400,1600,33.333332
6337,Moema,50,1,2,1,2250,486,2736,54.72
6338,Outro,55,3,1,1,1600,526,2126,38.654545
6339,Outro,47,2,1,1,900,450,1350,28.723404
6340,Vila Olímpia,63,2,2,1,2400,915,3315,52.61905
6341,Chácara Santo Antônio,55,2,2,1,2150,1072,3222,58.581818
6342,Jabaquara,49,2,1,1,1290,610,1900,38.77551
6343,Outro,408,3,4,4,40000,8308,48308,118.40196
6344,Vila Leopoldina,48,1,1,1,2600,454,3054,63.625
6345,Ipiranga,101,3,1,2,3500,795,4295,42.524754
6346,Campo Belo,70,2,1,1,2700,750,3450,49.285713
6347,Pinheiros,80,2,1,1,2100,760,2860,35.75
6348,Paraíso,79,2,2,2,6000,1041,7041,89.12658
6349,Bela Vista,47,2,1,1,3200,832,4032,85.78723
6350,Outro,42,2,1,0,1600,160,1760,41.904762
6351,Bela Vista,45,1,1,1,3700,544,4244,94.31111
6352,Outro,40,2,1,1,1500,0,1500,37.5
6353,Vila Andrade,69,2,2,1,2500,560,3060,44.347828
6354,Móoca,77,3,3,2,1600,1300,2900,37.66234
6355,Vila Mascote,60,2,1,1,1900,720,2620,43.666668
6356,Pinheiros,45,1,1,2,4100,600,4700,104.44444
6357,Outro,37,1,1,1,4950,665,5615,151.75676
6358,Morumbi,67,3,2,1,2000,450,2450,36.567165
6359,Vila Madalena,145,3,5,3,9700,2400,12100,83.44827
6360,Perdizes,58,2,2,1,2100,630,2730,47.068966
6361,Santo Amaro,40,1,1,1,2500,0,2500,62.5
6362,Consolação,58,2,1,1,2600,690,3290,56.724136
6363,Vila Clementino,96,3,4,2,4000,1150,5150,53.645832
6364,Bela Vista,30,1,1,0,900,414,1314,43.8
6365,Pinheiros,60,2,2,1,2254,706,2960,49.333332
6366,Itaim Bibi,92,2,3,1,4000,1206,5206,56.586956
6367,Paraíso,90,2,2,1,3400,875,4275,47.5
6368,Vila Sônia,84,3,2,2,3500,0,3500,41.666668
6369,Morumbi,48,2,1,1,1400,1200,2600,54.166668
6370,Perdizes,37,1,1,1,2300,560,2860,77.297295
6371,Aclimação,46,1,1,1,1800,501,2301,50.02174
6372,Outro,59,2,2,1,3000,600,3600,61.01695
6373,Outro,44,2,1,1,1650,257,1907,43.340908
6374,Saúde,73,3,2,2,2700,920,3620,49.589043
6375,Pinheiros,103,3,2,1,3500,1220,4720,45.82524
6376,Vila Olímpia,64,2,2,1,5200,800,6000,93.75
6377,Vila Nova Conceição,140,2,2,2,8000,1200,9200,65.71429
6378,Lapa,57,2,1,1,1000,510,1510,26.491228
6379,Consolação,37,1,1,1,2200,570,2770,74.86487
6380,Outro,46,2,1,1,1500,317,1817,39.5
6381,Pinheiros,46,1,1,2,5300,1300,6600,143.47826
6382,Cambuci,68,2,1,1,1800,668,2468,36.294117
6383,Outro,69,2,2,1,6300,376,6676,96.753624
6384,Paraíso,40,1,1,1,2200,653,2853,71.325
6385,Vila Mariana,98,3,1,2,4000,800,4800,48.97959
6386,Chácara Inglesa,39,2,1,0,3500,350,3850,98.71795
6387,Santana,70,2,2,1,1700,570,2270,32.42857
6388,Ipiranga,82,2,2,2,1600,560,2160,26.341463
6389,Vila Nova Conceição,158,3,3,2,12000,2000,14000,88.6076
6390,Consolação,35,1,1,0,1200,295,1495,42.714287
6391,Vila Sônia,74,3,2,2,2000,855,2855,38.58108
6392,Vila Nova Conceição,167,2,3,3,15000,2095,17095,102.36527
6393,Moema,31,1,1,1,3300,350,3650,117.741936
6394,Brooklin,55,2,2,1,2500,962,3462,62.945454
6395,Morumbi,226,3,5,3,800,3905,4705,20.818584
6396,Pinheiros,90,2,2,2,12000,981,12981,144.23334
6397,Outro,49,2,1,1,1100,350,1450,29.591837
6398,Outro,75,2,2,0,2500,631,3131,41.746666
6399,Móoca,33,1,1,0,2200,272,2472,74.90909
6400,Perdizes,70,2,2,1,2200,925,3125,44.642857
6401,Vila Olímpia,81,2,2,1,6000,0,6000,74.07407
6402,Vila Olímpia,74,2,1,1,2000,808,2808,37.945946
6403,Brooklin,38,1,1,1,3500,600,4100,107.89474
6404,Consolação,40,1,1,1,2500,500,3000,75.0
6405,Panamby,138,3,5,2,5000,1500,6500,47.101448
6406,Jabaquara,60,1,1,1,1400,740,2140,35.666668
6407,Bela Vista,28,1,1,0,1250,240,1490,53.214287
6408,Butantã,58,2,1,1,1300,660,1960,33.793102
6409,Santo Amaro,38,1,1,0,1249,0,1249,32.86842
6410,Perdizes,154,3,5,3,5700,1740,7440,48.311687
6411,Outro,30,1,1,0,1150,150,1300,43.333332
6412,Santa Ifigênia,40,1,1,1,3200,586,3786,94.65
6413,Bela Vista,35,1,1,0,1700,279,1979,56.54286
6414,Saúde,68,2,1,1,2800,518,3318,48.794117
6415,Granja Julieta,193,4,4,3,8000,2100,10100,52.331608
6416,Perdizes,80,2,2,1,2700,900,3600,45.0
6417,Santana,60,2,1,0,1500,600,2100,35.0
6418,Brooklin,75,2,2,1,2600,982,3582,47.76
6419,Jardim Paulista,65,2,2,1,4900,960,5860,90.15385
6420,Vila Olímpia,55,2,1,1,1800,1071,2871,52.2
6421,Pinheiros,68,2,1,1,2200,760,2960,43.52941
6422,Outro,110,3,5,2,3300,1100,4400,40.0
6423,Jardim Paulista,45,2,1,1,2200,879,3079,68.422226
6424,Saúde,60,2,2,2,3000,680,3680,61.333332
6425,Vila Mariana,75,2,1,0,2600,580,3180,42.4
6426,Outro,57,2,1,1,1200,575,1775,31.14035
6427,Vila Romana,90,2,2,0,1950,250,2200,24.444445
6428,Vila Santa Catarina,50,2,1,2,1100,781,1881,37.62
6429,Outro,60,2,1,1,1380,1,1381,23.016666
6430,Campo Belo,161,3,5,3,11000,1716,12716,78.98137
6431,Liberdade,63,2,2,1,2150,710,2860,45.396824
6432,Vila Mariana,35,1,1,0,2000,626,2626,75.02857
6433,Itaim Bibi,70,1,2,1,8000,1000,9000,128.57143
6434,Outro,49,2,1,1,1200,370,1570,32.040817
6435,Vila Mariana,177,4,3,3,10000,0,10000,56.497173
6436,Vila Mariana,106,3,1,2,2750,1531,4281,40.38679
6437,Jardim América,351,4,4,5,45000,6812,51812,147.61253
6438,Jardim Paulista,130,3,3,1,7765,1550,9315,71.65385
6439,Moema,126,2,2,2,11700,1320,13020,103.333336
6440,Cerqueira César,71,2,2,1,2900,886,3786,53.323944
6441,Cidade Monções,83,3,2,1,2300,825,3125,37.650604
6442,Bela Vista,37,1,1,0,1800,400,2200,59.45946
6443,Outro,60,2,2,1,1700,1011,2711,45.183334
6444,Outro,68,2,2,1,2500,545,3045,44.77941
6445,Pinheiros,118,3,2,1,2700,1400,4100,34.74576
6446,Campo Belo,45,1,1,1,2000,555,2555,56.77778
6447,Vila Cruzeiro,37,1,1,1,2300,512,2812,76.0
6448,Barra Funda,51,2,1,0,1250,363,1613,31.62745
6449,Aclimação,45,1,1,0,1500,350,1850,41.11111
6450,Higienópolis,130,3,3,2,6000,1230,7230,55.615383
6451,Vila Guarani,45,1,1,1,2200,494,2694,59.866665
6452,Itaim Bibi,77,1,2,2,8000,1747,9747,126.58442
6453,Outro,25,1,1,0,900,190,1090,43.6
6454,Cerqueira César,40,1,1,0,1550,370,1920,48.0
6455,Paraíso,71,2,1,0,2100,410,2510,35.35211
6456,Vila Mariana,47,1,1,0,1700,400,2100,44.68085
6457,Outro,50,2,1,1,1120,380,1500,30.0
6458,Moema,205,4,6,3,16000,3135,19135,93.34146
6459,Outro,22,1,1,1,2436,446,2882,131.0
6460,Vila Buarque,40,1,1,1,1500,681,2181,54.525
6461,Moema,211,3,1,0,5000,5050,10050,47.630333
6462,Barra Funda,63,2,2,1,1800,890,2690,42.698414
6463,Higienópolis,45,1,2,1,1630,1050,2680,59.555557
6464,Vila Guarani,61,2,1,1,2000,629,2629,43.098362
6465,Vila Olímpia,25,1,1,1,2500,820,3320,132.8
6466,Chácara Santo Antônio,82,2,2,1,2000,495,2495,30.426828
6467,Moema,45,1,1,1,2395,776,3171,70.46667
6468,Moema,94,3,3,2,7300,1400,8700,92.55319
6469,Outro,75,3,2,2,2100,370,2470,32.933334
6470,Saúde,77,2,2,1,1900,850,2750,35.714287
6471,Consolação,35,1,1,1,2300,650,2950,84.28571
6472,Tatuapé,315,3,5,5,17000,1632,18632,59.149208
6473,Santa Ifigênia,30,1,1,0,2300,371,2671,89.03333
6474,Outro,75,3,3,1,2200,720,2920,38.933334
6475,Vila Leopoldina,93,3,2,2,4300,815,5115,55.0
6476,Brooklin,69,2,2,1,4500,800,5300,76.81159
6477,Vila Nova Conceição,70,2,2,1,3100,1480,4580,65.42857
6478,Outro,40,2,1,0,900,0,900,22.5
6479,Vila Mariana,74,2,2,2,4200,650,4850,65.54054
6480,Chácara Inglesa,80,2,1,0,2200,100,2300,28.75
6481,Pinheiros,86,2,2,1,3000,1264,4264,49.581394
6482,Bela Vista,35,1,1,0,1400,450,1850,52.857143
6483,Outro,68,3,1,1,2100,0,2100,30.882353
6484,Higienópolis,208,3,4,2,4800,2060,6860,32.98077
6485,Santana,86,3,3,2,1600,1000,2600,30.232557
6486,Pirituba,62,2,1,1,1250,350,1600,25.806452
6487,Alto Da Boa Vista,371,4,5,5,13000,2944,15944,42.975742
6488,Outro,74,3,1,1,1700,678,2378,32.135136
6489,Moema,95,3,1,2,3300,1447,4747,49.968422
6490,Ipiranga,48,2,1,1,1800,521,2321,48.354168
6491,Brooklin,67,2,2,2,4900,1200,6100,91.04478
6492,Outro,50,1,1,0,1350,0,1350,27.0
6493,Outro,50,2,1,1,1300,350,1650,33.0
6494,Aclimação,85,3,3,1,3200,830,4030,47.411766
6495,Outro,68,3,2,1,2500,630,3130,46.02941
6496,Jardim Paulista,60,2,2,1,4000,850,4850,80.833336
6497,Paraíso,57,2,2,1,2900,978,3878,68.03509
6498,Jardins,178,3,3,1,8000,2450,10450,58.707867
6499,Brooklin,68,2,3,1,2500,1190,3690,54.264706
6500,Morumbi,90,3,2,2,3800,663,4463,49.58889
6501,Bela Vista,48,1,1,0,1900,900,2800,58.333332
6502,Itaim Bibi,45,1,1,1,2000,670,2670,59.333332
6503,Pinheiros,70,2,1,1,2600,390,2990,42.714287
6504,Outro,70,3,2,1,1800,580,2380,34.0
6505,Brooklin,180,4,6,3,6500,2770,9270,51.5
6506,Paraíso,56,2,2,1,2200,883,3083,55.05357
6507,Outro,50,2,1,1,1330,670,2000,40.0
6508,Outro,64,2,1,1,1050,650,1700,26.5625
6509,Freguesia do Ó,70,2,2,1,2300,375,2675,38.214287
6510,Santana,30,1,1,1,2700,0,2700,90.0
6511,Pinheiros,157,3,4,3,13000,2050,15050,95.85987
6512,Vila Mariana,40,1,2,1,2200,490,2690,67.25
6513,Outro,85,2,1,1,2280,0,2280,26.82353
6514,Cambuci,49,2,1,1,1600,500,2100,42.857143
6515,Perdizes,65,2,2,2,3000,700,3700,56.923077
6516,Outro,55,3,1,1,1300,565,1865,33.909092
6517,Consolação,62,1,1,1,1800,492,2292,36.967743
6518,Moema,90,3,2,1,3400,317,3717,41.3
6519,Jaguaré,70,3,1,1,2650,0,2650,37.857143
6520,Tatuapé,70,2,2,2,2400,711,3111,44.442856
6521,Itaim Bibi,37,1,1,1,1900,630,2530,68.37838
6522,Vila Olímpia,123,2,3,2,13200,1500,14700,119.51219
6523,Outro,56,2,1,1,2800,0,2800,50.0
6524,Itaim Bibi,77,1,2,2,8000,1747,9747,126.58442
6525,Barra Funda,33,1,1,0,1600,290,1890,57.272728
6526,Pinheiros,100,3,2,0,3000,818,3818,38.18
6527,Pinheiros,60,2,2,1,2300,1243,3543,59.05
6528,Móoca,60,1,1,0,1200,200,1400,23.333334
6529,Outro,55,1,1,1,3200,470,3670,66.72727
6530,Campo Belo,192,3,5,4,13200,3000,16200,84.375
6531,Vila Guarani,63,2,2,1,2000,680,2680,42.539684
6532,Moema,46,1,1,1,3000,529,3529,76.71739
6533,Pinheiros,42,1,1,1,2500,670,3170,75.47619
6534,Campo Belo,50,1,1,1,3500,450,3950,79.0
6535,Bela Vista,54,1,1,1,1800,1600,3400,62.962963
6536,Outro,75,2,2,2,4100,1055,5155,68.73333
6537,Outro,56,2,2,1,2200,553,2753,49.160713
6538,Moema,104,2,2,2,6000,1200,7200,69.23077
6539,Vila Cruzeiro,49,1,1,1,2800,480,3280,66.938774
6540,Outro,35,1,1,0,1000,30,1030,29.428572
6541,Vila Mariana,57,2,2,1,2750,920,3670,64.38596
6542,Brooklin,37,1,1,1,2300,700,3000,81.08108
6543,Vila Nova Conceição,36,1,1,1,1800,1042,2842,78.94444
6544,Outro,74,2,2,2,2150,671,2821,38.12162
6545,Água Branca,70,3,2,1,2300,450,2750,39.285713
6546,Outro,43,2,1,1,1450,0,1450,33.720932
6547,Outro,50,2,1,1,1500,400,1900,38.0
6548,Moema,60,2,2,1,4100,780,4880,81.333336
6549,Jardins,45,1,1,1,4800,735,5535,123.0
6550,Vila Leopoldina,83,3,2,2,3300,950,4250,51.20482
6551,Vila Leopoldina,70,2,2,1,2400,677,3077,43.95714
6552,Vila Clementino,112,3,3,1,2700,1050,3750,33.482143
6553,Vila Olímpia,94,3,3,3,7500,1172,8672,92.25532
6554,Vila Nova Conceição,54,1,2,1,7500,700,8200,151.85185
6555,Perdizes,115,3,3,2,4500,1480,5980,52.0
6556,Outro,63,2,2,0,2500,535,3035,48.174603
6557,Ipiranga,86,2,3,2,2500,980,3480,40.465115
6558,Itaim Bibi,40,1,1,1,1250,2360,3610,90.25
6559,Higienópolis,38,1,1,1,1500,540,2040,53.68421
6560,Jardim Paulista,406,3,3,3,25000,5057,30057,74.03202
6561,Pompeia,73,3,2,1,2700,853,3553,48.671234
6562,Pinheiros,75,3,2,1,3500,1100,4600,61.333332
6563,Vila Mariana,33,1,1,1,1500,483,1983,60.090908
6564,Vila Carrão,50,2,1,0,1300,150,1450,29.0
6565,Bela Vista,39,1,1,1,2400,480,2880,73.84615
6566,Outro,50,1,1,0,750,180,930,18.6
6567,Santo Amaro,130,3,3,2,5250,1170,6420,49.384617
6568,Vila Mariana,89,3,1,2,2900,650,3550,39.88764
6569,Sumaré,85,2,2,2,5800,1404,7204,84.752945
6570,Brooklin,84,4,3,2,17000,1100,18100,215.4762
6571,Moema,87,2,2,1,3500,685,4185,48.103447
6572,Vila Romana,75,3,2,1,1990,940,2930,39.066666
6573,Perdizes,190,4,4,3,8000,2900,10900,57.36842
6574,Jardim Paulista,115,3,2,2,5500,1050,6550,56.95652
6575,Outro,47,2,1,1,1500,0,1500,31.914894
6576,Butantã,20,1,1,0,1200,0,1200,60.0
6577,Vila Mariana,120,4,3,2,3500,916,4416,36.8
6578,Pinheiros,53,1,1,2,2800,940,3740,70.56604
6579,Outro,122,3,4,2,5000,1100,6100,50.0
6580,Higienópolis,63,2,2,2,5000,819,5819,92.36508
6581,Campo Belo,43,1,1,1,2450,654,3104,72.18604
6582,Butantã,55,2,1,1,1800,560,2360,42.909092
6583,Perdizes,100,3,2,1,2300,1094,3394,33.94
6584,Panamby,350,4,8,5,5000,4700,9700,27.714285
6585,Perdizes,202,3,4,3,6235,2510,8745,43.29208
6586,Saúde,37,1,1,1,2000,450,2450,66.21622
6587,Vila Nova Conceição,88,2,3,0,5500,2578,8078,91.795456
6588,Vila Clementino,68,2,1,0,1500,542,2042,30.029411
6589,Vila Madalena,136,2,3,2,12000,613,12613,92.742645
6590,Cidade Monções,172,3,3,3,10000,2500,12500,72.674416
6591,Outro,753,4,6,7,80000,14197,94197,125.09562
6592,Paraíso,40,1,1,1,2100,715,2815,70.375
6593,Santana,123,3,3,2,2100,1395,3495,28.414635
6594,Aclimação,88,3,2,2,2300,847,3147,35.761364
6595,Mirandópolis,40,1,1,1,1400,475,1875,46.875
6596,Casa Verde,70,2,1,0,1400,0,1400,20.0
6597,Bela Vista,40,1,1,1,1400,570,1970,49.25
6598,Outro,75,2,2,1,1600,510,2110,28.133333
6599,Consolação,161,3,2,1,4990,0,4990,30.99379
6600,Bela Vista,16,1,1,0,1980,230,2210,138.125
6601,Brooklin,70,2,2,1,2790,860,3650,52.142857
6602,Santa Cecília,188,3,3,2,4500,1514,6014,31.98936
6603,Perdizes,137,4,4,3,7000,1700,8700,63.50365
6604,Vila Guarani,50,2,1,1,1400,700,2100,42.0
6605,Pinheiros,82,2,2,1,3500,800,4300,52.439026
6606,Santo Amaro,65,2,1,1,2790,490,3280,50.46154
6607,Ipiranga,140,3,2,2,6000,997,6997,49.978573
6608,Saúde,70,3,2,2,2500,574,3074,43.914288
6609,Vila Madalena,50,2,1,1,2200,336,2536,50.72
6610,Chácara Santo Antônio,80,2,2,2,5650,800,6450,80.625
6611,Vila Leopoldina,52,1,1,1,2600,600,3200,61.53846
6612,Vila Nova Conceição,150,3,3,2,9700,1700,11400,76.0
6613,Paraíso,66,2,1,1,3700,470,4170,63.18182
6614,Itaim Bibi,97,2,3,1,3600,1241,4841,49.907215
6615,Cerqueira César,140,3,2,1,3200,1500,4700,33.57143
6616,Jardim Anália Franco,230,4,6,4,3000,3000,6000,26.086956
6617,Vila Buarque,60,2,2,1,3500,540,4040,67.333336
6618,Santa Cecília,75,2,2,2,3000,1496,4496,59.946667
6619,Santa Ifigênia,30,1,1,1,2550,480,3030,101.0
6620,Paraíso,52,2,1,0,2100,435,2535,48.75
6621,Outro,90,2,1,1,1500,885,2385,26.5
6622,Pinheiros,60,2,2,1,4500,860,5360,89.333336
6623,Cerqueira César,100,3,3,1,5000,1700,6700,67.0
6624,Itaim Bibi,29,1,1,1,3000,650,3650,125.86207
6625,Indianópolis,51,2,2,1,4500,0,4500,88.23529
6626,Outro,70,3,2,2,1900,856,2756,39.37143
6627,Jaguaré,117,3,3,2,1900,700,2600,22.222221
6628,Pinheiros,73,2,2,2,4000,830,4830,66.16438
6629,Pinheiros,35,1,1,1,2563,768,3331,95.171425
6630,Jardim Paulista,132,2,3,2,9000,865,9865,74.73485
6631,Moema,157,4,5,3,9000,1550,10550,67.19745
6632,Vila Leopoldina,88,2,3,2,3500,0,3500,39.772728
6633,Panamby,83,2,4,2,3000,983,3983,47.987953
6634,Higienópolis,107,3,2,2,4000,1633,5633,52.64486
6635,Chácara Santo Antônio,112,3,4,2,5700,840,6540,58.392857
6636,Consolação,35,1,1,1,2900,480,3380,96.57143
6637,Lapa,65,2,1,1,1600,380,1980,30.461538
6638,Indianópolis,120,3,3,2,4000,1880,5880,49.0
6639,Pinheiros,78,2,2,1,15000,2000,17000,217.94872
6640,Vila Olímpia,65,2,2,1,4600,880,5480,84.30769
6641,Outro,52,2,1,1,1400,529,1929,37.096153
6642,Cidade Monções,38,1,1,1,2800,550,3350,88.1579
6643,Tatuapé,48,2,1,1,1500,375,1875,39.0625
6644,Itaim Bibi,100,3,2,1,4500,1000,5500,55.0
6645,Pinheiros,50,1,1,1,3500,565,4065,81.3
6646,Aclimação,42,1,1,0,1449,301,1750,41.666668
6647,Bela Vista,50,2,1,1,3200,430,3630,72.6
6648,Outro,40,2,1,0,1210,140,1350,33.75
6649,Pinheiros,100,3,2,1,2600,1073,3673,36.73
6650,Brooklin,35,1,1,1,2500,550,3050,87.14286
6651,Outro,50,2,1,0,1170,0,1170,23.4
6652,Outro,61,2,1,2,1500,700,2200,36.065575
6653,Outro,62,2,2,1,4700,818,5518,89.0
6654,Itaim Bibi,45,1,1,1,2500,1150,3650,81.111115
6655,Jardim América,120,3,2,1,3000,1281,4281,35.675
6656,Barra Funda,403,5,5,2,8000,2800,10800,26.799007
6657,Chácara Santo Antônio,70,2,2,1,3200,734,3934,56.2
6658,Outro,50,1,1,0,1000,265,1265,25.3
6659,Bela Vista,35,1,1,1,1500,400,1900,54.285713
6660,Brás,60,2,1,1,1300,490,1790,29.833334
6661,Outro,60,2,1,1,1800,496,2296,38.266666
6662,Freguesia do Ó,64,2,2,1,2200,400,2600,40.625
6663,Mirandópolis,98,3,3,2,4500,893,5393,55.030613
6664,Vila Leopoldina,96,2,2,1,2500,780,3280,34.166668
6665,Indianópolis,97,3,3,2,3800,1300,5100,52.57732
6666,Outro,59,3,2,1,1500,740,2240,37.966103
6667,Butantã,60,2,2,1,1900,368,2268,37.8
6668,Casa Verde,72,2,3,2,3200,650,3850,53.47222
6669,Liberdade,45,2,1,1,1700,203,1903,42.288887
6670,Vila Mariana,120,3,3,1,3000,1500,4500,37.5
6671,Vila Olímpia,38,1,1,1,6299,950,7249,190.76315
6672,Bela Vista,47,2,1,1,3200,900,4100,87.23404
6673,Higienópolis,37,1,1,1,2600,733,3333,90.08108
6674,Jardim Paulista,120,4,3,1,4000,1488,5488,45.733334
6675,Jardins,48,2,1,1,1800,880,2680,55.833332
6676,Itaim Bibi,54,1,2,1,8300,1100,9400,174.07408
6677,Campo Belo,107,2,3,2,4200,800,5000,46.728973
6678,Vila Andrade,70,2,1,1,1400,700,2100,30.0
6679,Outro,52,2,1,1,1400,300,1700,32.692307
6680,Consolação,70,2,2,0,2100,0,2100,30.0
6681,Granja Julieta,81,3,2,2,4000,700,4700,58.024693
6682,Centro,50,1,1,1,1900,650,2550,51.0
6683,Brooklin,39,1,1,1,3250,560,3810,97.69231
6684,Brooklin,55,1,2,1,1900,782,2682,48.763638
6685,Outro,36,2,1,0,1200,200,1400,38.88889
6686,Morumbi,50,2,1,1,1880,420,2300,46.0
6687,Outro,90,2,2,1,2200,577,2777,30.855556
6688,Pinheiros,187,4,5,3,8000,2000,10000,53.475937
6689,Outro,40,2,1,1,2200,480,2680,67.0
6690,Vila Nova Conceição,465,5,7,6,49900,8344,58244,125.25591
6691,Vila Mariana,59,1,2,1,2200,720,2920,49.491524
6692,Liberdade,20,1,1,0,600,400,1000,50.0
6693,Pinheiros,160,3,4,2,5500,1754,7254,45.3375
6694,Centro,72,2,1,0,1800,500,2300,31.944445
6695,Santa Cecília,75,3,3,2,2500,1250,3750,50.0
6696,Perdizes,82,2,2,2,2900,1110,4010,48.90244
6697,Outro,50,2,2,2,2200,490,2690,53.8
6698,Vila Olímpia,61,2,1,0,1800,495,2295,37.62295
6699,Campo Belo,42,1,2,1,3200,580,3780,90.0
6700,Tatuapé,55,2,1,1,2100,450,2550,46.363636
6701,Consolação,55,2,1,1,6500,770,7270,132.18182
6702,Brooklin,115,3,3,2,3100,1479,4579,39.81739
6703,Vila Mascote,110,3,4,3,5500,759,6259,56.9
6704,Outro,77,3,2,1,2950,0,2950,38.311687
6705,Bela Vista,45,1,1,0,1500,510,2010,44.666668
6706,Outro,75,3,3,2,2500,998,3498,46.64
6707,Outro,250,4,6,4,3500,2800,6300,25.2
6708,Vila Clementino,40,1,1,1,2200,450,2650,66.25
6709,Moema,55,2,2,2,3150,950,4100,74.545456
6710,Outro,48,2,1,1,1200,430,1630,33.958332
6711,Vila Formosa,30,1,1,0,700,50,750,25.0
6712,Campos Eliseos,38,1,1,1,1700,496,2196,57.789474
6713,Perdizes,70,3,2,1,2800,924,3724,53.2
6714,Outro,35,1,1,0,900,202,1102,31.485714
6715,Outro,100,2,2,1,2500,700,3200,32.0
6716,Perdizes,160,3,5,3,12500,2850,15350,95.9375
6717,Móoca,93,3,2,2,2200,1200,3400,36.55914
6718,Cerqueira César,125,3,3,1,7500,1550,9050,72.4
6719,Vila Nova Conceição,91,3,2,1,3500,448,3948,43.384617
6720,Moema,100,3,3,2,6750,850,7600,76.0
6721,Pinheiros,63,2,2,0,2900,350,3250,51.587303
6722,Vila Madalena,54,1,1,1,2000,982,2982,55.22222
6723,Pinheiros,30,1,1,1,2150,742,2892,96.4
6724,Pompeia,80,3,3,2,3500,650,4150,51.875
6725,Outro,65,3,1,1,1400,574,1974,30.36923
6726,Brooklin,51,1,1,1,3300,590,3890,76.27451
6727,Vila Olímpia,41,1,1,1,3800,0,3800,92.68293
6728,Vila Olímpia,79,3,1,2,3200,1139,4339,54.92405
6729,Campo Belo,42,1,1,1,1700,750,2450,58.333332
6730,Vila Mascote,75,2,1,1,2200,0,2200,29.333334
6731,Campos Eliseos,30,1,1,1,1300,402,1702,56.733334
6732,Jaguaré,60,2,1,1,1250,506,1756,29.266666
6733,Outro,90,3,2,2,3200,1300,4500,50.0
6734,Mirandópolis,25,1,1,0,1900,350,2250,90.0
6735,Vila Romana,98,2,2,1,2300,823,3123,31.867348
6736,Campos Eliseos,68,3,2,1,1800,756,2556,37.588234
6737,Liberdade,60,1,2,1,1750,907,2657,44.283333
6738,Campo Belo,46,1,1,1,2600,560,3160,68.695656
6739,Jardim Paulista,130,2,3,1,5000,1180,6180,47.53846
6740,Moema,55,1,1,1,3450,720,4170,75.818184
6741,Vila Mariana,50,1,1,1,1650,685,2335,46.7
6742,Vila Clementino,53,2,1,1,4000,650,4650,87.73585
6743,Jardim América,200,4,1,2,6000,3017,9017,45.085
6744,Santana,40,1,1,0,1400,265,1665,41.625
6745,Moema,196,4,5,4,10000,2700,12700,64.79592
6746,Jardim Paulista,98,2,3,1,4000,1698,5698,58.142857
6747,Outro,118,3,4,3,3300,1175,4475,37.92373
6748,Brás,36,1,1,1,2100,465,2565,71.25
6749,Aclimação,26,1,1,1,2000,350,2350,90.38461
6750,Santo Amaro,50,2,1,0,1600,670,2270,45.4
6751,Jabaquara,90,3,1,1,1500,200,1700,18.88889
6752,Jardim Marajoara,70,3,2,2,2900,0,2900,41.42857
6753,Cidade Monções,54,2,2,1,2200,731,2931,54.27778
6754,Outro,55,2,2,2,1800,700,2500,45.454544
6755,Vila Nova Conceição,48,1,1,1,6900,0,6900,143.75
6756,Aclimação,39,1,1,1,2260,530,2790,71.53846
6757,Itaim Bibi,90,3,3,1,3400,861,4261,47.344444
6758,Jardim Paulista,99,2,3,0,3400,876,4276,43.191917
6759,Vila Mariana,70,2,1,0,1900,310,2210,31.571428
6760,Outro,51,1,1,1,2900,600,3500,68.62745
6761,Higienópolis,80,3,3,2,4800,1062,5862,73.275
6762,Outro,60,2,2,2,1600,769,2369,39.483334
6763,Itaim Bibi,265,4,7,4,20000,3217,23217,87.61132
6764,Lapa,54,2,2,2,3000,734,3734,69.14815
6765,Bela Vista,38,1,1,1,1050,715,1765,46.44737
6766,Campo Belo,130,3,2,2,4000,1300,5300,40.76923
6767,Vila Andrade,66,3,2,2,1901,570,2471,37.439392
6768,Vila Olímpia,77,1,2,1,7800,1200,9000,116.88312
6769,Itaim Bibi,105,3,4,2,7000,1400,8400,80.0
6770,Cambuci,136,3,3,1,1950,1000,2950,21.691177
6771,Vila Cruzeiro,45,1,1,1,3000,450,3450,76.666664
6772,Itaim Bibi,130,3,3,2,6500,2245,8745,67.26923
6773,Moema,287,4,3,4,28000,3500,31500,109.756096
6774,Vila Mariana,64,2,2,2,3000,935,3935,61.484375
6775,Outro,56,2,2,1,1700,420,2120,37.857143
6776,Brooklin,45,1,1,1,3200,586,3786,84.13333
6777,Brooklin,85,3,3,2,3600,1003,4603,54.152943
6778,Campos Eliseos,45,1,1,0,1300,340,1640,36.444443
6779,Saúde,41,1,1,1,1900,550,2450,59.756096
6780,Bela Vista,45,1,1,1,2000,575,2575,57.22222
6781,Vila Mascote,144,3,5,3,5000,2750,7750,53.819443
6782,Outro,55,2,2,2,1600,700,2300,41.81818
6783,Moema,75,2,2,2,4550,1067,5617,74.89333
6784,Vila Leopoldina,127,3,5,2,5400,900,6300,49.6063
6785,Bela Vista,68,2,1,1,2800,1445,4245,62.42647
6786,Vila Uberabinha,110,4,4,2,5400,1280,6680,60.727272
6787,Móoca,63,2,2,1,2000,590,2590,41.11111
6788,Barra Funda,40,1,1,1,1650,438,2088,52.2
6789,Cerqueira César,36,1,2,0,1650,650,2300,63.88889
6790,Outro,56,2,1,1,1050,200,1250,22.321428
6791,Vila Mariana,77,3,1,2,3500,770,4270,55.454544
6792,Morumbi,70,1,1,1,2400,700,3100,44.285713
6793,Outro,40,1,1,0,1600,0,1600,40.0
6794,Moema,60,1,1,1,2400,850,3250,54.166668
6795,Vila Olímpia,60,1,2,1,6000,890,6890,114.833336
6796,Perdizes,110,3,3,1,3600,1177,4777,43.427273
6797,Campo Belo,62,2,2,1,2400,720,3120,50.322582
6798,Outro,35,1,1,0,550,0,550,15.714286
6799,Moema,131,3,3,0,3200,1100,4300,32.82443
6800,Brooklin,51,1,1,1,3220,545,3765,73.82353
6801,Vila Buarque,110,3,3,1,4000,1490,5490,49.909092
6802,Perdizes,65,2,2,2,3400,990,4390,67.53846
6803,Outro,60,2,1,2,1450,850,2300,38.333332
6804,Barra Funda,50,1,1,1,2600,514,3114,62.28
6805,Pinheiros,70,2,2,1,4700,952,5652,80.74286
6806,Vila Clementino,250,4,3,2,5000,2190,7190,28.76
6807,Móoca,64,2,2,1,1700,800,2500,39.0625
6808,Santo Amaro,101,3,3,2,3800,1195,4995,49.455444
6809,Outro,40,2,1,0,1100,150,1250,31.25
6810,Vila Guarani,58,2,2,1,1700,688,2388,41.172413
6811,Outro,50,2,1,1,1200,0,1200,24.0
6812,Centro,89,2,2,0,2650,300,2950,33.14607
6813,Outro,70,3,2,1,1600,618,2218,31.685715
6814,Bela Vista,45,1,1,1,3500,544,4044,89.86667
6815,Vila Olímpia,76,2,1,2,4000,800,4800,63.157894
6816,Brooklin,80,3,3,2,3000,1221,4221,52.7625
6817,Centro,47,1,1,1,2500,632,3132,66.6383
6818,Jaguaré,52,2,1,1,1400,403,1803,34.673077
6819,Outro,65,2,2,1,1700,800,2500,38.46154
6820,Chácara Klabin,53,1,2,1,1450,981,2431,45.867924
6821,Vila Buarque,55,1,1,0,2100,620,2720,49.454544
6822,Liberdade,90,3,2,2,2800,1009,3809,42.322224
6823,Outro,236,2,6,3,30000,0,30000,127.118645
6824,Vila Guarani,54,2,2,1,2100,0,2100,38.88889
6825,Pinheiros,85,2,2,2,5500,775,6275,73.82353
6826,Lapa,52,2,1,1,1700,396,2096,40.307693
6827,Itaim Bibi,61,1,2,1,6450,1700,8150,133.60655
6828,Brooklin,67,2,2,1,3500,763,4263,63.626865
6829,Brooklin,90,3,3,2,3500,1104,4604,51.155556
6830,Outro,62,2,1,1,1900,480,2380,38.387096
6831,Moema,70,2,1,1,1500,717,2217,31.671429
6832,Outro,48,2,1,1,1250,565,1815,37.8125
6833,Jardins,110,3,3,2,4000,1800,5800,52.727272
6834,Pinheiros,55,2,1,0,2000,0,2000,36.363636
6835,Outro,48,2,1,1,1121,279,1400,29.166666
6836,Bela Vista,60,2,2,1,2800,750,3550,59.166668
6837,Móoca,142,3,5,2,4000,1162,5162,36.35211
6838,Moema,38,1,1,1,550,2700,3250,85.52631
6839,Outro,65,2,2,1,1650,324,1974,30.36923
6840,Itaim Bibi,120,3,1,2,4600,2900,7500,62.5
6841,Outro,49,2,1,1,850,200,1050,21.428572
6842,Mirandópolis,62,3,2,1,1800,350,2150,34.677418
6843,Jardim América,70,2,2,1,9500,1200,10700,152.85715
6844,Jardim Paulista,74,2,2,2,4500,610,5110,69.054054
6845,Outro,40,2,1,1,2100,0,2100,52.5
6846,Ipiranga,75,2,2,1,3000,750,3750,50.0
6847,Vila Carrão,50,2,1,1,1150,320,1470,29.4
6848,Mirandópolis,60,2,2,2,3000,900,3900,65.0
6849,Outro,47,1,2,1,2500,650,3150,67.02128
6850,Outro,52,2,1,1,1150,300,1450,27.884615
6851,Indianópolis,144,3,5,3,4000,1800,5800,40.27778
6852,Vila Uberabinha,170,3,5,3,14000,2300,16300,95.882355
6853,Brooklin,245,3,3,5,17000,2760,19760,80.65306
6854,Vila Madalena,60,2,2,2,3800,1100,4900,81.666664
6855,Outro,70,2,1,1,1600,757,2357,33.67143
6856,Moema,80,3,2,1,3800,935,4735,59.1875
6857,Vila Nova Conceição,116,2,4,2,7500,2760,10260,88.44827
6858,Outro,72,3,1,2,2500,873,3373,46.84722
6859,Sumaré,45,1,1,1,2100,700,2800,62.22222
6860,Tatuapé,128,3,3,3,3500,1286,4786,37.390625
6861,Vila Mariana,32,1,1,0,1380,230,1610,50.3125
6862,Outro,89,2,3,2,4300,800,5100,57.30337
6863,Outro,67,2,2,2,4000,750,4750,70.89552
6864,Ipiranga,111,3,4,2,5500,1000,6500,58.55856
6865,Jardim Paulista,65,2,2,1,5900,1750,7650,117.69231
6866,Jardim Marajoara,75,3,2,2,1600,706,2306,30.746666
6867,Tatuapé,65,2,2,2,2200,576,2776,42.70769
6868,Moema,53,2,2,1,2700,481,3181,60.018867
6869,Perdizes,65,2,2,1,2950,761,3711,57.092308
6870,Santa Cecília,52,2,1,1,2300,386,2686,51.653847
6871,Outro,45,2,1,1,1000,75,1075,23.88889
6872,Vila Olímpia,54,2,1,1,3500,660,4160,77.03704
6873,Vila Mariana,56,2,2,1,2600,1065,3665,65.44643
6874,Jardim Paulista,45,1,1,1,3600,0,3600,80.0
6875,Jabaquara,49,2,1,1,1500,500,2000,40.816326
6876,Ipiranga,70,3,1,1,2600,700,3300,47.142857
6877,Vila Mascote,66,2,2,1,2000,750,2750,41.666668
6878,Consolação,42,1,1,1,2000,483,2483,59.11905
6879,Brooklin,35,1,1,1,2700,550,3250,92.85714
6880,Ipiranga,50,2,1,1,2300,570,2870,57.4
6881,Saúde,56,2,2,1,4000,628,4628,82.64286
6882,Moema,70,2,1,1,2800,956,3756,53.657143
6883,Outro,42,2,1,1,1000,120,1120,26.666666
6884,Vila Mariana,102,3,3,2,4800,850,5650,55.39216
6885,Bela Vista,120,3,2,1,4200,0,4200,35.0
6886,Tatuapé,58,2,1,1,2000,439,2439,42.051723
6887,Bela Vista,42,1,1,0,1600,375,1975,47.02381
6888,Vila Madalena,66,1,1,1,3400,1200,4600,69.69697
6889,Cerqueira César,38,1,1,1,2000,509,2509,66.02631
6890,Outro,62,2,2,1,1900,890,2790,45.0
6891,Pinheiros,61,2,2,1,2950,1203,4153,68.08197
6892,Vila Buarque,65,2,2,1,1800,1039,2839,43.67692
6893,Campo Belo,37,1,1,1,2500,500,3000,81.08108
6894,Brooklin,37,1,1,1,1500,698,2198,59.405407
6895,Campo Belo,73,2,2,2,5000,0,5000,68.49315
6896,Bela Vista,47,1,1,1,2250,815,3065,65.21277
6897,Vila Sônia,105,2,2,2,3200,526,3726,35.485714
6898,Vila Mariana,127,3,2,1,3200,1050,4250,33.464565
6899,Brooklin,47,1,1,0,3500,738,4238,90.17021
6900,Jardim Paulista,42,1,1,2,3700,720,4420,105.2381
6901,Cerqueira César,35,1,1,1,5435,480,5915,169.0
6902,Centro,46,1,1,0,2400,741,3141,68.28261
6903,Tatuapé,114,3,5,3,3200,1050,4250,37.2807
6904,Vila Clementino,98,3,3,2,4600,966,5566,56.795918
6905,Campo Belo,60,1,2,1,3635,752,4387,73.11667
6906,Vila Leopoldina,56,2,2,1,3400,534,3934,70.25
6907,Outro,40,1,1,0,700,0,700,17.5
6908,Higienópolis,33,1,1,1,2900,550,3450,104.545456
6909,Outro,103,3,3,2,3700,862,4562,44.291264
6910,Vila Olímpia,56,2,1,1,1800,1225,3025,54.017857
6911,Chácara Santo Antônio,101,3,3,2,3800,1184,4984,49.346535
6912,Moema,83,2,2,1,3000,1100,4100,49.39759
6913,Vila Mariana,40,1,1,1,2700,700,3400,85.0
6914,Higienópolis,125,3,4,1,3500,2323,5823,46.584
6915,Itaim Bibi,100,2,2,1,3200,1300,4500,45.0
6916,Bela Vista,30,1,1,1,1700,514,2214,73.8
6917,Outro,46,2,1,1,1100,380,1480,32.173912
6918,Vila Gomes Cardim,47,1,1,1,1700,280,1980,42.12766
6919,Cerqueira César,178,3,3,1,8000,2450,10450,58.707867
6920,Pinheiros,52,2,2,1,4200,800,5000,96.15385
6921,Brooklin,44,1,1,1,3400,585,3985,90.568184
6922,Santana,70,2,1,0,1300,584,1884,26.914286
6923,Outro,56,2,1,1,1000,135,1135,20.267857
6924,Outro,70,2,2,2,3500,958,4458,63.685715
6925,Pinheiros,58,1,1,1,4900,750,5650,97.413795
6926,Aclimação,40,1,1,1,2290,509,2799,69.975
6927,Outro,63,3,2,1,1500,724,2224,35.301586
6928,Moema,170,4,1,2,6300,1400,7700,45.294117
6929,Santana,76,2,2,2,4000,600,4600,60.526318
6930,Aclimação,60,1,1,0,1450,549,1999,33.316666
6931,Brooklin,33,1,1,0,2900,750,3650,110.606064
6932,Higienópolis,130,3,2,1,3500,2283,5783,44.484615
6933,Brooklin,66,1,1,1,6500,650,7150,108.333336
6934,Vila Mariana,90,3,1,2,2800,1015,3815,42.38889
6935,Vila Mariana,265,4,3,2,5500,2563,8063,30.426414
6936,Vila Madalena,87,2,2,0,2100,440,2540,29.195402
6937,Perdizes,50,1,1,1,1950,665,2615,52.3
6938,Outro,165,3,4,3,7050,1,7051,42.733334
6939,Jardim Paulista,50,1,1,1,2700,694,3394,67.88
6940,Vila Olímpia,62,1,2,2,6200,2600,8800,141.93549
6941,Vila Mascote,86,3,3,2,4100,0,4100,47.67442
6942,Butantã,55,2,1,1,1600,520,2120,38.545456
6943,Jardim América,262,4,6,4,20000,4850,24850,94.84733
6944,Pinheiros,74,2,2,1,3000,850,3850,52.027027
6945,Outro,48,2,2,1,2300,550,2850,59.375
6946,Vila Olímpia,30,1,1,1,3000,700,3700,123.333336
6947,Barra Funda,33,1,1,1,1800,520,2320,70.30303
6948,Vila Leopoldina,83,3,3,2,3500,950,4450,53.614456
6949,Vila Andrade,120,3,3,2,5000,840,5840,48.666668
6950,Ipiranga,62,2,1,1,2600,550,3150,50.80645
6951,Outro,64,2,3,1,2000,884,2884,45.0625
6952,Moema,210,3,5,3,21500,2000,23500,111.90476
6953,Outro,56,2,1,1,900,140,1040,18.571428
6954,Perdizes,80,2,3,2,5500,1413,6913,86.4125
6955,Cerqueira César,40,1,1,0,1650,370,2020,50.5
6956,Outro,63,3,2,2,1700,600,2300,36.50794
6957,Outro,49,1,2,1,3000,580,3580,73.061226
6958,Santa Cecília,36,1,1,0,2200,340,2540,70.55556
6959,Paraíso,104,3,2,1,3900,1047,4947,47.567307
6960,Outro,52,2,1,1,1300,595,1895,36.442307
6961,Vila Santa Catarina,104,3,3,2,2200,650,2850,27.403847
6962,Sumaré,60,2,2,1,2300,1100,3400,56.666668
6963,Água Branca,70,2,1,0,1600,250,1850,26.428572
6964,Vila Uberabinha,173,3,3,3,16000,2736,18736,108.300575
6965,Aclimação,100,3,3,1,3000,830,3830,38.3
6966,Cerqueira César,121,3,3,1,7700,1515,9215,76.15703
6967,Campo Belo,77,3,3,1,4000,1027,5027,65.28571
6968,Saúde,40,1,1,1,1600,408,2008,50.2
6969,Vila Nova Conceição,161,3,4,3,16500,2900,19400,120.496895
6970,Itaim Bibi,45,1,1,1,2300,908,3208,71.28889
6971,Aclimação,37,1,1,0,849,268,1117,30.18919
6972,Campo Belo,228,4,5,4,20000,1900,21900,96.052635
6973,Paraíso,78,2,3,2,4500,1100,5600,71.79487
6974,Vila Olímpia,90,1,2,2,7500,1995,9495,105.5
6975,Pinheiros,57,1,1,1,4000,715,4715,82.7193
6976,Brás,71,3,2,1,2500,490,2990,42.112675
6977,Perdizes,183,4,3,4,4800,2500,7300,39.89071
6978,Moema,42,1,1,1,2000,880,2880,68.57143
6979,Vila Mariana,50,2,2,1,2800,845,3645,72.9
6980,Perdizes,155,3,5,3,12000,2130,14130,91.16129
6981,Outro,100,3,2,1,2500,200,2700,27.0
6982,Jardim Europa,110,3,4,3,6700,1396,8096,73.6
6983,Brooklin,239,3,6,4,18000,2250,20250,84.728035
6984,Outro,60,2,1,1,1300,450,1750,29.166666
6985,Vila Mariana,100,2,1,1,2000,668,2668,26.68
6986,Itaim Bibi,90,2,2,1,3900,1700,5600,62.22222
6987,Brooklin,68,1,2,2,4600,924,5524,81.23529
6988,Brooklin,45,1,2,1,2150,870,3020,67.111115
6989,Pompeia,70,3,2,2,2400,780,3180,45.42857
6990,Vila Mariana,43,1,1,1,2100,317,2417,56.2093
6991,Santana,60,2,1,0,1200,280,1480,24.666666
6992,Jardim Paulista,90,2,3,1,6700,1160,7860,87.333336
6993,Água Branca,70,3,1,1,2400,491,2891,41.3
6994,Moema,63,2,2,1,3000,2800,5800,92.06349
6995,Itaim Bibi,92,2,3,2,10500,1979,12479,135.64131
6996,Vila Mariana,40,1,1,1,3500,500,4000,100.0
6997,Alto Da Boa Vista,310,4,6,4,21000,2702,23702,76.45806
6998,Jardim América,180,3,4,2,9200,2700,11900,66.111115
6999,Itaim Bibi,55,1,2,1,2000,719,2719,49.436363
7000,Outro,96,2,1,0,1500,250,1750,18.229166
7001,Outro,52,2,1,1,1700,740,2440,46.923077
7002,Aclimação,85,3,3,1,3000,800,3800,44.705883
7003,Outro,50,2,1,0,1500,350,1850,37.0
7004,Vila Mariana,95,2,2,1,3300,688,3988,41.978947
7005,Outro,60,2,1,0,1700,180,1880,31.333334
7006,Bela Vista,30,1,1,1,5000,700,5700,190.0
7007,Chácara Santo Antônio,80,2,1,1,2500,680,3180,39.75
7008,Itaim Bibi,131,3,3,1,5000,945,5945,45.38168
7009,Vila Clementino,84,3,3,2,3600,1070,4670,55.595238
7010,Morumbi,112,2,4,2,3000,1676,4676,41.75
7011,Jardins,98,2,2,1,3500,1070,4570,46.632652
7012,Moema,70,2,3,2,3500,1500,5000,71.42857
7013,Outro,52,2,1,1,1550,430,1980,38.076923
7014,Vila Mariana,59,2,2,2,2700,1349,4049,68.62712
7015,Jardim América,150,3,5,4,15000,3824,18824,125.49333
7016,Bom Retiro,121,1,1,0,1200,771,1971,16.289257
7017,Vila Olímpia,98,3,2,2,5000,1000,6000,61.22449
7018,Vila Olímpia,46,1,1,1,3500,1380,4880,106.08696
7019,Pinheiros,80,3,2,0,2900,564,3464,43.3
7020,Consolação,35,1,1,1,3200,550,3750,107.14286
7021,Outro,65,3,1,1,1400,585,1985,30.538462
7022,Perdizes,110,3,3,1,4000,1415,5415,49.227272
7023,Vila Romana,90,2,4,2,3360,980,4340,48.22222
7024,Jardim Paulista,62,1,2,2,2900,1050,3950,63.70968
7025,Aclimação,48,2,1,0,1500,627,2127,44.3125
7026,Pinheiros,90,3,2,1,2600,930,3530,39.22222
7027,Vila Olímpia,65,1,2,1,5500,680,6180,95.07692
7028,Perdizes,114,3,4,2,3500,1800,5300,46.491226
7029,Jardim Prudência,100,3,1,2,5500,950,6450,64.5
7030,Pompeia,116,3,2,1,3500,660,4160,35.86207
7031,Tatuapé,42,1,1,1,1440,667,2107,50.166668
7032,Outro,75,3,2,1,1940,560,2500,33.333332
7033,Moema,50,1,1,1,1500,780,2280,45.6
7034,Pinheiros,93,3,3,1,3000,1450,4450,47.84946
7035,Campos Eliseos,180,3,3,1,2600,2950,5550,30.833334
7036,Paraíso,120,4,3,2,6000,1100,7100,59.166668
7037,Vila Mariana,82,2,2,1,2000,810,2810,34.26829
7038,Pinheiros,115,3,4,2,3450,1750,5200,45.217392
7039,Centro,50,1,1,0,1300,407,1707,34.14
7040,Liberdade,70,2,1,0,1700,535,2235,31.928572
7041,Outro,53,1,2,1,3700,920,4620,87.169815
7042,Vila Mariana,18,1,1,0,2100,350,2450,136.11111
7043,Vila Mariana,105,3,3,1,3200,1210,4410,42.0
7044,Morumbi,78,1,2,2,2200,1468,3668,47.025642
7045,Vila Guarani,110,3,3,2,4300,980,5280,48.0
7046,Moema,354,5,7,4,18000,2974,20974,59.24859
7047,Alto Da Boa Vista,46,1,1,1,2100,381,2481,53.934784
7048,Vila Mariana,90,3,2,0,2200,290,2490,27.666666
7049,Higienópolis,70,2,1,0,2400,880,3280,46.857143
7050,Outro,77,2,2,2,2300,1218,3518,45.688313
7051,Moema,210,3,1,0,5000,5050,10050,47.857143
7052,Outro,75,3,1,1,1500,650,2150,28.666666
7053,Moema,110,3,4,2,4500,1356,5856,53.236362
7054,Móoca,63,2,2,1,1800,530,2330,36.984127
7055,Ipiranga,67,2,2,1,3400,539,3939,58.791046
7056,Santa Ifigênia,30,1,1,0,2000,523,2523,84.1
7057,Vila Mariana,66,2,2,1,2950,935,3885,58.863636
7058,Saúde,37,1,1,1,1700,576,2276,61.51351
7059,Jardim Europa,280,4,5,3,16800,1980,18780,67.07143
7060,Jabaquara,78,3,2,1,1650,881,2531,32.44872
7061,Vila Mascote,70,2,2,2,3100,795,3895,55.642857
7062,Outro,50,2,1,1,1300,500,1800,36.0
7063,Outro,50,2,1,1,1800,292,2092,41.84
7064,Outro,41,2,1,0,1100,0,1100,26.829268
7065,Jardim Paulista,165,3,4,1,5800,2045,7845,47.545456
7066,Outro,32,2,1,0,950,50,1000,31.25
7067,Vila Buarque,32,1,1,1,1400,546,1946,60.8125
7068,Moema,75,2,3,1,4700,980,5680,75.73333
7069,Jardim Paulista,100,3,3,0,4600,1795,6395,63.95
7070,Consolação,45,1,1,1,1800,622,2422,53.822224
7071,Outro,65,2,1,1,2200,290,2490,38.307693
7072,Liberdade,35,1,1,0,850,250,1100,31.428572
7073,Chácara Santo Antônio,62,2,2,1,5200,784,5984,96.51613
7074,Santa Cecília,40,1,1,1,1600,600,2200,55.0
7075,Vila Mascote,64,2,2,2,2800,575,3375,52.734375
7076,Moema,80,2,2,1,2500,950,3450,43.125
7077,Cerqueira César,135,3,3,2,8000,980,8980,66.51852
7078,Vila Mascote,69,2,1,1,1880,920,2800,40.579712
7079,Vila Andrade,46,2,2,1,1330,470,1800,39.130436
7080,Paraíso,48,1,1,1,3500,0,3500,72.916664
7081,Morumbi,70,3,2,2,2200,630,2830,40.42857
7082,Perdizes,105,2,3,2,2800,1223,4023,38.314285
7083,Vila Nova Conceição,59,1,1,0,2100,416,2516,42.64407
7084,Consolação,56,2,1,1,2800,840,3640,65.0
7085,Vila Madalena,180,3,4,3,11000,2000,13000,72.22222
7086,Outro,62,3,2,1,1750,450,2200,35.48387
7087,Brooklin,98,3,3,2,4750,1330,6080,62.040817
7088,Jaguaré,70,3,1,1,2700,500,3200,45.714287
7089,Itaim Bibi,67,2,2,1,6200,0,6200,92.537315
7090,Vila Mariana,35,1,1,1,2000,929,2929,83.685715
7091,Consolação,52,1,1,1,1800,495,2295,44.134617
7092,Outro,48,1,1,1,3350,1400,4750,98.958336
7093,Itaim Bibi,40,1,2,1,2000,620,2620,65.5
7094,Cambuci,25,1,1,0,950,0,950,38.0
7095,Vila Santa Catarina,67,2,2,1,3000,692,3692,55.104477
7096,Paraíso,83,2,1,1,2500,1240,3740,45.06024
7097,Vila Leopoldina,79,2,2,2,3600,789,4389,55.55696
7098,Pinheiros,70,1,1,0,2400,0,2400,34.285713
7099,Butantã,32,1,1,1,2800,530,3330,104.0625
7100,Vila Mariana,35,1,1,1,1490,1358,2848,81.37143
7101,Outro,68,2,1,1,3000,0,3000,44.117645
7102,Mirandópolis,30,1,1,0,2240,175,2415,80.5
7103,Campo Belo,50,1,1,0,3200,587,3787,75.74
7104,Outro,78,3,1,1,1500,706,2206,28.282051
7105,Outro,49,2,1,1,1100,350,1450,29.591837
7106,Tatuapé,28,1,1,1,1700,300,2000,71.42857
7107,Santa Cecília,81,2,3,2,3200,947,4147,51.197533
7108,Outro,65,3,2,1,1200,684,1884,28.984615
7109,Perdizes,110,2,3,3,4500,1571,6071,55.19091
7110,Outro,120,3,3,3,3600,1172,4772,39.766666
7111,Chácara Santo Antônio,50,2,1,2,3500,671,4171,83.42
7112,Vila Nova Conceição,136,3,4,2,12500,1983,14483,106.492645
7113,Outro,45,2,1,1,1600,450,2050,45.555557
7114,Moema,87,3,3,1,2500,1213,3713,42.67816
7115,Brooklin,55,1,1,1,3100,950,4050,73.63636
7116,Lapa,98,3,2,1,2000,449,2449,24.989796
7117,Itaim Bibi,60,1,2,1,5500,1000,6500,108.333336
7118,Brooklin,52,1,2,1,2000,1052,3052,58.692307
7119,Vila Nova Conceição,104,1,3,2,9900,2000,11900,114.42308
7120,Vila Olímpia,70,2,1,1,3300,580,3880,55.42857
7121,Tatuapé,89,2,4,1,2500,1550,4050,45.50562
7122,Outro,48,2,1,0,1400,425,1825,38.020832
7123,Santana,40,1,1,2,2400,600,3000,75.0
7124,Perdizes,65,1,1,1,1750,350,2100,32.307693
7125,Itaim Bibi,76,1,1,2,11000,1523,12523,164.77632
7126,Consolação,43,1,1,1,2500,450,2950,68.60465
7127,Vila Olímpia,86,2,2,1,2200,860,3060,35.581394
7128,Outro,70,3,2,1,1600,618,2218,31.685715
7129,Vila Olímpia,82,2,3,1,15000,1100,16100,196.34146
7130,Outro,68,3,1,1,2000,580,2580,37.941177
7131,Móoca,42,1,1,0,1100,40,1140,27.142857
7132,Barra Funda,54,2,2,1,2300,572,2872,53.185184
7133,Liberdade,86,2,2,1,2200,890,3090,35.930233
7134,Alto Da Boa Vista,329,4,6,3,8700,5100,13800,41.94529
7135,Brooklin,53,1,1,1,4000,900,4900,92.45283
7136,Outro,64,3,1,1,1650,440,2090,32.65625
7137,Vila Mariana,110,3,2,1,2500,1100,3600,32.727272
7138,Brooklin,78,2,2,1,2600,840,3440,44.102566
7139,Granja Julieta,138,3,5,2,7000,1100,8100,58.695652
7140,Pinheiros,86,2,2,0,2100,0,2100,24.418604
7141,Perdizes,42,1,1,1,1650,1150,2800,66.666664
7142,Brooklin,100,2,3,2,5000,2800,7800,78.0
7143,Granja Julieta,168,4,4,3,8000,1500,9500,56.54762
7144,Moema,110,2,2,1,8000,1255,9255,84.13636
7145,Bela Vista,24,1,1,0,2900,217,3117,129.875
7146,Bela Vista,50,1,1,0,1300,280,1580,31.6
7147,Vila Sônia,70,3,3,2,2500,546,3046,43.514286
7148,Itaim Bibi,162,3,3,2,6300,1796,8096,49.975307
7149,Itaim Bibi,50,1,1,1,2700,755,3455,69.1
7150,Perdizes,60,2,1,0,2500,200,2700,45.0
7151,Campo Belo,35,1,1,1,2050,650,2700,77.14286
7152,Higienópolis,30,1,1,1,2550,450,3000,100.0
7153,Itaim Bibi,60,1,1,1,6550,1583,8133,135.55
7154,Perdizes,50,1,1,1,1900,680,2580,51.6
7155,Outro,69,3,2,1,1550,700,2250,32.608696
7156,Outro,85,3,2,2,2200,894,3094,36.4
7157,Saúde,43,1,1,1,1700,503,2203,51.23256
7158,Outro,50,2,1,1,1500,430,1930,38.6
7159,Água Branca,28,1,1,0,1700,250,1950,69.64286
7160,Pinheiros,80,2,2,1,3000,857,3857,48.2125
7161,Outro,68,3,1,1,1800,450,2250,33.088234
7162,Bela Vista,40,1,1,1,2100,900,3000,75.0
7163,Vila Clementino,52,2,1,0,1700,441,2141,41.173077
7164,Moema,135,3,4,2,6000,1200,7200,53.333332
7165,Vila Olímpia,100,1,2,1,8000,1500,9500,95.0
7166,Alto da Lapa,126,3,5,3,4500,1300,5800,46.031746
7167,Vila Mariana,55,1,1,0,2000,355,2355,42.81818
7168,Brooklin,47,1,1,1,3800,650,4450,94.680855
7169,Cambuci,31,1,1,0,1200,250,1450,46.774193
7170,Saúde,37,1,1,1,1950,490,2440,65.945946
7171,Higienópolis,239,2,4,2,16050,3300,19350,80.96234
7172,Jardim América,480,3,4,2,25000,0,25000,52.083332
7173,Outro,40,2,1,0,1000,500,1500,37.5
7174,Bela Vista,63,2,1,1,3600,1143,4743,75.28571
7175,Moema,81,2,2,2,6600,613,7213,89.049385
7176,Jardim Paulista,69,1,1,1,5400,1128,6528,94.608696
7177,Itaim Bibi,80,2,2,1,3100,992,4092,51.15
7178,Aclimação,40,1,1,0,1150,400,1550,38.75
7179,Tatuapé,52,2,2,1,2600,650,3250,62.5
7180,Jardim Paulista,60,1,1,1,2500,736,3236,53.933334
7181,Morumbi,74,2,2,2,2500,1100,3600,48.648647
7182,Chácara Klabin,110,3,4,2,3750,2020,5770,52.454544
7183,Itaim Bibi,67,2,2,0,1900,1043,2943,43.925373
7184,Alto da Lapa,70,2,2,2,2500,970,3470,49.57143
7185,Vila Mascote,75,2,2,1,2200,716,2916,38.88
7186,Pinheiros,67,2,2,2,3500,1050,4550,67.910446
7187,Itaim Bibi,80,2,2,2,7431,1580,9011,112.6375
7188,Água Branca,59,2,1,0,1500,650,2150,36.440678
7189,Vila Prudente,35,1,1,0,1300,0,1300,37.142857
7190,Vila Madalena,153,3,5,3,6000,2256,8256,53.960785
7191,Outro,42,2,1,1,1100,220,1320,31.428572
7192,Santa Cecília,276,3,2,1,5500,3500,9000,32.608696
7193,Vila Madalena,35,1,1,1,3300,600,3900,111.42857
7194,Higienópolis,130,2,4,2,4200,1606,5806,44.661537
7195,Outro,65,2,2,1,4800,830,5630,86.61539
7196,Centro,61,1,2,0,1590,355,1945,31.885246
7197,Pinheiros,94,3,3,1,3500,1472,4972,52.893616
7198,Perdizes,65,1,1,0,1800,0,1800,27.692308
7199,Jardim América,85,1,2,2,7000,2200,9200,108.23529
7200,Jardim América,130,3,3,1,4000,1660,5660,43.53846
7201,Pinheiros,70,3,3,1,2700,1032,3732,53.314285
7202,Liberdade,28,1,1,0,1350,310,1660,59.285713
7203,Bela Vista,43,1,1,0,1200,373,1573,36.581394
7204,Vila Leopoldina,70,2,1,1,2900,710,3610,51.57143
7205,Pinheiros,50,1,1,1,2700,670,3370,67.4
7206,Centro,27,1,1,0,1500,340,1840,68.14815
7207,Jardim Marajoara,79,3,2,2,3500,0,3500,44.3038
7208,Campo Belo,33,1,1,1,2180,670,2850,86.36364
7209,Vila Carrão,47,2,1,1,1550,265,1815,38.61702
7210,Centro,47,2,1,1,2150,480,2630,55.957447
7211,Moema,90,2,4,2,4400,1170,5570,61.88889
7212,Vila Buarque,52,1,1,0,1500,526,2026,38.96154
7213,Pirituba,20,1,1,0,1300,0,1300,65.0
7214,Jardim Paulista,119,2,3,1,3700,1415,5115,42.983192
7215,Itaim Bibi,130,3,3,2,7500,2249,9749,74.99231
7216,Outro,57,3,1,1,2050,484,2534,44.45614
7217,Bela Vista,42,1,1,1,2500,415,2915,69.40476
7218,Pompeia,94,3,3,2,3350,1083,4433,47.159573
7219,Santo Amaro,65,2,2,1,3000,615,3615,55.615383
7220,Alto de Pinheiros,290,4,4,4,10000,4573,14573,50.251724
7221,Vila Olímpia,50,1,1,1,2695,707,3402,68.04
7222,Bela Vista,40,1,1,1,2100,516,2616,65.4
7223,Jabaquara,50,2,1,1,1000,685,1685,33.7
7224,Outro,56,3,1,1,1150,150,1300,23.214285
7225,Outro,54,1,1,2,2000,653,2653,49.12963
7226,Pinheiros,85,2,2,1,2200,1033,3233,38.035294
7227,Pinheiros,130,3,3,1,4500,1032,5532,42.553844
7228,Vila Prudente,72,2,1,1,1950,530,2480,34.444443
7229,Tatuapé,59,2,2,1,3000,465,3465,58.728813
7230,Aclimação,80,3,2,1,2500,840,3340,41.75
7231,Saúde,94,3,3,2,2800,950,3750,39.893616
7232,Outro,72,2,2,2,3200,780,3980,55.27778
7233,Pinheiros,72,2,2,1,3000,800,3800,52.77778
7234,Vila Andrade,42,1,1,1,1450,412,1862,44.333332
7235,Vila Olímpia,43,1,1,1,2600,666,3266,75.95349
7236,Moema,55,2,1,1,2200,582,2782,50.581818
7237,Pinheiros,86,2,2,1,2500,1038,3538,41.139534
7238,Vila Olímpia,35,1,1,1,2700,660,3360,96.0
7239,Moema,70,2,2,2,5000,850,5850,83.57143
7240,Perdizes,72,1,1,1,2000,590,2590,35.97222
7241,Pompeia,110,2,2,2,3800,1062,4862,44.2
7242,Pinheiros,57,1,1,1,6000,888,6888,120.8421
7243,República,37,1,1,1,1400,450,1850,50.0
7244,Paraíso,77,2,3,1,2300,1223,3523,45.753246
7245,Outro,70,3,2,2,1590,745,2335,33.357143
7246,Outro,50,2,1,1,1600,600,2200,44.0
7247,Pinheiros,148,4,4,2,4500,1570,6070,41.01351
7248,Pinheiros,50,2,1,1,2300,616,2916,58.32
7249,Itaim Bibi,167,3,2,2,7000,0,7000,41.91617
7250,Paraíso,225,3,5,4,20000,2700,22700,100.888885
7251,Higienópolis,283,3,4,1,6200,2324,8524,30.120142
7252,Outro,48,2,1,1,1600,270,1870,38.958332
7253,Vila Buarque,46,2,1,0,1000,460,1460,31.73913
7254,Vila Clementino,40,1,1,1,2750,674,3424,85.6
7255,Bela Vista,45,1,1,1,1750,602,2352,52.266666
7256,Vila Nova Conceição,85,1,2,1,11223,1400,12623,148.50589
7257,Chácara Klabin,53,2,2,2,2250,616,2866,54.07547
7258,Outro,73,3,2,2,2798,581,3379,46.28767
7259,Perdizes,120,3,2,2,4500,1450,5950,49.583332
7260,Campos Eliseos,52,1,1,1,1300,600,1900,36.53846
7261,Outro,47,2,1,1,748,252,1000,21.276596
7262,Saúde,56,2,1,1,1999,1168,3167,56.55357
7263,Alto Da Boa Vista,45,1,1,1,2200,450,2650,58.88889
7264,Consolação,174,3,2,1,5500,1700,7200,41.37931
7265,Vila Leopoldina,117,3,4,2,5400,810,6210,53.076923
7266,Vila Leopoldina,88,3,3,2,3500,990,4490,51.022728
7267,Campo Belo,130,3,4,2,2800,1310,4110,31.615385
7268,Itaim Bibi,61,1,2,1,6000,1050,7050,115.57377
7269,Campo Belo,80,2,3,2,3200,1007,4207,52.5875
7270,Outro,70,2,1,0,1790,230,2020,28.857143
7271,Vila Nova Conceição,82,2,1,1,1900,785,2685,32.743904
7272,Outro,56,2,2,1,1950,600,2550,45.535713
7273,Vila Nova Conceição,150,2,2,1,8400,1165,9565,63.766666
7274,Campo Belo,76,1,1,2,4800,1059,5859,77.0921
7275,Brooklin,73,2,3,1,4100,615,4715,64.58904
7276,Outro,51,2,1,1,900,403,1303,25.549019
7277,Pinheiros,69,2,2,1,3200,720,3920,56.811596
7278,Chácara Klabin,62,2,2,1,3700,839,4539,73.20968
7279,Vila Nova Conceição,229,4,6,3,12500,3300,15800,68.995636
7280,Alto Da Boa Vista,45,1,1,1,2000,600,2600,57.77778
7281,Jardim Paulista,47,1,1,1,2400,701,3101,65.97872
7282,Outro,32,1,1,0,1200,140,1340,41.875
7283,Santa Cecília,56,2,2,1,2100,685,2785,49.732143
7284,Cambuci,26,1,1,0,1100,180,1280,49.23077
7285,Vila Nova Conceição,70,2,2,1,2600,809,3409,48.7
7286,Vila Guarani,53,1,1,1,2499,550,3049,57.5283
7287,Bela Vista,72,2,2,2,2900,982,3882,53.916668
7288,Perdizes,40,1,1,1,1600,650,2250,56.25
7289,Barra Funda,33,1,1,1,2300,393,2693,81.606064
7290,Brás,55,2,1,1,1200,600,1800,32.727272
7291,Butantã,49,2,1,1,1150,350,1500,30.612246
7292,Outro,40,2,1,0,1750,350,2100,52.5
7293,Paraíso,105,3,2,1,5500,1250,6750,64.28571
7294,Bela Vista,32,1,1,1,1200,1000,2200,68.75
7295,Ipiranga,59,2,1,1,2000,700,2700,45.76271
7296,Outro,78,3,1,2,2500,680,3180,40.76923
7297,Cambuci,27,1,1,0,1300,150,1450,53.703705
7298,Outro,50,2,2,1,850,600,1450,29.0
7299,Pinheiros,73,2,3,2,3500,1580,5080,69.58904
7300,Jardim Paulista,44,1,1,1,2900,739,3639,82.704544
7301,Ipiranga,108,3,1,2,4500,1200,5700,52.77778
7302,Vila Nova Conceição,128,3,2,1,5300,1428,6728,52.5625
7303,Perdizes,76,3,3,3,2600,1540,4140,54.473682
7304,Higienópolis,210,3,2,2,6590,2680,9270,44.142857
7305,Pinheiros,68,2,1,1,2000,670,2670,39.264706
7306,Vila Mascote,60,2,2,1,2300,595,2895,48.25
7307,Campos Eliseos,71,1,1,0,1650,0,1650,23.239437
7308,Jaguaré,57,3,1,1,2000,560,2560,44.91228
7309,Butantã,58,2,1,1,1200,643,1843,31.775862
7310,Vila Nova Conceição,300,3,3,4,35000,4600,39600,132.0
7311,Pinheiros,90,3,2,1,2500,847,3347,37.18889
7312,Vila Olímpia,59,1,1,1,3000,903,3903,66.15254
7313,Pirituba,62,3,2,1,1650,500,2150,34.677418
7314,Pinheiros,72,3,2,1,5100,615,5715,79.375
7315,Itaim Bibi,125,3,4,2,10500,1850,12350,98.8
7316,Pinheiros,65,2,1,1,3240,730,3970,61.076923
7317,Lapa,76,2,1,0,1500,581,2081,27.381578
7318,Consolação,37,1,1,1,1950,300,2250,60.81081
7319,Outro,62,2,1,1,1700,518,2218,35.774193
7320,Vila Clementino,50,1,1,1,1600,850,2450,49.0
7321,Outro,48,1,1,1,1820,496,2316,48.25
7322,Pinheiros,47,1,1,1,7500,0,7500,159.57446
7323,Jardim Paulista,228,2,4,3,19997,4700,24697,108.320175
7324,Vila Mariana,54,2,1,1,1999,802,2801,51.87037
7325,Outro,37,1,1,1,2200,495,2695,72.83784
7326,Outro,48,2,1,1,921,600,1521,31.6875
7327,Cerqueira César,50,1,1,1,5500,0,5500,110.0
7328,República,130,3,2,0,2550,955,3505,26.961538
7329,Vila Buarque,67,2,2,1,4100,691,4791,71.50746
7330,Moema,40,1,1,1,2150,800,2950,73.75
7331,Pinheiros,84,2,2,2,8500,1200,9700,115.47619
7332,Outro,65,2,1,2,2800,950,3750,57.692307
7333,Vila Guarani,55,2,2,1,2300,560,2860,52.0
7334,Outro,130,3,4,2,3900,1300,5200,40.0
7335,Vila Mariana,40,1,1,1,1500,360,1860,46.5
7336,Água Branca,53,2,1,1,2499,389,2888,54.490566
7337,Outro,82,2,2,2,3200,830,4030,49.146343
7338,Brooklin,98,1,2,2,10000,1500,11500,117.34694
7339,Jardim Paulista,70,2,2,1,2300,392,2692,38.45714
7340,Vila Carrão,64,3,1,1,2000,519,2519,39.359375
7341,Paraíso,66,2,1,1,3500,800,4300,65.15151
7342,Aclimação,170,3,5,3,16000,2579,18579,109.28824
7343,Jardim Paulista,120,1,3,2,10120,1444,11564,96.36667
7344,Cidade Monções,53,1,1,1,4440,640,5080,95.84906
7345,Alto Da Boa Vista,230,4,2,2,5650,3000,8650,37.608696
7346,Brooklin,40,1,1,0,1750,0,1750,43.75
7347,Vila Nova Conceição,40,1,1,1,4300,600,4900,122.5
7348,Vila Uberabinha,170,3,5,3,13000,2300,15300,90.0
7349,Vila Nova Conceição,130,3,3,2,7300,2200,9500,73.07692
7350,Bela Vista,96,2,2,1,2800,800,3600,37.5
7351,Vila Olímpia,81,2,2,1,3200,920,4120,50.864197
7352,Outro,44,1,1,1,1650,545,2195,49.886364
7353,Vila Clementino,38,1,1,1,1700,576,2276,59.894737
7354,Vila Mariana,45,1,1,1,2150,648,2798,62.177776
7355,Outro,190,3,3,2,5360,681,6041,31.794737
7356,Barra Funda,35,2,1,0,1900,400,2300,65.71429
7357,Tatuapé,93,2,2,0,1500,460,1960,21.07527
7358,Outro,22,1,1,0,2400,450,2850,129.54546
7359,Higienópolis,120,3,2,1,6394,2160,8554,71.28333
7360,Saúde,48,1,1,1,1800,500,2300,47.916668
7361,Vila Mariana,58,2,2,1,2500,700,3200,55.172413
7362,Santa Cecília,63,2,2,1,2500,890,3390,53.809525
7363,Aclimação,64,1,1,1,3200,0,3200,50.0
7364,Barra Funda,33,1,1,0,1600,260,1860,56.363636
7365,Alto Da Boa Vista,45,1,1,1,2200,380,2580,57.333332
7366,Moema,150,3,4,2,3495,1900,5395,35.966667
7367,Moema,210,3,4,3,25000,0,25000,119.04762
7368,Pompeia,80,2,2,2,5000,1340,6340,79.25
7369,Vila Prudente,85,3,2,1,1600,828,2428,28.564707
7370,Outro,65,2,2,1,2700,0,2700,41.53846
7371,Perdizes,25,1,1,1,1800,483,2283,91.32
7372,Consolação,40,1,1,1,2600,479,3079,76.975
7373,Vila Leopoldina,117,4,4,2,3555,1200,4755,40.641026
7374,Vila Mariana,137,3,3,2,3500,1160,4660,34.0146
7375,Vila Buarque,37,1,1,1,1200,892,2092,56.54054
7376,Outro,62,3,1,1,1400,730,2130,34.35484
7377,Outro,44,1,1,1,1600,535,2135,48.522728
7378,Outro,56,3,1,1,2800,500,3300,58.92857
7379,Moema,54,1,1,1,2100,765,2865,53.055557
7380,Santana,60,1,2,1,3200,654,3854,64.23333
7381,Santo Amaro,67,2,2,2,3500,720,4220,62.985073
7382,Vila Madalena,128,1,1,2,6700,1200,7900,61.71875
7383,Aclimação,83,3,2,1,2200,1052,3252,39.18072
7384,Vila Mascote,42,1,1,1,2700,500,3200,76.190475
7385,Moema,55,2,2,1,2500,520,3020,54.909092
7386,Vila Mariana,72,2,3,2,3520,1150,4670,64.861115
7387,Vila Mariana,90,3,3,1,2550,1450,4000,44.444443
7388,Vila Guarani,51,2,1,1,1980,599,2579,50.568626
7389,Vila Mariana,45,1,1,0,1500,160,1660,36.88889
7390,Moema,60,1,2,1,4300,842,5142,85.7
7391,Outro,50,2,1,1,1100,700,1800,36.0
7392,Jardins,259,3,5,4,12064,4600,16664,64.33977
7393,Outro,61,3,1,1,1300,650,1950,31.967213
7394,Outro,207,4,6,3,11000,2063,13063,63.10628
7395,Outro,58,2,2,1,1600,818,2418,41.689655
7396,Outro,50,1,1,1,3500,1376,4876,97.52
7397,Centro,39,1,1,1,2000,508,2508,64.30769
7398,Vila Andrade,100,3,1,2,3490,948,4438,44.38
7399,Vila Carrão,60,2,2,1,2300,341,2641,44.016666
7400,Tatuapé,35,1,1,1,2400,380,2780,79.42857
7401,Itaim Bibi,60,1,1,1,8522,936,9458,157.63333
7402,Brooklin,178,3,5,3,12500,1498,13998,78.64045
7403,Vila Olímpia,86,3,2,2,3500,1069,4569,53.127907
7404,Pinheiros,25,1,1,1,2800,480,3280,131.2
7405,Moema,110,4,3,2,6000,1140,7140,64.90909
7406,Jardim Paulista,230,3,3,1,6900,2900,9800,42.608696
7407,Pinheiros,84,1,2,2,6200,1400,7600,90.47619
7408,Paraíso,80,2,1,2,5400,1052,6452,80.65
7409,Móoca,210,4,4,2,4800,1300,6100,29.047619
7410,Vila Olímpia,56,1,1,1,4000,900,4900,87.5
7411,Vila Gomes Cardim,35,1,1,1,2400,380,2780,79.42857
7412,Jardim Anália Franco,375,4,5,6,17000,4917,21917,58.44533
7413,Vila Mariana,60,2,2,2,2680,1096,3776,62.933334
7414,Vila Leopoldina,70,1,2,2,3750,1230,4980,71.14286
7415,Centro,37,1,1,0,1180,670,1850,50.0
7416,Outro,53,2,1,1,1600,350,1950,36.792454
7417,Brooklin,40,1,1,1,3800,770,4570,114.25
7418,Bela Vista,37,1,1,1,2250,413,2663,71.97298
7419,Vila Nova Conceição,150,4,3,2,9700,1800,11500,76.666664
7420,Jabaquara,57,2,1,2,1600,543,2143,37.596493
7421,Consolação,81,1,1,1,2000,747,2747,33.91358
7422,Vila Mascote,100,3,3,2,3000,1100,4100,41.0
7423,Santa Cecília,130,2,2,1,4000,1160,5160,39.692307
7424,Paraíso,60,1,1,0,2600,491,3091,51.516666
7425,Vila Andrade,38,1,1,1,1490,379,1869,49.18421
7426,Chácara Klabin,116,3,1,1,1950,925,2875,24.784483
7427,Vila Mariana,421,3,5,5,29000,5200,34200,81.23515
7428,Vila Andrade,150,3,4,2,5900,1129,7029,46.86
7429,Bom Retiro,28,1,1,1,1600,570,2170,77.5
7430,Itaim Bibi,100,2,2,2,13000,2149,15149,151.49
7431,Vila Nova Conceição,157,3,4,3,21000,1790,22790,145.15924
7432,Vila Clementino,127,3,5,3,6000,1660,7660,60.31496
7433,Paraíso,55,1,2,1,1700,640,2340,42.545456
7434,Bela Vista,70,2,1,1,2450,0,2450,35.0
7435,Jaguaré,70,3,2,2,2500,780,3280,46.857143
7436,Consolação,100,3,2,0,2800,680,3480,34.8
7437,Saúde,96,3,3,2,4500,0,4500,46.875
7438,Cidade Monções,70,2,2,2,4200,850,5050,72.14286
7439,Vila Madalena,57,2,2,1,2600,1056,3656,64.14035
7440,Barra Funda,33,1,1,1,2400,560,2960,89.69697
7441,Outro,207,4,7,3,10000,0,10000,48.309177
7442,Vila Olímpia,39,1,1,1,3800,702,4502,115.4359
7443,Jardim Paulista,90,2,1,1,3600,1121,4721,52.455555
7444,Moema,114,3,3,2,2500,1915,4415,38.72807
7445,Jabaquara,72,2,1,1,1750,538,2288,31.777779
7446,Liberdade,44,1,1,1,1800,476,2276,51.727272
7447,Perdizes,143,3,5,3,5000,1675,6675,46.67832
7448,Vila Formosa,38,1,1,1,1520,325,1845,48.55263
7449,Outro,43,2,1,1,1950,0,1950,45.34884
7450,Moema,117,3,5,3,4600,1379,5979,51.102566
7451,Moema,25,1,1,0,2500,460,2960,118.4
7452,Moema,130,2,1,2,2900,1463,4363,33.56154
7453,Vila Olímpia,87,3,3,2,6100,915,7015,80.63219
7454,Jardim Europa,94,2,1,1,5000,1700,6700,71.276596
7455,Pompeia,84,2,1,0,2100,390,2490,29.642857
7456,Outro,50,2,1,1,2000,0,2000,40.0
7457,Vila Madalena,77,2,2,2,4700,970,5670,73.63636
7458,Jardim Paulista,90,2,2,0,3300,646,3946,43.844444
7459,Tatuapé,57,2,1,1,1600,432,2032,35.649124
7460,Vila Clementino,110,3,3,0,1950,980,2930,26.636364
7461,Jardins,37,1,1,1,1900,1350,3250,87.83784
7462,Vila Clementino,38,1,1,1,1900,670,2570,67.63158
7463,Jardim Europa,241,4,5,2,13000,4154,17154,71.17842
7464,Vila Olímpia,100,2,2,1,2500,1150,3650,36.5
7465,Vila Cruzeiro,75,3,3,2,3500,765,4265,56.866665
7466,Pinheiros,60,2,1,0,2499,530,3029,50.483334
7467,Campo Belo,161,3,5,3,10000,1700,11700,72.67081
7468,Jardim América,300,3,4,2,30000,2900,32900,109.666664
7469,Outro,56,2,1,1,1038,162,1200,21.428572
7470,Outro,72,3,2,2,2485,565,3050,42.36111
7471,Campo Belo,45,1,1,1,1600,600,2200,48.88889
7472,Outro,44,2,1,1,1600,250,1850,42.045456
7473,Campo Belo,177,3,2,2,4000,1854,5854,33.07345
7474,Bela Vista,107,3,1,1,3400,850,4250,39.719627
7475,Moema,47,1,2,1,5200,500,5700,121.276596
7476,Bela Vista,60,2,2,1,2900,750,3650,60.833332
7477,Bela Vista,110,3,2,1,3800,764,4564,41.49091
7478,Vila Nova Conceição,192,4,7,4,25000,2950,27950,145.57292
7479,Outro,103,3,2,0,1900,0,1900,18.446602
7480,Vila Mariana,77,2,2,2,3200,950,4150,53.896103
7481,Alto de Pinheiros,65,3,2,1,2400,774,3174,48.83077
7482,Santo Amaro,78,2,2,1,1850,1100,2950,37.820515
7483,Vila Clementino,50,1,1,1,1600,764,2364,47.28
7484,Brooklin,87,2,2,1,3100,680,3780,43.448277
7485,Perdizes,68,2,2,0,3000,1500,4500,66.17647
7486,Vila Olímpia,65,2,3,1,3500,752,4252,65.41538
7487,Pinheiros,165,3,4,2,5500,1753,7253,43.957577
7488,Vila Leopoldina,93,3,2,2,4100,930,5030,54.08602
7489,Brooklin,165,2,4,3,16000,1,16001,96.97575
7490,Saúde,58,2,1,1,2000,707,2707,46.672413
7491,Moema,108,3,3,2,4200,1700,5900,54.62963
7492,Perdizes,25,1,1,1,2000,400,2400,96.0
7493,Pinheiros,30,1,1,0,3700,590,4290,143.0
7494,Outro,55,3,1,1,1400,507,1907,34.672726
7495,Morumbi,200,2,4,3,12950,3408,16358,81.79
7496,Bela Vista,54,2,1,0,4000,880,4880,90.37037
7497,Campo Belo,108,3,5,2,5000,1400,6400,59.25926
7498,Campo Belo,56,2,2,1,2900,846,3746,66.89286
7499,Higienópolis,40,1,1,1,2700,750,3450,86.25
7500,Brooklin,41,1,1,1,4000,500,4500,109.756096
7501,Brooklin,147,3,5,3,7000,1583,8583,58.387756
7502,Bela Vista,47,1,2,1,1800,550,2350,50.0
7503,Pinheiros,120,3,3,2,8000,1200,9200,76.666664
7504,Vila Nova Conceição,32,1,1,1,1884,1000,2884,90.125
7505,Aclimação,100,2,2,1,2200,770,2970,29.7
7506,Vila Olímpia,75,2,2,1,2600,845,3445,45.933334
7507,Outro,49,2,1,1,950,150,1100,22.44898
7508,Moema,85,2,2,1,4485,1170,5655,66.52941
7509,Vila Olímpia,52,1,2,1,7250,900,8150,156.73077
7510,Moema,163,2,2,2,18000,2464,20464,125.54601
7511,Chácara Santo Antônio,95,3,3,2,6200,682,6882,72.44211
7512,Ipiranga,147,3,5,2,6750,1480,8230,55.986393
7513,Outro,33,1,1,0,700,0,700,21.212122
7514,Casa Verde,498,5,5,4,21000,2164,23164,46.514057
7515,Brás,54,1,1,0,1300,130,1430,26.481482
7516,Perdizes,130,3,3,2,3500,1662,5162,39.70769
7517,Vila Clementino,42,1,2,1,2000,750,2750,65.47619
7518,Pompeia,60,3,2,1,2400,746,3146,52.433334
7519,Jaguaré,65,3,2,1,1750,587,2337,35.953846
7520,Campo Belo,68,2,2,1,3200,840,4040,59.411766
7521,Morumbi,125,4,4,2,2700,1300,4000,32.0
7522,Outro,55,1,1,2,3490,490,3980,72.36364
7523,Moema,44,1,1,1,2350,606,2956,67.181816
7524,Itaim Bibi,118,4,3,1,4200,1000,5200,44.067795
7525,Bom Retiro,90,2,2,0,1600,180,1780,19.777779
7526,Santa Cecília,75,2,1,1,2700,504,3204,42.72
7527,Outro,55,2,1,1,1800,600,2400,43.636364
7528,Pompeia,65,2,2,1,2300,850,3150,48.46154
7529,Jardim América,80,2,2,1,3000,900,3900,48.75
7530,Perdizes,80,2,1,1,2300,820,3120,39.0
7531,Pinheiros,250,4,3,4,12000,5000,17000,68.0
7532,Aclimação,75,3,3,2,2800,807,3607,48.093334
7533,Vila Nova Conceição,40,1,1,1,4400,598,4998,124.95
7534,Brooklin,178,4,3,3,9900,1483,11383,63.94944
7535,Santa Cecília,130,3,3,2,5000,1430,6430,49.46154
7536,Brooklin,111,2,4,2,5800,900,6700,60.36036
7537,Cambuci,29,1,1,0,1300,230,1530,52.75862
7538,Moema,75,2,3,1,4710,980,5690,75.86667
7539,Casa Verde,93,3,3,2,3000,645,3645,39.19355
7540,Itaim Bibi,92,2,3,2,9400,2156,11556,125.608696
7541,Moema,66,2,2,1,2500,893,3393,51.409092
7542,Campo Belo,100,3,2,2,2500,1280,3780,37.8
7543,Vila Mariana,52,2,2,1,2500,709,3209,61.71154
7544,Jardim Marajoara,57,2,2,1,1690,573,2263,39.701756
7545,Brooklin,44,1,1,1,3300,585,3885,88.295456
7546,Bela Vista,40,1,1,1,2100,405,2505,62.625
7547,Outro,52,2,1,1,1100,315,1415,27.211538
7548,Jabaquara,62,2,2,2,1400,910,2310,37.258064
7549,Água Branca,83,2,2,1,5400,800,6200,74.69879
7550,Consolação,62,2,2,2,4250,715,4965,80.08064
7551,Brooklin,37,1,1,1,2800,0,2800,75.675674
7552,Outro,40,1,1,0,1200,400,1600,40.0
7553,Jardim Paulista,120,4,3,2,4000,1650,5650,47.083332
7554,Consolação,53,1,1,1,2000,1700,3700,69.81132
7555,Vila Nova Conceição,85,2,1,1,4000,834,4834,56.870586
7556,Liberdade,50,1,1,0,1200,497,1697,33.94
7557,Itaim Bibi,70,2,1,1,3985,1700,5685,81.21429
7558,Pinheiros,139,2,2,2,10900,2268,13168,94.73381
7559,Santa Cecília,224,3,5,2,6000,2600,8600,38.392857
7560,Vila Clementino,50,1,1,1,1650,532,2182,43.64
7561,Tatuapé,337,4,6,5,35000,3500,38500,114.243324
7562,Brooklin,43,1,1,1,2100,860,2960,68.83721
7563,Bela Vista,150,3,3,1,3750,1214,4964,33.093334
7564,Vila Mariana,222,4,6,4,20000,2369,22369,100.76126
7565,Santa Cecília,50,2,2,1,1900,600,2500,50.0
7566,Itaim Bibi,85,2,2,1,4400,1044,5444,64.04706
7567,Outro,60,2,2,2,3000,914,3914,65.23333
7568,Bela Vista,40,1,1,1,1050,450,1500,37.5
7569,Vila Olímpia,78,2,2,2,2590,970,3560,45.641026
7570,Outro,89,2,2,1,5350,1183,6533,73.404495
7571,Vila Madalena,83,3,2,2,3600,1150,4750,57.228916
7572,Perdizes,67,2,2,1,3000,640,3640,54.328358
7573,Vila Romana,85,2,3,2,4800,897,5697,67.02353
7574,Bela Vista,139,3,5,2,8500,1350,9850,70.86331
7575,Outro,58,2,1,1,1250,450,1700,29.310345
7576,Jardim América,80,1,2,2,10000,1500,11500,143.75
7577,Outro,50,2,1,1,1330,420,1750,35.0
7578,Pompeia,40,1,1,1,2200,530,2730,68.25
7579,Moema,100,2,3,2,6200,850,7050,70.5
7580,Outro,60,2,1,1,1600,350,1950,32.5
7581,Perdizes,35,1,1,1,3000,650,3650,104.28571
7582,Outro,29,1,1,0,1100,50,1150,39.655174
7583,Brooklin,52,1,2,1,2200,1052,3252,62.53846
7584,Outro,63,2,1,1,1900,630,2530,40.15873
7585,Outro,126,2,1,1,1700,718,2418,19.190475
7586,Vila Mariana,50,1,2,1,2800,862,3662,73.24
7587,Cidade Monções,223,3,5,2,10500,4267,14767,66.219734
7588,Santa Ifigênia,40,1,1,1,1650,418,2068,51.7
7589,Brooklin,41,1,1,1,3700,300,4000,97.560974
7590,Perdizes,100,2,1,0,2150,0,2150,21.5
7591,Saúde,105,4,1,2,4200,700,4900,46.666668
7592,Pinheiros,68,2,1,1,2000,670,2670,39.264706
7593,Chácara Santo Antônio,79,2,3,2,6300,643,6943,87.88608
7594,Vila Clementino,43,1,1,1,2800,675,3475,80.81396
7595,Vila Nova Conceição,95,3,4,2,9500,1300,10800,113.68421
7596,Pinheiros,73,2,1,0,2500,375,2875,39.38356
7597,Itaim Bibi,117,3,3,1,4000,1968,5968,51.00855
7598,Vila Clementino,169,3,5,3,6500,1492,7992,47.28994
7599,Brooklin,166,4,5,3,11000,2300,13300,80.12048
7600,Vila Mariana,50,2,2,1,2800,845,3645,72.9
7601,Cambuci,105,3,3,2,5400,1324,6724,64.03809
7602,Sumaré,85,2,1,2,6200,1404,7604,89.458824
7603,Brooklin,172,4,5,4,9800,1900,11700,68.023254
7604,Vila Buarque,83,4,1,0,2200,320,2520,30.361446
7605,Chácara Inglesa,72,3,2,1,2200,731,2931,40.708332
7606,Vila Clementino,100,3,3,2,5600,1413,7013,70.13
7607,Pinheiros,108,3,2,1,3300,1150,4450,41.203705
7608,Consolação,130,4,4,2,5366,1750,7116,54.73846
7609,Mirandópolis,68,2,1,0,1900,670,2570,37.794117
7610,Outro,70,2,2,1,2700,1114,3814,54.485714
7611,Outro,44,2,1,1,1000,208,1208,27.454546
7612,Moema,87,3,1,2,4200,1170,5370,61.724136
7613,Outro,72,3,2,1,1400,500,1900,26.38889
7614,Vila Mascote,66,2,2,1,2000,800,2800,42.424244
7615,Vila Madalena,70,2,2,1,2700,983,3683,52.614285
7616,Vila Mariana,390,4,5,4,12000,0,12000,30.76923
7617,Bela Vista,126,3,2,1,3300,1163,4463,35.420635
7618,Itaim Bibi,65,1,2,1,6000,0,6000,92.30769
7619,Outro,42,2,1,1,1200,100,1300,30.952381
7620,Chácara Klabin,105,3,3,2,3800,1400,5200,49.52381
7621,Vila Andrade,44,2,1,0,1180,300,1480,33.636364
7622,Jardim América,120,3,3,1,7000,1900,8900,74.166664
7623,Outro,62,2,4,2,1490,571,2061,33.241936
7624,Itaim Bibi,61,2,2,0,6500,1200,7700,126.22951
7625,Perdizes,80,2,2,0,1600,478,2078,25.975
7626,Outro,60,2,1,0,2500,507,3007,50.116665
7627,Pinheiros,136,2,4,2,8000,1477,9477,69.68382
7628,Barra Funda,38,1,1,1,1600,350,1950,51.31579
7629,Mirandópolis,33,1,1,0,1500,0,1500,45.454544
7630,Vila Mascote,116,3,5,3,3300,1500,4800,41.37931
7631,Campo Belo,65,2,1,1,4900,700,5600,86.15385
7632,Pinheiros,63,2,2,1,4800,980,5780,91.74603
7633,Jaguaré,65,3,1,1,1500,530,2030,31.23077
7634,Vila Carrão,180,4,5,2,2500,1405,3905,21.694445
7635,Vila Guarani,65,3,2,1,1990,662,2652,40.8
7636,Bela Vista,43,1,1,1,3024,475,3499,81.37209
7637,Pinheiros,62,2,2,1,3000,950,3950,63.70968
7638,Consolação,120,2,2,1,2600,771,3371,28.091667
7639,Tatuapé,72,3,1,1,2840,650,3490,48.47222
7640,Bela Vista,47,2,1,1,3700,832,4532,96.42553
7641,Santa Ifigênia,30,1,1,0,1000,285,1285,42.833332
7642,Santana,41,1,1,1,2200,639,2839,69.243904
7643,Cambuci,40,1,1,0,1000,298,1298,32.45
7644,Outro,70,2,1,2,2700,970,3670,52.42857
7645,Vila Madalena,35,1,1,0,3500,400,3900,111.42857
7646,Brooklin,50,2,2,1,2500,622,3122,62.44
7647,Bela Vista,47,2,1,1,3400,900,4300,91.489365
7648,Outro,48,2,1,1,1200,0,1200,25.0
7649,Outro,63,2,1,1,1400,473,1873,29.730158
7650,Cidade Monções,70,2,2,1,6720,800,7520,107.42857
7651,Santa Cecília,116,3,3,1,5200,1,5201,44.83621
7652,Jardim América,158,3,2,1,4700,2300,7000,44.3038
7653,Pinheiros,43,1,1,1,3100,647,3747,87.139534
7654,Cidade Monções,96,3,3,2,3200,1200,4400,45.833332
7655,Vila Anastácio,71,2,2,2,3280,680,3960,55.774647
7656,Itaim Bibi,287,3,6,4,35000,5548,40548,141.28223
7657,Pinheiros,62,2,2,1,4000,830,4830,77.90323
7658,Pinheiros,57,1,1,0,1590,410,2000,35.08772
7659,Jardim Paulista,54,1,1,0,2000,532,2532,46.88889
7660,Outro,57,2,2,1,2200,472,2672,46.877193
7661,Outro,78,2,2,2,3200,625,3825,49.03846
7662,Outro,58,2,1,1,1900,650,2550,43.96552
7663,Moema,150,3,4,2,3500,1900,5400,36.0
7664,Pinheiros,86,2,2,1,3000,1000,4000,46.511627
7665,Bela Vista,33,1,1,1,1000,493,1493,45.242424
7666,Vila Nova Conceição,116,3,4,2,7200,1200,8400,72.413795
7667,Vila Olímpia,124,3,3,2,4350,1350,5700,45.967743
7668,Vila Leopoldina,88,2,3,2,3499,0,3499,39.761364
7669,Tatuapé,29,1,1,0,1490,120,1610,55.517242
7670,Tatuapé,56,2,1,1,1850,590,2440,43.57143
7671,Móoca,63,3,1,1,2500,450,2950,46.825397
7672,Ipiranga,67,2,1,1,3250,539,3789,56.55224
7673,Paraíso,100,2,2,1,2750,1090,3840,38.4
7674,Outro,65,2,1,1,1200,0,1200,18.461538
7675,Outro,48,2,1,2,900,0,900,18.75
7676,Outro,54,2,1,1,1380,625,2005,37.12963
7677,Pinheiros,78,2,3,1,3000,1233,4233,54.26923
7678,Vila Mariana,60,2,1,1,2200,978,3178,52.966667
7679,Vila Nova Conceição,85,1,2,1,11223,1400,12623,148.50589
7680,Vila Madalena,75,2,2,1,3800,1012,4812,64.16
7681,Bela Vista,50,2,2,1,2400,650,3050,61.0
7682,Vila Olímpia,97,3,3,2,9000,1172,10172,104.86598
7683,Vila Nova Conceição,85,1,2,1,11300,1400,12700,149.41176
7684,Vila Sônia,75,3,2,2,2700,915,3615,48.2
7685,Outro,96,2,1,0,1500,161,1661,17.302084
7686,Pinheiros,120,3,3,0,4000,400,4400,36.666668
7687,Pirituba,20,1,1,0,1200,0,1200,60.0
7688,Brooklin,200,2,3,3,5400,2100,7500,37.5
7689,Brooklin,50,2,2,1,2500,629,3129,62.58
7690,Vila Mariana,100,3,1,2,4500,600,5100,51.0
7691,Outro,70,2,2,1,2200,970,3170,45.285713
7692,Vila Mascote,273,4,5,3,6500,2500,9000,32.967033
7693,Outro,53,2,2,1,2000,550,2550,48.11321
7694,Jardim Marajoara,93,3,3,2,3500,772,4272,45.935482
7695,Outro,50,2,1,1,1100,277,1377,27.54
7696,Bela Vista,39,1,1,1,2600,450,3050,78.20513
7697,Ipiranga,87,2,3,1,2700,640,3340,38.390804
7698,Jardim Paulista,70,2,1,2,5000,1100,6100,87.14286
7699,Saúde,35,1,1,1,2200,492,2692,76.91428
7700,Santa Ifigênia,34,1,1,1,2350,523,2873,84.5
7701,Paraíso,50,2,1,0,2500,854,3354,67.08
7702,Vila Buarque,50,1,1,1,2200,400,2600,52.0
7703,Chácara Santo Antônio,66,1,2,2,3800,540,4340,65.757576
7704,Outro,58,2,1,1,1480,559,2039,35.155174
7705,Móoca,63,3,2,1,2500,450,2950,46.825397
7706,Pinheiros,65,2,2,2,4700,860,5560,85.53846
7707,Moema,170,3,4,3,13000,2296,15296,89.97647
7708,Vila Nova Conceição,85,1,1,1,12999,1400,14399,169.4
7709,Moema,35,1,1,1,3000,700,3700,105.71429
7710,Santana,32,1,1,1,1800,636,2436,76.125
7711,Vila Mariana,55,1,1,0,1500,600,2100,38.18182
7712,Vila Nova Conceição,157,2,3,3,18000,2627,20627,131.38217
7713,Outro,70,3,1,1,2100,500,2600,37.142857
7714,Bom Retiro,70,2,1,0,1800,210,2010,28.714285
7715,Campos Eliseos,100,3,1,1,2500,1000,3500,35.0
7716,Liberdade,40,1,1,0,1150,0,1150,28.75
7717,Higienópolis,40,1,1,1,3000,1100,4100,102.5
7718,Vila Mascote,118,3,4,2,4000,1100,5100,43.22034
7719,Jardim Anália Franco,40,1,1,1,2100,450,2550,63.75
7720,Tatuapé,52,2,1,1,2300,552,2852,54.846153
7721,Outro,44,1,1,1,1100,798,1898,43.136364
7722,Outro,57,2,2,1,4000,1020,5020,88.070175
7723,Outro,60,3,1,1,2700,490,3190,53.166668
7724,Bela Vista,80,2,1,1,4360,846,5206,65.075
7725,Freguesia do Ó,73,3,1,1,1700,450,2150,29.452055
7726,Outro,70,3,2,1,1300,897,2197,31.385714
7727,Morumbi,50,1,1,1,1300,525,1825,36.5
7728,Outro,57,2,1,1,1100,201,1301,22.824562
7729,Ipiranga,35,1,1,1,2400,560,2960,84.57143
7730,Aclimação,82,2,1,2,2700,660,3360,40.97561
7731,Vila Formosa,110,3,3,2,5000,1550,6550,59.545456
7732,Outro,67,2,2,1,2300,414,2714,40.50746
7733,Outro,117,3,4,2,5000,900,5900,50.42735
7734,Jabaquara,35,1,1,0,1550,385,1935,55.285713
7735,Bela Vista,50,2,1,0,2200,705,2905,58.1
7736,Butantã,48,2,1,1,1300,440,1740,36.25
7737,Tatuapé,58,1,1,0,1300,100,1400,24.137932
7738,Pinheiros,42,1,1,0,1700,333,2033,48.404762
7739,Moema,53,1,1,1,3600,1182,4782,90.22642
7740,Santana,55,2,1,1,3000,670,3670,66.72727
7741,Vila Nova Conceição,116,3,4,2,8000,1470,9470,81.63793
7742,Itaim Bibi,552,4,5,8,55000,11000,66000,119.565216
7743,Brooklin,98,2,3,2,8000,1550,9550,97.44898
7744,Outro,50,2,1,1,1200,331,1531,30.62
7745,Vila Mascote,55,2,1,1,1300,700,2000,36.363636
7746,Brooklin,63,2,2,1,2900,790,3690,58.57143
7747,Vila Buarque,38,1,1,1,1400,604,2004,52.736843
7748,Itaim Bibi,131,3,1,1,4985,945,5930,45.267174
7749,Outro,55,3,1,1,1500,0,1500,27.272728
7750,Outro,118,3,2,2,6000,1100,7100,60.16949
7751,Bom Retiro,58,2,1,1,2000,540,2540,43.793102
7752,Santo Amaro,33,1,1,1,3300,598,3898,118.121216
7753,Santa Cecília,105,3,3,1,2800,1455,4255,40.52381
7754,Cambuci,70,2,2,0,1450,290,1740,24.857143
7755,Brooklin,48,1,1,1,3800,700,4500,93.75
7756,Pinheiros,32,1,1,0,4000,150,4150,129.6875
7757,Aclimação,69,3,2,2,2800,720,3520,51.014492
7758,Outro,180,3,5,2,6600,1579,8179,45.43889
7759,Outro,55,2,1,1,2095,405,2500,45.454544
7760,Móoca,72,2,1,0,1400,470,1870,25.972221
7761,Vila Mariana,66,2,1,0,1350,574,1924,29.151516
7762,Brooklin,63,2,1,1,2500,800,3300,52.38095
7763,Jardim Marajoara,50,2,1,1,1600,480,2080,41.6
7764,Outro,75,2,1,2,1500,0,1500,20.0
7765,Moema,48,1,1,1,2000,720,2720,56.666668
7766,Ipiranga,170,4,5,3,7500,1380,8880,52.235294
7767,Campo Belo,60,1,2,2,2950,900,3850,64.166664
7768,Vila Clementino,65,2,2,1,1600,1050,2650,40.76923
7769,Cidade Monções,70,1,1,1,5500,994,6494,92.77143
7770,Vila Mariana,101,3,3,0,3500,1133,4633,45.87129
7771,Santa Ifigênia,50,1,1,0,1700,400,2100,42.0
7772,Pinheiros,160,4,4,3,10000,957,10957,68.48125
7773,Vila Gomes Cardim,99,3,3,2,6000,900,6900,69.69697
7774,Vila Leopoldina,73,2,3,2,2700,885,3585,49.10959
7775,Perdizes,37,1,1,1,3880,690,4570,123.51351
7776,Vila Olímpia,67,1,1,1,5500,1200,6700,100.0
7777,Bom Retiro,90,2,2,0,1550,250,1800,20.0
7778,Outro,370,4,4,4,20000,5400,25400,68.64865
7779,Vila Leopoldina,68,2,2,1,2000,880,2880,42.35294
7780,Outro,50,2,1,1,1300,400,1700,34.0
7781,Outro,110,3,3,2,2700,1200,3900,35.454544
7782,Vila Mariana,40,2,1,0,1800,130,1930,48.25
7783,Cambuci,50,2,1,0,1500,585,2085,41.7
7784,Outro,32,2,1,0,1200,190,1390,43.4375
7785,Moema,468,5,6,6,75000,8400,83400,178.20512
7786,Vila Olímpia,55,2,2,2,3430,990,4420,80.36364
7787,Jabaquara,65,2,2,1,1750,730,2480,38.153847
7788,Cidade Monções,205,4,5,3,10000,2200,12200,59.512196
7789,Moema,154,3,2,2,5500,1862,7362,47.805195
7790,Moema,42,1,1,1,2300,880,3180,75.71429
7791,Vila Olímpia,94,3,3,2,7500,1171,8671,92.24468
7792,Vila Leopoldina,50,2,1,1,2300,530,2830,56.6
7793,Itaim Bibi,40,1,1,1,1050,1860,2910,72.75
7794,Consolação,24,1,1,0,2500,260,2760,115.0
7795,Brooklin,87,3,2,0,3100,611,3711,42.655174
7796,Saúde,35,1,1,1,1800,590,2390,68.28571
7797,Móoca,125,3,2,2,2800,1080,3880,31.04
7798,Vila Cruzeiro,37,1,1,1,2350,512,2862,77.35135
7799,Moema,200,4,3,3,14000,3963,17963,89.815
7800,Outro,70,2,1,1,1600,650,2250,32.142857
7801,Barra Funda,70,2,1,0,1400,160,1560,22.285715
7802,Moema,31,1,1,1,1260,1700,2960,95.48387
7803,Outro,60,2,1,1,2000,420,2420,40.333332
7804,Outro,50,2,1,1,1000,500,1500,30.0
7805,Vila Olímpia,74,2,1,0,2500,786,3286,44.405407
7806,Bela Vista,28,1,1,1,1100,357,1457,52.035713
7807,Vila Mariana,31,1,1,1,2420,528,2948,95.09677
7808,Outro,53,2,1,0,1400,253,1653,31.188679
7809,Bela Vista,40,1,1,0,1900,0,1900,47.5
7810,Jardim Paulista,52,1,1,1,3500,467,3967,76.28846
7811,Outro,64,2,2,1,1700,700,2400,37.5
7812,Vila Olímpia,126,3,5,2,9000,1500,10500,83.333336
7813,Mirandópolis,100,3,1,0,1800,0,1800,18.0
7814,Jardim Paulista,134,3,3,1,6000,1100,7100,52.985073
7815,Cambuci,60,2,1,0,1300,300,1600,26.666666
7816,Perdizes,86,3,3,2,3500,1088,4588,53.34884
7817,Bela Vista,210,3,3,2,8000,1950,9950,47.38095
7818,Vila Mariana,47,1,2,1,3000,723,3723,79.21277
7819,Vila Mariana,51,2,1,1,1650,450,2100,41.17647
7820,Jardim Anália Franco,60,2,2,1,2300,620,2920,48.666668
7821,Vila Olímpia,45,1,1,1,2350,665,3015,67.0
7822,Outro,65,3,2,1,928,322,1250,19.23077
7823,Outro,84,3,3,2,2300,1263,3563,42.416668
7824,Vila Andrade,87,2,2,2,3450,1050,4500,51.724136
7825,Moema,46,1,1,1,2300,484,2784,60.52174
7826,Vila Olímpia,45,1,1,1,7500,0,7500,166.66667
7827,Consolação,40,1,1,0,1500,482,1982,49.55
7828,Saúde,89,2,2,1,2750,0,2750,30.898876
7829,Outro,56,2,1,1,1450,570,2020,36.07143
7830,República,44,1,1,0,1900,379,2279,51.795456
7831,Brooklin,69,2,3,1,2700,836,3536,51.246376
7832,Jaguaré,100,3,1,1,2400,620,3020,30.2
7833,Vila Mariana,45,1,1,1,1800,900,2700,60.0
7834,Outro,47,2,1,1,1100,0,1100,23.404255
7835,Outro,61,1,2,2,2700,650,3350,54.918034
7836,Alto Da Boa Vista,45,1,2,1,2100,508,2608,57.955555
7837,Bela Vista,37,1,1,1,2400,500,2900,78.37838
7838,Alto Da Boa Vista,31,1,1,1,1800,500,2300,74.19355
7839,Aclimação,63,2,2,2,2500,641,3141,49.857143
7840,Pinheiros,60,2,2,1,4300,830,5130,85.5
7841,Aclimação,45,1,1,1,1800,451,2251,50.02222
7842,Outro,35,1,1,0,1400,0,1400,40.0
7843,Pinheiros,65,2,2,1,4590,830,5420,83.38461
7844,Jardim Europa,96,1,3,2,8500,1880,10380,108.125
7845,Perdizes,50,2,1,1,1900,680,2580,51.6
7846,Alto Da Boa Vista,35,1,1,1,2000,695,2695,77.0
7847,Chácara Klabin,53,2,2,1,3500,900,4400,83.01887
7848,Santana,160,3,3,3,3500,1767,5267,32.91875
7849,Outro,60,3,2,1,1850,480,2330,38.833332
7850,Vila Nova Conceição,70,2,1,1,3300,1395,4695,67.07143
7851,Vila Mariana,84,3,2,2,2499,1260,3759,44.75
7852,Outro,57,2,2,1,2000,543,2543,44.614037
7853,Pinheiros,85,2,2,1,6700,1000,7700,90.588234
7854,Consolação,42,1,1,1,3500,800,4300,102.38095
7855,Brooklin,60,2,2,0,3300,1023,4323,72.05
7856,Vila Mariana,90,2,1,0,1800,130,1930,21.444445
7857,Granja Julieta,74,1,2,2,4500,959,5459,73.77027
7858,Jaguaré,70,3,2,2,2800,498,3298,47.114285
7859,Vila Andrade,68,3,2,1,2200,660,2860,42.058823
7860,Pinheiros,75,2,2,1,2300,941,3241,43.213333
7861,Panamby,236,4,5,3,3500,3147,6647,28.165255
7862,Vila Nova Conceição,98,2,2,1,4000,834,4834,49.32653
7863,Butantã,50,2,1,1,1450,523,1973,39.46
7864,Outro,300,4,3,3,3000,2500,5500,18.333334
7865,Moema,83,2,1,1,2500,1037,3537,42.614456
7866,Pinheiros,140,3,2,2,5000,650,5650,40.357143
7867,Higienópolis,60,2,1,0,2800,314,3114,51.9
7868,Jabaquara,37,1,1,1,1650,350,2000,54.054054
7869,Tatuapé,47,1,1,1,2100,700,2800,59.574467
7870,Brooklin,66,1,2,2,4500,1147,5647,85.56061
7871,Cerqueira César,220,4,4,3,12500,1994,14494,65.88182
7872,Perdizes,119,3,3,2,2800,1575,4375,36.764706
7873,Outro,28,1,1,0,1050,50,1100,39.285713
7874,Vila Anastácio,80,2,3,2,4600,700,5300,66.25
7875,Jabaquara,40,1,2,1,1550,461,2011,50.275
7876,Itaim Bibi,100,3,2,1,8500,600,9100,91.0
7877,Campo Belo,40,1,1,1,1700,716,2416,60.4
7878,Ipiranga,78,3,2,2,2500,736,3236,41.48718
7879,Perdizes,55,2,1,1,2200,725,2925,53.18182
7880,Sumaré,100,3,2,1,3000,915,3915,39.15
7881,Vila Mariana,123,3,3,1,3400,1100,4500,36.585365
7882,Outro,48,2,1,1,1200,0,1200,25.0
7883,Itaim Bibi,105,3,3,1,3900,1290,5190,49.42857
7884,Jaguaré,80,3,1,1,1400,550,1950,24.375
7885,Outro,65,2,2,2,4900,1100,6000,92.30769
7886,Brooklin,135,4,3,2,4550,1846,6396,47.377777
7887,Ipiranga,72,2,1,0,1600,140,1740,24.166666
7888,Chácara Santo Antônio,189,3,5,3,15000,1550,16550,87.56614
7889,Centro,52,2,2,1,2400,830,3230,62.115383
7890,Chácara Santo Antônio,243,4,4,4,14000,2350,16350,67.28395
7891,Jardim América,170,3,3,2,7300,1215,8515,50.088234
7892,Alto da Lapa,128,4,5,2,5100,1280,6380,49.84375
7893,Outro,48,2,1,1,1900,300,2200,45.833332
7894,Móoca,51,1,2,1,1800,1070,2870,56.27451
7895,Cerqueira César,51,1,2,1,3800,1000,4800,94.117645
7896,Outro,57,3,1,1,2000,0,2000,35.08772
7897,Jardim Marajoara,50,2,1,1,1500,560,2060,41.2
7898,Vila Leopoldina,60,2,2,1,2600,754,3354,55.9
7899,Outro,55,1,1,1,3340,550,3890,70.72727
7900,Vila Sônia,105,2,3,2,3100,1600,4700,44.761906
7901,Vila Andrade,54,2,1,2,1300,844,2144,39.703705
7902,Pinheiros,120,3,2,2,4000,1133,5133,42.775
7903,Brooklin,113,3,2,2,3295,970,4265,37.743362
7904,Outro,257,4,4,3,13000,0,13000,50.583656
7905,Campos Eliseos,27,1,1,0,650,550,1200,44.444443
7906,Itaim Bibi,140,3,4,1,12000,1890,13890,99.21429
7907,Moema,54,1,1,1,2100,765,2865,53.055557
7908,Vila Madalena,141,3,4,3,8000,1870,9870,70.0
7909,Móoca,74,2,2,2,3200,800,4000,54.054054
7910,Moema,135,3,3,2,6300,1950,8250,61.11111
7911,Vila Mariana,60,2,1,0,1700,374,2074,34.566666
7912,Consolação,52,1,1,1,2850,370,3220,61.923077
7913,Moema,48,1,1,1,3200,700,3900,81.25
7914,Paraíso,88,3,2,2,3600,1200,4800,54.545456
7915,Brooklin,57,2,2,2,2800,1040,3840,67.36842
7916,Moema,116,3,5,2,8100,1300,9400,81.034485
7917,Vila Clementino,54,1,1,1,1700,780,2480,45.925926
7918,Moema,110,3,2,2,4000,1522,5522,50.2
7919,Morumbi,125,3,4,2,4900,1100,6000,48.0
7920,Moema,55,2,1,1,1600,750,2350,42.727272
7921,Outro,73,2,1,1,4500,1120,5620,76.9863
7922,Chácara Klabin,132,3,5,4,5000,974,5974,45.257576
7923,Cidade Monções,53,1,1,1,3500,880,4380,82.64151
7924,Outro,55,2,1,1,1300,500,1800,32.727272
7925,Chácara Santo Antônio,70,2,2,2,4500,852,5352,76.457146
7926,Bela Vista,35,1,1,0,850,464,1314,37.54286
7927,Brooklin,90,3,2,2,3300,980,4280,47.555557
7928,Jardim Paulista,96,2,1,1,3950,1600,5550,57.8125
7929,Vila Nova Conceição,128,3,3,2,8000,1346,9346,73.015625
7930,Santa Cecília,38,1,1,1,1900,525,2425,63.81579
7931,Outro,61,2,1,1,1344,544,1888,30.950819
7932,Jardim Europa,250,4,6,2,15900,5020,20920,83.68
7933,Vila Romana,60,2,1,1,1650,430,2080,34.666668
7934,Cidade Monções,170,2,4,2,16000,2000,18000,105.882355
7935,Vila Madalena,91,2,2,2,5932,1430,7362,80.9011
7936,Vila Andrade,56,2,2,1,2400,285,2685,47.94643
7937,Pinheiros,58,1,2,1,2700,689,3389,58.431034
7938,Outro,56,2,1,1,1500,530,2030,36.25
7939,Itaim Bibi,150,2,4,1,10500,0,10500,70.0
7940,Brooklin,43,1,1,1,4100,769,4869,113.23256
7941,Itaim Bibi,60,1,1,1,4590,950,5540,92.333336
7942,Itaim Bibi,98,2,3,1,5500,1174,6674,68.10204
7943,Bela Vista,62,2,2,1,2600,1046,3646,58.80645
7944,Vila Cruzeiro,40,1,1,1,2100,511,2611,65.275
7945,Bom Retiro,75,2,1,0,1100,400,1500,20.0
7946,Chácara Klabin,67,3,3,1,3200,820,4020,60.0
7947,Outro,20,1,1,0,925,0,925,46.25
7948,Outro,40,2,1,0,800,65,865,21.625
7949,Chácara Santo Antônio,143,2,4,2,10500,1150,11650,81.46853
7950,Moema,464,4,8,6,60000,7410,67410,145.28017
7951,Vila Mariana,56,2,2,1,2490,1000,3490,62.32143
7952,Aclimação,86,2,3,1,2300,1100,3400,39.534885
7953,Vila Leopoldina,299,4,5,4,6500,3100,9600,32.107025
7954,Outro,37,1,1,1,1700,576,2276,61.51351
7955,Paraíso,60,2,1,0,1600,569,2169,36.15
7956,Higienópolis,79,2,2,1,3300,900,4200,53.16456
7957,Outro,55,2,1,1,1300,710,2010,36.545456
7958,Itaim Bibi,92,2,2,2,12000,1400,13400,145.65218
7959,Consolação,60,2,2,2,4000,800,4800,80.0
7960,Itaim Bibi,62,1,1,1,10416,1272,11688,188.51613
7961,Vila Cruzeiro,38,1,1,1,2600,580,3180,83.68421
7962,Moema,74,2,2,1,3000,800,3800,51.351353
7963,Jardins,27,1,1,1,810,1810,2620,97.03704
7964,Pirituba,47,2,1,0,1700,0,1700,36.17021
7965,Brooklin,45,1,1,1,3000,585,3585,79.666664
7966,Alto da Lapa,65,2,2,1,2000,860,2860,44.0
7967,Vila Clementino,60,2,1,0,1400,991,2391,39.85
7968,Ipiranga,80,3,3,2,2500,936,3436,42.95
7969,Vila Olímpia,54,2,1,1,3900,660,4560,84.44444
7970,Vila Prudente,33,1,1,0,1800,480,2280,69.09091
7971,Moema,65,2,2,1,2000,790,2790,42.923077
7972,Butantã,70,3,1,1,1700,780,2480,35.42857
7973,Itaim Bibi,32,1,1,1,2800,0,2800,87.5
7974,Pinheiros,85,2,1,2,5807,1651,7458,87.74117
7975,Brooklin,70,2,2,1,4000,900,4900,70.0
7976,Vila Nova Conceição,70,1,2,2,8700,1050,9750,139.28572
7977,Campo Belo,73,2,2,1,2800,793,3593,49.219177
7978,Brás,105,2,2,0,1600,500,2100,20.0
7979,Vila Clementino,43,1,1,1,2000,700,2700,62.7907
7980,Campo Belo,161,3,5,3,11000,2400,13400,83.22981
7981,Outro,86,2,2,2,1650,988,2638,30.67442
7982,Bela Vista,42,1,1,1,2100,740,2840,67.61905
7983,Santa Cecília,40,1,1,0,1400,430,1830,45.75
7984,Outro,200,4,6,4,8000,3200,11200,56.0
7985,Tatuapé,118,3,2,3,2500,1761,4261,36.11017
7986,Outro,50,2,1,1,1200,400,1600,32.0
7987,Bela Vista,22,1,1,0,2999,217,3216,146.18182
7988,Pinheiros,175,4,4,2,5000,2400,7400,42.285713
7989,Vila Andrade,89,3,3,2,1900,750,2650,29.77528
7990,Cerqueira César,60,2,1,1,2800,723,3523,58.716667
7991,Vila Mariana,50,2,1,1,2700,674,3374,67.48
7992,Itaim Bibi,230,4,6,4,10000,3430,13430,58.391304
7993,Campo Belo,180,4,4,3,10600,2289,12889,71.60555
7994,Cambuci,85,2,3,1,1300,1226,2526,29.717648
7995,Outro,75,2,2,1,3500,960,4460,59.466667
7996,Vila Mariana,55,2,1,1,1800,802,2602,47.30909
7997,Tatuapé,35,1,1,1,2200,380,2580,73.71429
7998,Moema,420,4,6,4,14170,6180,20350,48.45238
7999,Centro,36,1,1,1,1700,380,2080,57.77778
8000,Moema,56,1,1,1,4300,845,5145,91.875
8001,Outro,162,3,5,4,2500,2200,4700,29.012346
8002,Ipiranga,32,1,1,1,1600,437,2037,63.65625
8003,Vila Olímpia,100,3,3,1,3750,970,4720,47.2
8004,Campo Belo,83,2,3,2,4500,698,5198,62.626507
8005,Vila Olímpia,60,2,1,1,2400,871,3271,54.516666
8006,Pinheiros,55,2,1,1,2500,690,3190,58.0
8007,Jardim Paulista,406,4,5,3,25000,5055,30055,74.02709
8008,Jardim Paulista,45,1,1,1,2500,750,3250,72.22222
8009,Tatuapé,37,1,1,1,2500,370,2870,77.567566
8010,Pompeia,72,2,2,2,2300,845,3145,43.680557
8011,Outro,60,2,2,1,1277,1200,2477,41.283333
8012,Pinheiros,38,1,1,1,3900,900,4800,126.31579
8013,Vila Leopoldina,114,3,3,2,4800,871,5671,49.745613
8014,Brooklin,63,2,2,1,3300,700,4000,63.49206
8015,Outro,161,3,3,3,7000,2062,9062,56.285713
8016,Cidade Monções,180,2,5,2,17315,1912,19227,106.816666
8017,Outro,74,2,2,2,3100,770,3870,52.2973
8018,Outro,48,1,2,1,2200,600,2800,58.333332
8019,Santa Cecília,42,1,1,1,1800,590,2390,56.904762
8020,Vila Madalena,42,1,1,1,2300,980,3280,78.09524
8021,Santo Amaro,130,3,2,2,4500,1100,5600,43.076923
8022,Jardim América,143,2,2,2,13000,2405,15405,107.72727
8023,Jardins,100,3,2,1,2800,1084,3884,38.84
8024,Outro,60,2,1,1,1200,250,1450,24.166666
8025,Outro,56,2,1,1,1500,0,1500,26.785715
8026,Perdizes,65,2,2,2,2800,850,3650,56.153847
8027,Granja Julieta,68,2,2,2,4800,750,5550,81.617645
8028,Brooklin,75,2,2,2,6900,1200,8100,108.0
8029,Jardim Paulista,65,2,2,2,2800,1035,3835,59.0
8030,Jardim Paulista,228,3,5,4,13000,4540,17540,76.929825
8031,Cambuci,39,1,1,1,2260,530,2790,71.53846
8032,Móoca,45,2,1,1,1800,340,2140,47.555557
8033,Pinheiros,58,1,1,1,4000,770,4770,82.24138
8034,Vila Mascote,130,3,5,2,3800,1450,5250,40.384617
8035,Saúde,90,3,1,2,2000,345,2345,26.055555
8036,Moema,56,1,1,1,2300,437,2737,48.875
8037,Outro,71,3,1,1,1100,360,1460,20.563381
8038,Brooklin,132,3,5,2,12000,700,12700,96.21212
8039,Santa Ifigênia,46,1,1,1,2700,390,3090,67.17391
8040,Butantã,77,2,2,1,2400,600,3000,38.96104
8041,Brooklin,67,2,1,1,4200,995,5195,77.537315
8042,Jardins,47,1,1,1,2200,810,3010,64.04256
8043,Liberdade,35,1,1,0,1150,349,1499,42.82857
8044,Outro,90,2,1,1,1600,0,1600,17.777779
8045,Santa Cecília,220,3,3,2,7900,2300,10200,46.363636
8046,Outro,75,3,2,0,1159,687,1846,24.613333
8047,Consolação,29,1,1,0,2900,340,3240,111.72414
8048,Jardim América,90,2,2,1,3600,1185,4785,53.166668
8049,Itaim Bibi,223,3,5,4,26000,3100,29100,130.49327
8050,Tatuapé,90,3,2,1,2400,980,3380,37.555557
8051,Itaim Bibi,90,2,3,1,4290,765,5055,56.166668
8052,Paraíso,100,3,1,2,3500,1550,5050,50.5
8053,Vila Olímpia,120,2,3,1,4000,1050,5050,42.083332
8054,Vila Romana,45,1,1,1,1800,536,2336,51.91111
8055,Chácara Santo Antônio,104,3,4,2,3900,980,4880,46.923077
8056,Alto Da Boa Vista,185,3,4,2,11000,2200,13200,71.35135
8057,Outro,103,3,4,2,3300,1190,4490,43.59223
8058,Tatuapé,65,2,1,1,2150,600,2750,42.307693
8059,Pompeia,72,3,2,2,3100,799,3899,54.15278
8060,Água Branca,72,2,2,2,3000,850,3850,53.47222
8061,Ipiranga,63,2,2,1,2000,500,2500,39.68254
8062,Santana,50,1,1,1,1150,560,1710,34.2
8063,Pinheiros,120,2,4,2,2500,2315,4815,40.125
8064,Outro,47,1,1,1,1650,240,1890,40.212765
8065,Vila Guarani,88,3,3,2,2700,674,3374,38.340908
8066,Barra Funda,50,2,1,1,1200,1000,2200,44.0
8067,Pinheiros,65,1,1,0,1550,450,2000,30.76923
8068,Moema,210,4,5,4,5000,3000,8000,38.095238
8069,Pinheiros,350,3,3,2,15000,5672,20672,59.06286
8070,Móoca,70,2,1,1,2300,0,2300,32.857143
8071,Brooklin,94,3,4,2,4900,1300,6200,65.95744
8072,Itaim Bibi,170,3,3,3,7300,1750,9050,53.235294
8073,Vila Madalena,68,2,2,1,2300,680,2980,43.82353
8074,Pompeia,128,3,4,2,7300,1200,8500,66.40625
8075,Outro,160,3,1,4,6500,1873,8373,52.33125
8076,Outro,70,3,2,1,1300,720,2020,28.857143
8077,Vila Guarani,92,3,2,2,4800,691,5491,59.684784
8078,Campos Eliseos,38,1,1,1,1800,500,2300,60.526318
8079,Vila Nova Conceição,234,3,5,3,22000,3067,25067,107.12393
8080,Bela Vista,26,1,1,0,1250,376,1626,62.53846
8081,Tatuapé,57,2,2,1,2200,339,2539,44.54386
8082,Santa Ifigênia,78,2,2,0,1700,582,2282,29.25641
8083,Bela Vista,70,1,2,0,2600,400,3000,42.857143
8084,Vila Mascote,63,2,2,1,2500,702,3202,50.825397
8085,Campo Belo,89,2,2,2,4700,525,5225,58.707867
8086,Outro,68,2,2,1,1800,860,2660,39.117645
8087,Consolação,64,2,2,1,4200,700,4900,76.5625
8088,Consolação,38,1,1,1,1400,1200,2600,68.42105
8089,Vila Madalena,90,2,2,0,2000,530,2530,28.11111
8090,Outro,40,1,1,0,1000,0,1000,25.0
8091,Pinheiros,62,1,1,1,2850,700,3550,57.258064
8092,Jardim América,125,3,5,1,4000,1800,5800,46.4
8093,Vila Uberabinha,55,2,1,1,2400,877,3277,59.581818
8094,Campos Eliseos,60,2,1,1,1900,923,2823,47.05
8095,Santa Ifigênia,44,1,1,1,2750,624,3374,76.681816
8096,Vila Mariana,70,3,1,0,2500,0,2500,35.714287
8097,Outro,60,2,1,1,1500,490,1990,33.166668
8098,Vila Clementino,45,1,1,1,2000,420,2420,53.77778
8099,Jardim Paulista,385,4,6,6,40000,8444,48444,125.828575
8100,Higienópolis,66,2,1,1,3000,970,3970,60.151516
8101,Outro,30,1,1,0,1350,150,1500,50.0
8102,Outro,62,2,2,2,1390,649,2039,32.887096
8103,Chácara Santo Antônio,64,2,2,2,3800,650,4450,69.53125
8104,Tatuapé,60,2,1,1,2600,650,3250,54.166668
8105,Vila Madalena,35,1,1,1,3000,505,3505,100.14286
8106,Aclimação,176,4,5,3,7500,1350,8850,50.284092
8107,Pinheiros,49,1,1,0,1700,300,2000,40.816326
8108,Jardins,178,3,4,1,12300,2300,14600,82.02247
8109,Chácara Santo Antônio,60,2,2,1,3170,630,3800,63.333332
8110,Brooklin,105,2,3,2,9000,1100,10100,96.190475
8111,Cerqueira César,151,2,3,3,14000,3000,17000,112.58278
8112,Outro,54,2,1,0,900,310,1210,22.407408
8113,Vila Mascote,65,3,2,1,2500,640,3140,48.307693
8114,Jabaquara,49,2,1,1,1300,700,2000,40.816326
8115,Itaim Bibi,44,1,1,1,3200,790,3990,90.681816
8116,Pinheiros,80,2,2,1,2700,625,3325,41.5625
8117,Brooklin,96,2,3,3,8250,1420,9670,100.729164
8118,Outro,82,3,3,2,2200,450,2650,32.317074
8119,Campo Belo,110,3,3,1,2800,1133,3933,35.754547
8120,Jardim Paulista,354,4,5,3,25000,3000,28000,79.09605
8121,Campo Belo,108,3,5,2,5000,820,5820,53.88889
8122,Vila Olímpia,52,1,1,1,3450,1150,4600,88.46154
8123,Jardim Paulista,45,1,1,1,2200,670,2870,63.77778
8124,Vila Leopoldina,96,3,4,2,3600,1074,4674,48.6875
8125,Jabaquara,55,2,1,1,1650,550,2200,40.0
8126,Brooklin,69,2,2,1,5500,890,6390,92.608696
8127,Moema,154,4,4,2,8000,2700,10700,69.48052
8128,Pompeia,41,1,1,1,2100,594,2694,65.70731
8129,Casa Verde,60,2,1,1,1600,658,2258,37.633335
8130,Pompeia,48,2,2,1,2500,600,3100,64.583336
8131,Outro,70,3,1,1,1500,445,1945,27.785715
8132,Vila Sônia,50,1,1,1,2000,550,2550,51.0
8133,Vila Nova Conceição,39,1,1,1,2125,1042,3167,81.20513
8134,Vila Mariana,39,2,1,1,1650,600,2250,57.692307
8135,Vila Andrade,51,2,1,1,2750,380,3130,61.372547
8136,Água Branca,105,3,1,1,2600,990,3590,34.190475
8137,Vila Madalena,83,1,2,2,3600,1150,4750,57.228916
8138,Pinheiros,100,2,2,0,3000,360,3360,33.6
8139,Campo Belo,41,1,1,1,3200,850,4050,98.78049
8140,Itaim Bibi,50,1,1,1,3500,815,4315,86.3
8141,Jardim Paulista,74,2,2,2,4450,1400,5850,79.054054
8142,Outro,73,2,1,1,4500,710,5210,71.369865
8143,Moema,114,3,4,2,6500,1100,7600,66.666664
8144,Bom Retiro,112,3,1,0,2700,0,2700,24.107143
8145,Brooklin,119,3,2,3,7000,1550,8550,71.84874
8146,Itaim Bibi,70,1,2,1,5000,1200,6200,88.57143
8147,Jardins,60,2,2,1,2500,819,3319,55.316666
8148,Moema,122,3,3,2,3000,1936,4936,40.459015
8149,Saúde,60,2,2,1,1700,550,2250,37.5
8150,Campo Belo,58,2,1,1,2400,760,3160,54.482758
8151,Outro,236,2,3,4,31000,4500,35500,150.42372
8152,Jardim Paulista,60,1,2,1,2100,613,2713,45.216667
8153,Vila Olímpia,52,1,1,1,3500,780,4280,82.30769
8154,Brooklin,146,3,3,2,9000,1350,10350,70.89041
8155,Moema,210,3,5,3,16000,2800,18800,89.52381
8156,Móoca,64,3,2,1,2500,428,2928,45.75
8157,Vila Nova Conceição,134,2,2,2,15000,2200,17200,128.35822
8158,Vila Mascote,147,3,3,2,5100,1150,6250,42.517006
8159,Outro,51,2,1,1,1464,401,1865,36.568626
8160,Vila Nova Conceição,76,1,2,2,8900,1050,9950,130.92105
8161,Brooklin,50,2,2,1,2800,548,3348,66.96
8162,Pinheiros,60,2,1,0,2300,501,2801,46.683334
8163,Móoca,67,2,2,1,1300,860,2160,32.238808
8164,Vila Nova Conceição,104,1,2,2,11500,1400,12900,124.03846
8165,Outro,62,2,1,1,1468,626,2094,33.774193
8166,Lapa,53,2,1,1,2200,400,2600,49.056602
8167,Outro,48,2,1,1,1900,453,2353,49.020832
8168,Itaim Bibi,357,3,4,5,60000,6000,66000,184.87395
8169,Outro,55,1,1,0,899,0,899,16.345455
8170,Pinheiros,60,2,1,0,2000,485,2485,41.416668
8171,Outro,69,3,2,1,1450,600,2050,29.710144
8172,Campo Belo,32,1,1,1,800,1400,2200,68.75
8173,Itaim Bibi,90,2,3,1,3500,965,4465,49.61111
8174,Moema,46,1,2,1,2750,600,3350,72.82609
8175,Outro,55,1,1,0,1100,1,1101,20.018183
8176,Chácara Santo Antônio,135,4,4,2,6800,805,7605,56.333332
8177,Alto Da Boa Vista,170,3,4,2,4500,1773,6273,36.9
8178,Vila Clementino,128,3,4,2,5000,1500,6500,50.78125
8179,Outro,75,2,1,0,1800,160,1960,26.133333
8180,Outro,55,2,1,1,1300,612,1912,34.763638
8181,Outro,362,4,4,4,6500,3200,9700,26.79558
8182,Outro,64,2,2,1,2200,897,3097,48.390625
8183,Santana,85,2,1,0,1300,160,1460,17.17647
8184,Jardins,32,1,1,0,2000,150,2150,67.1875
8185,Vila Mariana,51,1,1,1,2300,439,2739,53.705883
8186,Vila Formosa,106,3,1,2,2800,850,3650,34.433964
8187,Campo Belo,180,3,4,3,16000,1500,17500,97.22222
8188,Pinheiros,90,2,2,2,6600,1290,7890,87.666664
8189,Pompeia,38,1,1,1,1900,450,2350,61.842106
8190,Vila Olímpia,89,3,2,2,6170,914,7084,79.595505
8191,Moema,44,1,1,1,4800,732,5532,125.72727
8192,Vila Cruzeiro,209,3,5,4,12000,1700,13700,65.55024
8193,Barra Funda,126,3,3,2,5850,1300,7150,56.746033
8194,Brooklin,93,2,2,1,2800,780,3580,38.494625
8195,Moema,46,1,1,1,2100,980,3080,66.95652
8196,Chácara Klabin,78,2,1,1,1850,485,2335,29.935898
8197,Vila Mariana,55,1,1,2,4500,869,5369,97.61818
8198,Bela Vista,40,1,1,0,1500,700,2200,55.0
8199,República,26,1,1,0,1050,265,1315,50.576923
8200,Outro,238,4,6,4,9000,1535,10535,44.264706
8201,Vila Madalena,62,2,2,2,2300,1498,3798,61.258064
8202,Cidade Monções,54,2,2,1,2100,731,2831,52.425926
8203,Outro,58,2,1,2,1700,770,2470,42.58621
8204,Vila Sônia,53,2,1,1,1800,535,2335,44.056602
8205,Vila Olímpia,45,1,1,1,2800,650,3450,76.666664
8206,Água Branca,47,2,1,1,1800,340,2140,45.531914
8207,Perdizes,106,3,2,1,2600,1032,3632,34.264153
8208,Jardim Prudência,57,2,2,1,2400,580,2980,52.2807
8209,Pinheiros,60,2,1,0,2000,485,2485,41.416668
8210,Vila Olímpia,60,2,1,1,2500,874,3374,56.233334
8211,Outro,80,3,2,0,1500,0,1500,18.75
8212,Outro,50,1,2,0,1550,350,1900,38.0
8213,Outro,58,2,1,1,1380,598,1978,34.103447
8214,Moema,45,1,1,1,2100,765,2865,63.666668
8215,Outro,32,2,1,0,1200,187,1387,43.34375
8216,Outro,65,2,1,1,1500,774,2274,34.984615
8217,Vila Andrade,220,4,6,4,5000,2900,7900,35.909092
8218,Vila Mariana,84,1,2,1,3300,522,3822,45.5
8219,Brooklin,50,1,1,1,3855,820,4675,93.5
8220,Móoca,55,2,2,1,3000,500,3500,63.636364
8221,Indianópolis,42,1,1,1,4000,1200,5200,123.809525
8222,Tatuapé,65,3,2,2,2200,672,2872,44.184616
8223,Santo Amaro,72,2,2,1,3900,684,4584,63.666668
8224,Outro,40,2,1,1,1500,0,1500,37.5
8225,Chácara Santo Antônio,80,2,1,0,1890,300,2190,27.375
8226,Barra Funda,126,3,3,1,5800,1200,7000,55.555557
8227,Morumbi,145,4,4,2,2900,1201,4101,28.282759
8228,Itaim Bibi,137,3,3,1,4500,1361,5861,42.78102
8229,Jardim Paulista,50,1,2,1,3200,1045,4245,84.9
8230,Perdizes,55,2,1,2,2700,1010,3710,67.454544
8231,Vila Formosa,55,2,1,1,1900,426,2326,42.29091
8232,Vila Mascote,53,1,2,1,3500,420,3920,73.962265
8233,Pinheiros,127,3,3,2,4890,1250,6140,48.34646
8234,Higienópolis,127,3,2,1,4000,1400,5400,42.519684
8235,Vila Leopoldina,35,2,1,0,2000,305,2305,65.85714
8236,Pinheiros,113,3,2,1,3700,1192,4892,43.292034
8237,Vila Andrade,170,3,5,5,5500,1100,6600,38.82353
8238,Santo Amaro,130,3,4,3,4400,1329,5729,44.06923
8239,Jardim Marajoara,45,2,1,1,2200,0,2200,48.88889
8240,Outro,68,2,1,1,1800,950,2750,40.441177
8241,Outro,40,2,1,1,1500,0,1500,37.5
8242,Moema,112,3,3,2,3300,1337,4637,41.401787
8243,Jardim Paulista,33,1,1,1,800,2110,2910,88.181816
8244,Moema,26,1,1,1,2500,539,3039,116.88461
8245,Higienópolis,36,1,1,1,1500,551,2051,56.97222
8246,Santana,100,3,2,1,3300,900,4200,42.0
8247,Pinheiros,332,3,6,4,30000,3833,33833,101.906624
8248,Outro,74,2,2,1,1000,700,1700,22.972973
8249,Morumbi,100,2,3,2,2500,2046,4546,45.46
8250,Jardim Paulista,121,2,3,2,6300,1200,7500,61.98347
8251,Bela Vista,45,1,1,1,1500,578,2078,46.177776
8252,Cambuci,80,3,3,2,2600,1190,3790,47.375
8253,Pinheiros,70,2,1,1,4500,800,5300,75.71429
8254,Outro,50,2,2,1,1950,500,2450,49.0
8255,Bela Vista,110,2,2,1,3100,1300,4400,40.0
8256,Vila Uberabinha,90,3,2,1,4000,905,4905,54.5
8257,Bela Vista,58,1,1,0,2200,595,2795,48.189655
8258,Itaim Bibi,247,4,6,3,14000,3850,17850,72.267204
8259,Moema,70,2,3,1,4620,780,5400,77.14286
8260,Consolação,25,1,1,1,1300,605,1905,76.2
8261,Outro,50,2,1,1,2000,500,2500,50.0
8262,Campo Belo,62,1,2,2,4000,0,4000,64.51613
8263,Vila Leopoldina,60,2,2,2,3400,0,3400,56.666668
8264,Perdizes,115,3,3,2,3600,1600,5200,45.217392
8265,Brooklin,147,3,5,3,7000,1573,8573,58.31973
8266,Cambuci,70,1,1,0,1750,161,1911,27.3
8267,Outro,40,2,1,0,1200,165,1365,34.125
8268,Brooklin,40,1,1,1,1500,834,2334,58.35
8269,Freguesia do Ó,47,2,1,1,1100,570,1670,35.531914
8270,Pinheiros,39,1,1,1,3550,490,4040,103.589745
8271,Outro,73,2,2,1,1600,1100,2700,36.9863
8272,Moema,70,2,3,2,3900,909,4809,68.7
8273,Itaim Bibi,118,2,3,2,7000,1342,8342,70.694916
8274,Cerqueira César,136,3,3,1,4000,1300,5300,38.97059
8275,Jardim América,120,2,3,1,5500,1895,7395,61.625
8276,Indianópolis,121,3,5,3,7000,1958,8958,74.03306
8277,Cidade Monções,80,2,2,1,2050,770,2820,35.25
8278,Indianópolis,50,1,1,1,4500,871,5371,107.42
8279,Liberdade,75,2,1,0,1300,406,1706,22.746666
8280,Campo Belo,75,3,2,2,3500,1080,4580,61.066666
8281,Vila Uberabinha,245,4,3,4,24000,3944,27944,114.057144
8282,Higienópolis,80,3,2,0,2600,400,3000,37.5
8283,Pinheiros,75,2,2,1,2500,425,2925,39.0
8284,Brooklin,47,1,1,1,1800,695,2495,53.085106
8285,Morumbi,46,1,1,1,1690,960,2650,57.608696
8286,Pinheiros,57,1,2,0,4000,750,4750,83.333336
8287,Vila Leopoldina,83,3,3,2,3300,950,4250,51.20482
8288,Jardim Europa,250,4,3,3,15000,5760,20760,83.04
8289,Paraíso,101,3,3,1,3799,1254,5053,50.0297
8290,Jardins,70,2,3,1,3900,642,4542,64.88571
8291,Vila Anastácio,69,2,1,1,3000,800,3800,55.072464
8292,Vila Formosa,56,2,1,1,1500,400,1900,33.92857
8293,Aclimação,91,3,1,3,3300,820,4120,45.274727
8294,Liberdade,35,1,1,1,1300,300,1600,45.714287
8295,Pinheiros,80,2,2,1,2600,868,3468,43.35
8296,Mirandópolis,27,1,1,0,1500,380,1880,69.62963
8297,Saúde,65,2,1,0,2401,600,3001,46.16923
8298,Campo Belo,180,2,3,3,18400,1800,20200,112.22222
8299,Outro,40,2,1,0,1600,220,1820,45.5
8300,Paraíso,130,3,3,1,3200,1155,4355,33.5
8301,Itaim Bibi,97,3,2,2,5900,1290,7190,74.12371
8302,Aclimação,89,3,3,1,3000,840,3840,43.14607
8303,Vila Clementino,40,1,1,1,1800,568,2368,59.2
8304,Outro,68,2,1,1,1300,369,1669,24.544117
8305,Vila Nova Conceição,50,1,2,2,3639,1400,5039,100.78
8306,Outro,88,2,2,0,3200,1220,4420,50.227272
8307,Brooklin,148,3,2,2,4500,1450,5950,40.2027
8308,Chácara Santo Antônio,102,3,3,2,4800,980,5780,56.666668
8309,Alto de Pinheiros,208,3,4,3,15000,2250,17250,82.93269
8310,Lapa,93,3,3,2,4000,813,4813,51.75269
8311,Moema,54,2,2,1,2300,645,2945,54.537037
8312,Outro,220,3,4,5,12000,1800,13800,62.727272
8313,Vila Guarani,128,3,3,2,4600,980,5580,43.59375
8314,Outro,40,1,1,2,1300,639,1939,48.475
8315,Brooklin,65,2,2,1,3500,650,4150,63.846153
8316,Campo Belo,150,3,2,2,8500,1770,10270,68.46667
8317,Santa Cecília,197,3,3,1,4500,1589,6089,30.90863
8318,Brooklin,42,1,1,1,3200,600,3800,90.47619
8319,Vila Leopoldina,56,2,2,2,2500,750,3250,58.035713
8320,Vila Anastácio,87,3,3,2,5100,630,5730,65.86207
8321,Outro,87,2,3,2,5000,535,5535,63.62069
8322,Itaim Bibi,40,1,1,1,3500,813,4313,107.825
8323,Outro,58,2,2,1,1400,860,2260,38.96552
8324,Moema,116,3,3,2,4400,1902,6302,54.327587
8325,Saúde,37,1,1,1,2200,492,2692,72.75676
8326,Outro,64,2,1,0,1300,250,1550,24.21875
8327,Jardim Paulista,45,2,1,1,2300,837,3137,69.71111
8328,Santa Cecília,68,1,2,1,1500,1440,2940,43.235294
8329,Outro,38,1,1,0,1400,100,1500,39.473682
8330,Sumaré,215,3,3,4,10800,3568,14368,66.8279
8331,Jabaquara,52,2,1,1,1600,650,2250,43.26923
8332,Bela Vista,32,1,1,0,1100,450,1550,48.4375
8333,Vila Olímpia,70,2,1,1,2300,839,3139,44.842857
8334,Vila Nova Conceição,112,2,3,2,7570,2600,10170,90.80357
8335,Ipiranga,68,2,2,2,2700,605,3305,48.60294
8336,Vila Mariana,51,1,1,1,2000,434,2434,47.72549
8337,Itaim Bibi,151,3,5,3,17500,2500,20000,132.45033
8338,Outro,47,2,1,1,1000,290,1290,27.446808
8339,Pompeia,84,3,2,2,3800,1180,4980,59.285713
8340,Jabaquara,60,2,1,1,1700,600,2300,38.333332
8341,Jardim Paulista,45,1,1,1,3900,750,4650,103.333336
8342,Outro,131,3,2,1,3300,0,3300,25.19084
8343,Bela Vista,46,1,2,1,3100,381,3481,75.67391
8344,Vila Nova Conceição,85,2,2,1,2900,1290,4190,49.294117
8345,Itaim Bibi,85,2,2,1,6000,0,6000,70.588234
8346,Vila Nova Conceição,285,4,5,4,20000,7550,27550,96.666664
8347,Morumbi,42,1,1,1,1200,800,2000,47.61905
8348,Morumbi,148,2,3,2,4700,1317,6017,40.655407
8349,Vila Nova Conceição,70,1,1,0,1800,230,2030,29.0
8350,Jardim Paulista,190,4,4,4,18000,2480,20480,107.789474
8351,Itaim Bibi,65,1,2,1,5500,930,6430,98.92308
8352,Vila Mariana,69,2,2,1,2199,747,2946,42.695652
8353,Móoca,73,2,2,2,3030,770,3800,52.054794
8354,Chácara Santo Antônio,53,2,1,1,4460,982,5442,102.679245
8355,Morumbi,62,2,2,2,2500,611,3111,50.177418
8356,Outro,54,2,1,1,1600,560,2160,40.0
8357,Vila Nova Conceição,80,2,2,1,3500,1000,4500,56.25
8358,Perdizes,84,2,2,0,2400,300,2700,32.142857
8359,Outro,61,2,1,2,2500,1094,3594,58.918034
8360,Consolação,50,2,2,2,5000,0,5000,100.0
8361,Moema,81,2,3,2,6500,994,7494,92.51852
8362,Campo Belo,42,1,1,1,3500,0,3500,83.333336
8363,Vila Olímpia,43,1,1,1,1680,1129,2809,65.325584
8364,Moema,130,3,3,1,5000,1340,6340,48.76923
8365,Santo Amaro,85,3,1,2,4000,0,4000,47.058823
8366,Outro,130,3,4,2,10050,1500,11550,88.84615
8367,Perdizes,42,1,1,1,2300,820,3120,74.28571
8368,Vila Mariana,80,2,2,1,2500,820,3320,41.5
8369,Brooklin,104,2,2,1,2800,665,3465,33.317307
8370,Brooklin,60,2,2,1,2200,637,2837,47.283333
8371,Outro,68,2,2,1,1600,900,2500,36.764706
8372,Consolação,52,2,1,1,2500,577,3077,59.173077
8373,Vila Mascote,34,1,1,1,1200,457,1657,48.735294
8374,Brooklin,117,3,5,2,6800,1220,8020,68.54701
8375,Bela Vista,45,1,1,0,1300,520,1820,40.444443
8376,Pinheiros,68,2,2,1,2600,1145,3745,55.07353
8377,Paraíso,173,3,4,3,12000,2400,14400,83.23699
8378,Pompeia,65,2,2,1,2600,637,3237,49.8
8379,Santa Cecília,50,1,1,0,1850,550,2400,48.0
8380,Brooklin,50,1,1,1,2300,700,3000,60.0
8381,Tatuapé,65,2,1,1,1550,387,1937,29.8
8382,Brooklin,100,3,2,1,3200,790,3990,39.9
8383,Jardim Anália Franco,172,3,4,3,8000,1630,9630,55.988373
8384,Outro,47,2,1,1,1480,0,1480,31.48936
8385,Bela Vista,39,1,1,1,2400,550,2950,75.64103
8386,Jardim Europa,120,3,2,1,6000,2300,8300,69.166664
8387,Brooklin,360,4,3,3,9000,1500,10500,29.166666
8388,Itaim Bibi,161,3,5,2,7500,2684,10184,63.254658
8389,Brooklin,60,2,2,1,2500,962,3462,57.7
8390,Bela Vista,47,1,2,1,2200,560,2760,58.723404
8391,Vila Nova Conceição,432,4,6,4,25000,8020,33020,76.43519
8392,Campo Belo,35,1,1,1,2500,500,3000,85.71429
8393,Itaim Bibi,90,1,2,1,8900,1412,10312,114.577774
8394,Santana,86,2,1,0,1750,415,2165,25.17442
8395,Jardim Europa,240,4,3,2,15900,5020,20920,87.166664
8396,Jardim Marajoara,61,2,1,1,2500,415,2915,47.786884
8397,Vila Prudente,50,2,2,1,1650,495,2145,42.9
8398,Outro,45,2,1,1,1750,150,1900,42.22222
8399,Cambuci,94,2,2,0,2000,384,2384,25.361702
8400,Jardim Paulista,88,2,1,1,3400,0,3400,38.636364
8401,Indianópolis,115,3,3,2,4000,1584,5584,48.556522
8402,Pinheiros,30,1,1,1,2000,720,2720,90.666664
8403,Pinheiros,100,2,2,1,3550,1256,4806,48.06
8404,Jardim América,241,4,1,2,9500,3000,12500,51.867218
8405,Barra Funda,128,4,3,2,5500,1200,6700,52.34375
8406,Chácara Santo Antônio,146,4,3,2,6200,1050,7250,49.657536
8407,Paraíso,95,2,1,1,2080,1020,3100,32.63158
8408,Higienópolis,90,2,3,2,3200,900,4100,45.555557
8409,Ipiranga,69,2,2,1,2900,490,3390,49.130436
8410,Santa Cecília,90,3,1,2,3000,1150,4150,46.11111
8411,Outro,104,3,2,1,1500,1600,3100,29.807692
8412,Outro,65,3,1,1,1450,408,1858,28.584616
8413,Tatuapé,85,3,3,2,2500,799,3299,38.811764
8414,Vila Buarque,42,1,1,1,1400,559,1959,46.642857
8415,Outro,55,2,1,1,1350,483,1833,33.327274
8416,Moema,105,3,5,2,5500,1100,6600,62.857143
8417,Santana,76,2,2,2,3500,702,4202,55.289474
8418,Outro,43,2,1,1,1200,278,1478,34.372093
8419,Alto Da Boa Vista,158,3,2,2,4500,0,4500,28.481012
8420,Moema,55,2,2,1,4000,673,4673,84.96364
8421,Vila Formosa,40,1,1,0,1000,150,1150,28.75
8422,Vila Clementino,100,3,4,2,4000,1390,5390,53.9
8423,Jardim Paulista,194,4,5,3,9000,2894,11894,61.309277
8424,Aclimação,50,2,2,0,1350,0,1350,27.0
8425,Aclimação,183,4,4,3,7500,3100,10600,57.923496
8426,Outro,88,1,2,0,3500,1220,4720,53.636364
8427,Brooklin,86,3,2,2,3900,900,4800,55.813953
8428,Chácara Santo Antônio,143,3,4,2,10000,1000,11000,76.92308
8429,Saúde,48,1,1,1,1800,550,2350,48.958332
8430,Jardim Paulista,80,2,2,0,2450,659,3109,38.8625
8431,Moema,109,3,2,2,4900,1350,6250,57.33945
8432,Água Branca,70,3,2,1,2500,491,2991,42.728573
8433,Cerqueira César,110,2,3,1,7800,1400,9200,83.63636
8434,Saúde,30,1,1,0,1200,200,1400,46.666668
8435,Água Branca,128,4,4,2,6300,810,7110,55.546875
8436,Outro,50,2,1,1,950,315,1265,25.3
8437,Itaim Bibi,45,1,1,1,3200,717,3917,87.04444
8438,Moema,75,3,2,2,3200,1150,4350,58.0
8439,Outro,68,2,2,1,1755,0,1755,25.808823
8440,Vila Romana,72,2,2,2,3000,900,3900,54.166668
8441,Paraíso,70,2,2,1,2900,815,3715,53.07143
8442,Outro,36,1,1,0,1400,0,1400,38.88889
8443,Outro,55,2,1,1,2500,610,3110,56.545456
8444,Vila Andrade,70,2,2,2,1600,950,2550,36.42857
8445,Santo Amaro,60,2,1,1,2000,600,2600,43.333332
8446,Itaim Bibi,130,3,3,2,6500,2250,8750,67.30769
8447,Jardins,85,2,2,1,3000,1197,4197,49.376472
8448,Brooklin,117,3,4,2,4200,1680,5880,50.25641
8449,Liberdade,14,1,1,0,1800,220,2020,144.28572
8450,Campo Belo,75,2,2,1,2300,811,3111,41.48
8451,Vila Olímpia,74,2,2,1,3500,750,4250,57.432434
8452,Outro,94,3,2,0,1600,820,2420,25.74468
8453,Perdizes,52,1,2,1,2400,400,2800,53.846153
8454,Vila Mascote,48,2,1,1,2100,850,2950,61.458332
8455,Higienópolis,43,1,1,1,2200,550,2750,63.953487
8456,Vila Leopoldina,53,2,1,1,2100,425,2525,47.64151
8457,Vila Mariana,37,1,1,1,1700,576,2276,61.51351
8458,Cidade Monções,105,2,3,2,6600,1149,7749,73.8
8459,Bela Vista,62,1,2,1,1500,1102,2602,41.967743
8460,Vila Mariana,86,3,1,2,3200,650,3850,44.76744
8461,Pinheiros,85,2,3,2,3850,1520,5370,63.17647
8462,Vila Olímpia,80,3,2,2,2500,1211,3711,46.3875
8463,Vila Mariana,100,3,1,1,2500,858,3358,33.58
8464,Vila Mariana,25,1,1,0,1100,80,1180,47.2
8465,Santa Ifigênia,48,1,1,1,2700,665,3365,70.104164
8466,Barra Funda,33,1,1,0,1500,290,1790,54.242424
8467,Vila Olímpia,80,3,2,2,4200,1100,5300,66.25
8468,Centro,30,1,1,0,1800,534,2334,77.8
8469,Chácara Santo Antônio,134,4,4,3,4600,830,5430,40.52239
8470,Vila Formosa,110,3,3,2,5000,1550,6550,59.545456
8471,Bela Vista,50,1,1,0,1600,579,2179,43.58
8472,Cambuci,63,2,2,1,2000,790,2790,44.285713
8473,Campos Eliseos,91,2,2,0,1600,430,2030,22.307692
8474,Vila Guarani,56,2,1,1,1500,637,2137,38.160713
8475,Aclimação,40,1,1,1,1900,558,2458,61.45
8476,Pinheiros,162,1,2,2,9000,2716,11716,72.320984
8477,Cerqueira César,195,4,4,0,11000,4820,15820,81.128204
8478,Vila Mariana,38,1,1,1,1500,497,1997,52.55263
8479,Móoca,39,1,1,1,1900,300,2200,56.410255
8480,Bela Vista,38,1,1,0,1490,372,1862,49.0
8481,Itaim Bibi,89,2,2,1,4950,821,5771,64.8427
8482,Pinheiros,57,1,1,1,3800,770,4570,80.17544
8483,Consolação,67,2,2,1,3800,750,4550,67.910446
8484,Moema,88,3,3,1,2900,1685,4585,52.102272
8485,Jardim Paulista,151,3,4,3,10000,2280,12280,81.3245
8486,Morumbi,81,3,3,2,3050,750,3800,46.91358
8487,Pinheiros,72,3,2,1,5500,580,6080,84.44444
8488,Tatuapé,130,2,2,2,5700,800,6500,50.0
8489,Vila Mascote,204,4,5,3,5100,2700,7800,38.235294
8490,Tatuapé,72,2,1,1,1600,590,2190,30.416666
8491,Vila Mariana,68,2,2,1,2300,707,3007,44.22059
8492,Outro,50,2,1,1,1400,400,1800,36.0
8493,Itaim Bibi,78,3,2,1,3500,1030,4530,58.076923
8494,Bela Vista,37,1,1,0,1150,340,1490,40.27027
8495,Outro,70,3,1,1,2000,580,2580,36.857143
8496,Vila Mariana,85,2,2,1,2600,650,3250,38.235294
8497,Vila Carrão,60,2,2,2,1800,995,2795,46.583332
8498,Santa Cecília,39,1,1,1,1750,680,2430,62.307693
8499,Consolação,48,1,1,1,1800,439,2239,46.645832
8500,Jardim Paulista,50,2,1,1,2600,838,3438,68.76
8501,Aclimação,52,2,1,1,1600,520,2120,40.76923
8502,Outro,47,2,1,1,1750,385,2135,45.425533
8503,Outro,67,3,1,1,1680,607,2287,34.134327
8504,Brooklin,42,1,1,1,3000,605,3605,85.833336
8505,Bela Vista,46,1,1,1,6200,316,6516,141.65218
8506,Liberdade,45,1,1,1,1500,773,2273,50.511112
8507,Pinheiros,160,3,3,3,5500,1753,7253,45.33125
8508,Jabaquara,76,2,2,2,1440,928,2368,31.157894
8509,Pinheiros,30,1,1,0,3000,500,3500,116.666664
8510,Chácara Inglesa,76,2,2,2,2700,956,3656,48.105263
8511,Outro,44,1,1,0,1600,0,1600,36.363636
8512,Jardim Paulista,82,2,2,1,3600,955,4555,55.548782
8513,Jardim Paulista,90,2,1,1,3200,0,3200,35.555557
8514,Freguesia do Ó,82,3,2,1,2500,550,3050,37.19512
8515,Vila Nova Conceição,70,1,2,2,8700,1050,9750,139.28572
8516,Outro,76,3,2,2,3057,760,3817,50.223682
8517,Outro,70,3,1,1,2000,779,2779,39.7
8518,Jardins,33,1,1,1,970,2150,3120,94.545456
8519,Bela Vista,75,2,1,0,1600,300,1900,25.333334
8520,Sumaré,100,3,2,1,2600,791,3391,33.91
8521,Campo Belo,130,3,4,1,4100,1200,5300,40.76923
8522,Liberdade,36,1,1,0,1200,349,1549,43.02778
8523,Tatuapé,93,2,3,2,5000,695,5695,61.23656
8524,Brás,38,1,1,0,1500,350,1850,48.68421
8525,Brooklin,126,3,4,2,7000,1048,8048,63.873016
8526,Pinheiros,170,3,5,3,10000,1750,11750,69.117645
8527,Vila Mariana,100,3,3,2,5800,1500,7300,73.0
8528,Itaim Bibi,105,1,2,3,24000,3600,27600,262.85715
8529,Jardim Paulista,134,3,1,2,3800,1845,5645,42.126865
8530,Moema,120,3,4,2,6900,1900,8800,73.333336
8531,Vila Andrade,70,2,2,2,1150,900,2050,29.285715
8532,Jardim Prudência,64,2,2,1,2530,490,3020,47.1875
8533,Outro,52,2,1,1,800,253,1053,20.25
8534,Vila Mascote,45,2,1,1,1300,629,1929,42.866665
8535,Outro,68,2,1,1,1000,750,1750,25.735294
8536,Lapa,115,3,3,1,3300,790,4090,35.565216
8537,Outro,56,2,1,1,1000,300,1300,23.214285
8538,Vila Clementino,84,2,3,2,2800,1138,3938,46.88095
8539,Outro,60,2,2,1,850,390,1240,20.666666
8540,Móoca,45,2,1,1,2200,500,2700,60.0
8541,Cambuci,51,2,1,1,1500,805,2305,45.19608
8542,Brooklin,44,2,1,1,2500,880,3380,76.818184
8543,Outro,130,3,2,1,2400,850,3250,25.0
8544,Outro,54,2,1,2,2102,0,2102,38.925926
8545,Outro,67,3,2,1,1700,513,2213,33.02985
8546,Chácara Santo Antônio,50,2,2,1,2650,0,2650,53.0
8547,Móoca,92,3,1,2,2500,850,3350,36.413044
8548,Moema,150,3,4,3,6000,1867,7867,52.446667
8549,Vila Leopoldina,56,2,2,1,2200,648,2848,50.857143
8550,Jardins,109,3,2,1,4500,1119,5619,51.550457
8551,Vila Formosa,72,3,2,2,1750,698,2448,34.0
8552,Vila Mariana,50,1,2,1,3500,856,4356,87.12
8553,Higienópolis,62,2,2,1,3000,970,3970,64.03226
8554,Vila Formosa,65,2,1,1,2600,0,2600,40.0
8555,Vila Nova Conceição,35,1,1,0,2300,400,2700,77.14286
8556,Butantã,67,2,1,2,1500,705,2205,32.910446
8557,Barra Funda,70,3,2,2,3700,650,4350,62.142857
8558,Saúde,47,1,1,1,1800,602,2402,51.106384
8559,Outro,61,2,2,1,1900,360,2260,37.04918
8560,Panamby,226,4,6,4,4300,2950,7250,32.079647
8561,Chácara Santo Antônio,95,2,3,2,5500,725,6225,65.52631
8562,Moema,113,4,2,2,5500,1196,6696,59.256638
8563,Pinheiros,70,2,1,0,2200,300,2500,35.714287
8564,Moema,92,3,4,2,3800,1089,4889,53.141304
8565,Vila Nova Conceição,85,3,1,1,6200,0,6200,72.94118
8566,Brooklin,91,3,3,2,3500,1018,4518,49.64835
8567,Jardim Paulista,120,3,3,2,7000,1460,8460,70.5
8568,Pinheiros,49,2,1,1,2600,602,3202,65.34694
8569,Moema,73,2,2,2,4700,950,5650,77.39726
8570,Tatuapé,65,2,2,1,2100,600,2700,41.53846
8571,Brás,65,2,1,1,1200,589,1789,27.523077
8572,Jardim Paulista,178,4,4,3,6500,2050,8550,48.033707
8573,Móoca,65,2,2,1,2400,520,2920,44.923077
8574,Tatuapé,63,3,2,1,2500,680,3180,50.47619
8575,Outro,75,2,2,2,2035,912,2947,39.293335
8576,Brooklin,42,1,1,1,2900,580,3480,82.85714
8577,Vila Nova Conceição,36,1,1,1,2836,967,3803,105.638885
8578,Vila Olímpia,47,1,1,1,2320,670,2990,63.61702
8579,Moema,70,2,2,2,5300,720,6020,86.0
8580,Higienópolis,70,2,2,1,2600,960,3560,50.857143
8581,Pirituba,44,2,1,1,2150,250,2400,54.545456
8582,Pinheiros,60,2,2,1,3900,1100,5000,83.333336
8583,Pinheiros,65,2,1,2,4454,1458,5912,90.95385
8584,Santo Amaro,85,3,2,1,3900,0,3900,45.882355
8585,Vila Clementino,43,1,1,1,3500,530,4030,93.72093
8586,Vila Mariana,47,1,2,1,2000,719,2719,57.851063
8587,Moema,74,2,3,2,3650,1260,4910,66.35135
8588,Outro,45,2,1,1,1600,300,1900,42.22222
8589,Jardim Paulista,110,3,3,2,5500,1060,6560,59.636364
8590,Perdizes,75,2,2,0,3500,1,3501,46.68
8591,Brooklin,84,2,3,2,10900,1170,12070,143.69048
8592,Outro,60,2,1,1,1690,542,2232,37.2
8593,Indianópolis,43,1,1,1,2000,796,2796,65.023254
8594,Ipiranga,63,1,1,0,1400,0,1400,22.222221
8595,Brooklin,85,1,1,2,10000,1539,11539,135.75294
8596,Perdizes,42,1,1,1,2200,554,2754,65.57143
8597,Bela Vista,35,1,1,1,2356,551,2907,83.057144
8598,Outro,220,3,4,4,2500,2800,5300,24.09091
8599,Pinheiros,66,2,1,1,2300,980,3280,49.696968
8600,Saúde,37,1,1,1,2000,480,2480,67.02702
8601,Vila Guarani,50,1,1,1,2200,494,2694,53.88
8602,Santa Cecília,65,2,1,1,2800,800,3600,55.384617
8603,Pirituba,40,2,1,1,1300,0,1300,32.5
8604,Vila Romana,85,2,2,1,2000,783,2783,32.741177
8605,Vila Leopoldina,141,4,3,2,11000,850,11850,84.04256
8606,Santo Amaro,370,4,6,4,15000,2900,17900,48.37838
8607,Chácara Santo Antônio,51,1,1,1,4100,760,4860,95.29412
8608,Vila Madalena,79,2,1,1,4650,875,5525,69.93671
8609,Perdizes,50,1,1,1,1900,600,2500,50.0
8610,Outro,296,4,4,3,12000,5142,17142,57.912163
8611,Moema,80,2,3,1,2600,950,3550,44.375
8612,Outro,32,1,1,0,1100,0,1100,34.375
8613,Aclimação,43,1,1,1,2300,800,3100,72.093025
8614,Vila Mariana,49,2,1,1,2800,463,3263,66.591835
8615,Pinheiros,110,3,3,1,3900,880,4780,43.454544
8616,Vila Mariana,60,2,1,1,2200,690,2890,48.166668
8617,Lapa,87,2,2,1,3500,320,3820,43.908047
8618,Brooklin,55,1,1,1,6000,1070,7070,128.54546
8619,Morumbi,155,3,4,3,3100,1800,4900,31.612904
8620,Jabaquara,55,2,1,1,1500,600,2100,38.18182
8621,Brooklin,70,2,1,1,2100,1000,3100,44.285713
8622,Cidade Monções,52,2,2,1,3370,0,3370,64.80769
8623,República,36,1,1,1,2200,440,2640,73.333336
8624,Campo Belo,78,3,2,1,2200,950,3150,40.384617
8625,Ipiranga,125,3,3,2,6000,1028,7028,56.224
8626,Granja Julieta,186,3,3,3,10000,2450,12450,66.935486
8627,Chácara Santo Antônio,70,2,2,2,4500,852,5352,76.457146
8628,Bela Vista,45,1,1,1,1700,660,2360,52.444443
8629,Campo Belo,125,4,4,2,3000,1415,4415,35.32
8630,Aclimação,276,4,4,3,9000,2580,11580,41.95652
8631,Tatuapé,40,1,1,1,2500,660,3160,79.0
8632,Jardim Paulista,170,3,4,2,4800,1750,6550,38.52941
8633,Outro,49,2,1,1,1000,698,1698,34.65306
8634,Outro,49,2,1,0,1100,280,1380,28.163265
8635,Itaim Bibi,201,3,4,4,21000,4100,25100,124.875626
8636,Outro,32,1,1,0,1200,0,1200,37.5
8637,Lapa,80,1,1,1,3300,0,3300,41.25
8638,Sumaré,64,1,2,1,4000,1058,5058,79.03125
8639,Moema,25,1,1,0,3200,498,3698,147.92
8640,Saúde,77,2,2,1,1800,998,2798,36.33766
8641,Brooklin,70,2,1,1,3995,850,4845,69.21429
8642,Cerqueira César,91,2,2,1,2900,954,3854,42.35165
8643,Outro,70,3,2,1,1650,650,2300,32.857143
8644,Pinheiros,160,3,4,2,5000,1700,6700,41.875
8645,Casa Verde,65,2,2,1,1800,587,2387,36.723076
8646,Moema,210,3,5,4,7000,3900,10900,51.904762
8647,Cambuci,105,3,2,1,2500,1050,3550,33.809525
8648,Vila Mariana,45,1,1,1,3500,0,3500,77.77778
8649,Pompeia,40,1,1,1,1800,500,2300,57.5
8650,Indianópolis,228,4,6,4,13000,3500,16500,72.36842
8651,Vila Leopoldina,56,2,2,1,3400,535,3935,70.26786
8652,Ipiranga,70,3,2,2,2300,653,2953,42.185715
8653,Jardim Paulista,240,3,3,2,6900,2240,9140,38.083332
8654,Santa Cecília,42,1,1,1,2850,558,3408,81.14286
8655,Outro,48,2,1,1,1500,300,1800,37.5
8656,Perdizes,80,3,1,0,2750,0,2750,34.375
8657,Aclimação,39,1,1,1,2260,530,2790,71.53846
8658,Vila Mascote,70,2,1,1,1500,599,2099,29.985714
8659,Vila Guarani,56,2,2,1,2800,560,3360,60.0
8660,Jardim Paulista,82,2,2,0,2900,360,3260,39.756096
8661,Outro,58,2,1,1,1500,610,2110,36.37931
8662,Vila Madalena,78,1,2,2,2600,1200,3800,48.71795
8663,Brooklin,68,2,2,1,7500,1085,8585,126.25
8664,Vila Clementino,43,1,1,1,2700,675,3375,78.48837
8665,Consolação,86,2,1,1,3000,700,3700,43.023254
8666,Vila Mariana,91,3,3,1,2800,1100,3900,42.857143
8667,Bela Vista,104,3,2,0,2200,955,3155,30.336538
8668,Saúde,67,2,2,1,3100,830,3930,58.656715
8669,Outro,60,2,2,1,1200,1,1201,20.016666
8670,Vila Mariana,80,3,1,1,1800,535,2335,29.1875
8671,Vila Cruzeiro,75,3,3,2,3500,765,4265,56.866665
8672,Brooklin,67,1,2,2,4300,1048,5348,79.82089
8673,Brooklin,126,3,3,0,4500,1664,6164,48.920635
8674,Cerqueira César,55,2,1,0,2500,850,3350,60.909092
8675,Vila Mariana,63,2,2,0,1800,406,2206,35.015873
8676,Jardim Paulista,162,3,4,4,14000,2711,16711,103.15432
8677,Santo Amaro,210,4,4,4,8000,1700,9700,46.190475
8678,Bom Retiro,152,3,2,0,1800,1250,3050,20.06579
8679,Ipiranga,60,2,2,2,2000,870,2870,47.833332
8680,Itaim Bibi,153,2,3,1,18000,1800,19800,129.41176
8681,Aclimação,40,1,1,1,2290,561,2851,71.275
8682,Barra Funda,34,1,1,0,1500,210,1710,50.294117
8683,Cerqueira César,62,2,2,1,4490,590,5080,81.935486
8684,Chácara Santo Antônio,70,2,3,1,3200,734,3934,56.2
8685,Jardim Marajoara,64,3,1,1,1775,636,2411,37.671875
8686,Campo Belo,39,1,1,1,2550,330,2880,73.84615
8687,Itaim Bibi,110,3,4,2,4900,1500,6400,58.18182
8688,Higienópolis,165,3,3,2,5500,1900,7400,44.848484
8689,Higienópolis,35,1,1,1,1600,512,2112,60.342857
8690,Vila Olímpia,80,2,1,1,2100,364,2464,30.8
8691,Outro,32,2,1,0,800,185,985,30.78125
8692,Vila Nova Conceição,105,2,3,1,5450,1346,6796,64.72381
8693,Pirituba,120,2,1,1,1800,510,2310,19.25
8694,Higienópolis,230,4,4,2,5000,4000,9000,39.130436
8695,Perdizes,115,4,3,2,3580,1607,5187,45.104347
8696,Outro,50,2,1,1,1800,291,2091,41.82
8697,Perdizes,84,2,2,2,2800,1157,3957,47.107143
8698,Outro,49,2,1,1,1900,350,2250,45.918365
8699,Jardim América,80,2,3,2,10000,1500,11500,143.75
8700,Centro,40,1,1,1,2500,450,2950,73.75
8701,Cerqueira César,105,2,3,1,2600,1374,3974,37.84762
8702,Vila Olímpia,111,3,3,2,11000,1600,12600,113.51351
8703,Brás,44,2,1,1,1550,370,1920,43.636364
8704,Outro,24,1,1,1,2450,0,2450,102.083336
8705,Moema,40,1,1,1,4500,1100,5600,140.0
8706,Outro,41,1,1,1,2400,900,3300,80.48781
8707,Itaim Bibi,45,1,1,1,3500,624,4124,91.64445
8708,Outro,45,1,1,0,1100,0,1100,24.444445
8709,Moema,84,2,2,1,1700,702,2402,28.595238
8710,Aclimação,62,2,1,2,1600,750,2350,37.903225
8711,Paraíso,171,3,5,3,13500,2800,16300,95.32164
8712,Vila Madalena,81,2,2,1,3500,1289,4789,59.123455
8713,Santo Amaro,65,2,1,1,2700,490,3190,49.076923
8714,Jardim Paulista,110,3,2,1,2800,1750,4550,41.363636
8715,Vila Nova Conceição,104,1,2,2,10000,1480,11480,110.38461
8716,Itaim Bibi,50,1,1,1,2600,728,3328,66.56
8717,Bela Vista,48,1,2,0,2800,450,3250,67.708336
8718,Outro,47,1,1,1,3100,595,3695,78.61702
8719,Ipiranga,192,4,1,3,7500,0,7500,39.0625
8720,Vila Clementino,280,3,2,4,15000,4369,19369,69.175
8721,Pinheiros,85,2,2,2,5785,1342,7127,83.84706
8722,Vila Andrade,52,2,1,1,2500,0,2500,48.076923
8723,Vila Mascote,50,2,1,1,2800,405,3205,64.1
8724,Campo Belo,44,1,1,1,1900,665,2565,58.295456
8725,Bela Vista,42,1,1,1,1399,669,2068,49.238094
8726,Vila Prudente,41,2,1,1,2000,300,2300,56.09756
8727,Vila Buarque,25,1,1,0,1000,368,1368,54.72
8728,Pinheiros,42,1,1,1,3600,647,4247,101.11905
8729,Perdizes,140,3,3,1,3900,1000,4900,35.0
8730,Jardim Paulista,160,3,3,1,6000,2340,8340,52.125
8731,Moema,110,3,1,2,6000,1200,7200,65.454544
8732,Brooklin,62,2,1,1,2100,720,2820,45.48387
8733,Brás,60,2,2,0,1600,500,2100,35.0
8734,Jabaquara,114,3,2,2,2200,1300,3500,30.701754
8735,Higienópolis,500,4,6,5,39000,8300,47300,94.6
8736,Brooklin,43,1,1,1,4205,628,4833,112.39535
8737,Outro,50,2,1,1,1300,450,1750,35.0
8738,Ipiranga,60,2,2,2,1700,874,2574,42.9
8739,Bela Vista,48,1,1,0,1300,523,1823,37.979168
8740,Liberdade,30,1,1,1,1846,1254,3100,103.333336
8741,Jardim Paulista,42,1,1,1,1399,699,2098,49.95238
8742,Vila Olímpia,60,2,1,1,3200,1000,4200,70.0
8743,Aclimação,66,2,2,2,2700,741,3441,52.136364
8744,Vila Nova Conceição,70,2,2,1,2950,1600,4550,65.0
8745,Bela Vista,34,1,1,0,1200,353,1553,45.67647
8746,Vila Clementino,65,2,2,1,1900,1167,3067,47.184616
8747,Barra Funda,126,4,3,2,5859,1200,7059,56.02381
8748,Jardim Paulista,240,3,3,4,10500,7500,18000,75.0
8749,Móoca,40,1,1,0,1300,180,1480,37.0
8750,Vila Cruzeiro,60,2,2,2,3300,623,3923,65.38333
8751,Vila Nova Conceição,300,4,5,4,22000,5500,27500,91.666664
8752,Moema,313,4,6,6,11128,7769,18897,60.373802
8753,Santo Amaro,65,2,2,2,4000,685,4685,72.07692
8754,Vila Madalena,175,3,5,3,6400,2800,9200,52.57143
8755,Saúde,62,2,2,1,2200,930,3130,50.48387
8756,Outro,55,2,2,1,1200,452,1652,30.036364
8757,Outro,130,4,4,2,7000,1350,8350,64.23077
8758,Outro,64,2,1,1,1300,875,2175,33.984375
8759,Campo Belo,155,2,1,2,10000,1400,11400,73.548386
8760,Jardins,76,2,1,1,5300,1000,6300,82.89474
8761,Campo Belo,50,1,1,1,2950,700,3650,73.0
8762,Bela Vista,25,1,1,0,1050,190,1240,49.6
8763,Barra Funda,160,3,2,2,7000,1204,8204,51.275
8764,Jardins,53,2,2,1,3700,730,4430,83.58491
8765,Liberdade,49,2,1,1,1600,222,1822,37.183674
8766,Brooklin,47,1,1,1,3000,485,3485,74.14893
8767,Jardim Marajoara,59,2,1,1,1585,614,2199,37.271187
8768,Brás,55,2,1,1,1450,350,1800,32.727272
8769,Vila Olímpia,90,2,3,2,8500,2200,10700,118.888885
8770,Chácara Santo Antônio,48,1,1,1,2250,326,2576,53.666668
8771,Bom Retiro,33,1,1,1,2500,800,3300,100.0
8772,Tatuapé,70,3,2,1,2000,561,2561,36.585712
8773,Jaguaré,60,2,1,1,1650,700,2350,39.166668
8774,Bela Vista,103,3,3,1,2800,830,3630,35.242718
8775,Vila Sônia,58,2,2,0,1800,646,2446,42.172413
8776,Moema,35,1,1,0,3000,0,3000,85.71429
8777,Perdizes,86,3,3,1,3000,850,3850,44.76744
8778,Moema,70,2,2,1,2600,900,3500,50.0
8779,Outro,98,4,3,2,4000,660,4660,47.55102
8780,Campo Belo,60,2,1,0,2200,1,2201,36.683334
8781,Jardim Paulista,68,2,2,1,2700,809,3509,51.60294
8782,Jardim Paulista,34,1,1,1,1800,577,2377,69.911766
8783,Tatuapé,82,3,2,1,2500,830,3330,40.609756
8784,Barra Funda,66,2,2,1,2700,995,3695,55.984848
8785,Outro,90,2,4,1,2800,1239,4039,44.877777
8786,Bela Vista,103,3,3,1,3500,1430,4930,47.86408
8787,Ipiranga,68,2,2,1,2700,0,2700,39.705883
8788,Mirandópolis,27,1,1,0,1500,390,1890,70.0
8789,Higienópolis,190,3,4,1,5000,2200,7200,37.894737
8790,Bela Vista,35,1,1,0,1300,0,1300,37.142857
8791,Vila Madalena,130,3,3,2,4500,1849,6349,48.838463
8792,Cerqueira César,180,3,5,1,12900,2200,15100,83.888885
8793,Moema,130,3,3,2,5200,1287,6487,49.9
8794,Outro,75,3,2,1,1400,750,2150,28.666666
8795,Moema,40,1,1,1,2500,800,3300,82.5
8796,Aclimação,77,3,1,2,2900,0,2900,37.66234
8797,Pinheiros,215,2,4,2,18000,1750,19750,91.860466
8798,Tatuapé,48,2,1,1,1500,356,1856,38.666668
8799,Vila Olímpia,35,1,1,1,3000,858,3858,110.22857
8800,Bom Retiro,110,3,3,2,3200,920,4120,37.454544
8801,Vila Nova Conceição,37,1,1,1,2300,900,3200,86.48649
8802,Ipiranga,70,2,1,0,1700,310,2010,28.714285
8803,Bela Vista,65,1,2,1,3000,1118,4118,63.353848
8804,Itaim Bibi,62,2,2,1,5000,873,5873,94.72581
8805,Outro,50,2,1,2,1500,350,1850,37.0
8806,Outro,49,2,1,0,1200,100,1300,26.530613
8807,Consolação,40,1,1,1,2100,378,2478,61.95
8808,Outro,56,2,1,1,1700,640,2340,41.785713
8809,Paraíso,59,2,2,1,3300,615,3915,66.355934
8810,Jardim Paulista,118,3,3,2,3500,1282,4782,40.525425
8811,Outro,69,2,2,1,1600,510,2110,30.57971
8812,Jardim Paulista,45,1,1,1,3000,780,3780,84.0
8813,Moema,120,3,2,2,13000,3148,16148,134.56667
8814,Jardim Europa,126,3,2,1,8000,3100,11100,88.09524
8815,Outro,35,1,1,0,1200,0,1200,34.285713
8816,Vila Santa Catarina,52,2,1,1,1750,450,2200,42.307693
8817,Vila Olímpia,65,2,2,1,3500,875,4375,67.30769
8818,Alto da Lapa,200,4,4,3,6990,2800,9790,48.95
8819,Paraíso,38,1,1,1,1400,510,1910,50.263157
8820,Freguesia do Ó,52,1,1,1,1300,0,1300,25.0
8821,Moema,165,3,4,2,6000,1400,7400,44.848484
8822,Jabaquara,55,2,1,1,1549,641,2190,39.81818
8823,Morumbi,86,1,2,2,3000,1300,4300,50.0
8824,Brooklin,132,3,4,2,11000,1220,12220,92.57576
8825,Jardim Anália Franco,120,3,5,3,2300,1800,4100,34.166668
8826,Vila Formosa,62,2,1,1,1200,535,1735,27.983871
8827,Vila Olímpia,31,1,1,1,3000,800,3800,122.58064
8828,Lapa,62,2,1,1,2700,628,3328,53.677418
8829,Outro,52,2,1,1,1500,420,1920,36.923077
8830,Higienópolis,50,1,1,1,1800,550,2350,47.0
8831,Outro,47,2,1,1,1500,0,1500,31.914894
8832,Campo Belo,83,2,3,1,2000,1149,3149,37.93976
8833,Vila Olímpia,105,3,3,1,2700,950,3650,34.761906
8834,Jardins,38,1,1,1,4000,0,4000,105.26316
8835,Cerqueira César,72,2,2,2,3000,971,3971,55.15278
8836,Campo Belo,37,1,1,1,1800,1400,3200,86.48649
8837,Brooklin,50,1,1,1,1800,641,2441,48.82
8838,Vila Olímpia,70,2,1,1,2409,715,3124,44.62857
8839,Outro,220,3,4,2,2500,3200,5700,25.90909
8840,Outro,57,2,1,2,1500,550,2050,35.964912
8841,Itaim Bibi,125,2,2,1,4500,1660,6160,49.28
8842,Bela Vista,60,2,2,1,3300,612,3912,65.2
8843,Chácara Santo Antônio,103,3,3,2,4800,1000,5800,56.31068
8844,Outro,50,2,1,1,1400,424,1824,36.48
8845,Pinheiros,49,2,1,1,2800,657,3457,70.55102
8846,Outro,222,4,4,4,20000,2600,22600,101.8018
8847,Pinheiros,45,1,1,1,2200,1002,3202,71.155556
8848,Perdizes,105,3,3,1,3500,998,4498,42.838097
8849,Panamby,290,3,5,4,8000,2115,10115,34.87931
8850,Paraíso,201,2,3,0,5000,919,5919,29.447762
8851,Campos Eliseos,65,2,1,0,1500,328,1828,28.123077
8852,Brooklin,36,1,1,1,3200,0,3200,88.888885
8853,Consolação,27,1,1,0,2400,280,2680,99.25926
8854,Jardim Paulista,68,2,2,0,3000,690,3690,54.264706
8855,Vila Buarque,50,1,1,0,1400,572,1972,39.44
8856,Pinheiros,85,3,2,1,3000,800,3800,44.705883
8857,Vila Andrade,49,1,1,1,2000,475,2475,50.510204
8858,Vila Mariana,70,2,1,0,1600,392,1992,28.457144
8859,Santana,205,3,5,2,7000,0,7000,34.146343
8860,Vila Mariana,60,2,2,1,3550,920,4470,74.5
8861,Ipiranga,137,4,2,2,6000,1100,7100,51.824818
8862,Jardim América,40,1,1,0,2200,429,2629,65.725
8863,Outro,60,2,1,0,1600,236,1836,30.6
8864,Itaim Bibi,180,2,3,1,18000,1740,19740,109.666664
8865,Vila Mariana,73,2,1,2,4600,1156,5756,78.84931
8866,Perdizes,127,3,2,2,7500,1331,8831,69.53543
8867,Outro,42,1,1,0,780,0,780,18.571428
8868,Bom Retiro,80,2,2,0,1400,700,2100,26.25
8869,Perdizes,33,1,1,0,2500,426,2926,88.666664
8870,Perdizes,75,2,1,1,1850,975,2825,37.666668
8871,Vila Nova Conceição,134,2,2,2,13500,2400,15900,118.656715
8872,Bom Retiro,137,3,1,1,1900,1200,3100,22.627737
8873,Outro,76,2,1,0,1600,0,1600,21.052631
8874,Aclimação,50,1,1,0,1300,487,1787,35.74
8875,Chácara Santo Antônio,70,2,2,1,3200,750,3950,56.42857
8876,Vila Prudente,69,3,2,1,2300,515,2815,40.7971
8877,Tatuapé,67,2,2,1,3000,476,3476,51.880596
8878,Vila Mariana,190,3,5,3,10000,1900,11900,62.63158
8879,Vila Leopoldina,68,2,1,1,1800,905,2705,39.77941
8880,Higienópolis,180,3,4,2,5000,2137,7137,39.65
8881,Consolação,29,1,1,0,2100,276,2376,81.93104
8882,Ipiranga,60,2,2,1,2200,737,2937,48.95
8883,Moema,60,2,2,1,2900,787,3687,61.45
8884,Vila Olímpia,97,2,3,1,3900,1090,4990,51.4433
8885,Outro,70,2,2,2,2000,680,2680,38.285713
8886,Indianópolis,41,1,1,1,3900,1475,5375,131.09756
8887,Lapa,60,2,2,1,2730,660,3390,56.5
8888,Santana,50,1,1,0,1100,345,1445,28.9
8889,Outro,66,3,1,1,1300,502,1802,27.30303
8890,Moema,156,3,6,3,9000,1585,10585,67.85256
8891,Outro,58,2,1,1,2100,390,2490,42.931034
8892,Saúde,60,2,1,1,1800,750,2550,42.5
8893,Aclimação,23,1,1,0,1080,267,1347,58.565216
8894,Outro,46,2,1,1,1600,1600,3200,69.565216
8895,Vila Nova Conceição,127,3,3,2,9170,1415,10585,83.34646
8896,Bela Vista,33,1,1,0,1700,450,2150,65.15151
8897,Brooklin,93,3,4,2,4500,1320,5820,62.580647
8898,Itaim Bibi,52,1,2,1,6800,800,7600,146.15384
8899,Outro,75,2,2,1,1700,930,2630,35.066666
8900,Consolação,40,1,1,1,2100,450,2550,63.75
8901,Campo Belo,70,2,2,2,1800,939,2739,39.12857
8902,Outro,47,2,1,1,1250,367,1617,34.404255
8903,Outro,22,1,1,0,2100,361,2461,111.86364
8904,Vila Nova Conceição,55,2,1,1,1400,780,2180,39.636364
8905,Cidade Monções,62,1,1,1,3850,913,4763,76.82258
8906,Saúde,66,2,2,1,1900,599,2499,37.863636
8907,Outro,95,3,3,2,2600,1056,3656,38.48421
8908,Vila Nova Conceição,192,4,6,4,30000,2950,32950,171.61458
8909,Pinheiros,50,2,1,1,2600,662,3262,65.24
8910,Jardim Paulista,43,1,1,1,2300,1300,3600,83.72093
8911,Campo Belo,106,3,3,2,4200,1344,5544,52.301888
8912,Bela Vista,39,1,1,1,2800,428,3228,82.76923
8913,Brás,98,2,1,0,1680,0,1680,17.142857
8914,Perdizes,115,3,4,2,3800,1100,4900,42.608696
8915,Perdizes,70,2,2,2,2950,650,3600,51.42857
8916,Vila Mariana,137,3,2,1,4200,1766,5966,43.547443
8917,Vila Uberabinha,167,2,2,2,15000,2400,17400,104.19162
8918,Vila Leopoldina,151,3,5,3,7500,1950,9450,62.582783
8919,Brooklin,51,1,1,1,3300,592,3892,76.31373
8920,Móoca,77,3,2,2,2800,700,3500,45.454544
8921,Outro,75,3,1,1,1950,647,2597,34.626667
8922,Brooklin,112,3,4,2,3800,1251,5051,45.098213
8923,Jardim Paulista,110,3,3,2,5500,1060,6560,59.636364
8924,Pinheiros,42,1,1,1,2300,656,2956,70.38095
8925,Vila Romana,60,2,2,1,3350,583,3933,65.55
8926,Outro,68,2,1,1,1500,880,2380,35.0
8927,Santo Amaro,115,3,3,2,5000,900,5900,51.304348
8928,Outro,47,1,2,1,2300,600,2900,61.70213
8929,Jardim Europa,250,2,2,2,9200,0,9200,36.8
8930,Barra Funda,162,3,4,2,8000,1500,9500,58.641975
8931,Tatuapé,141,4,4,2,2000,1894,3894,27.617022
8932,Bela Vista,40,1,1,1,2550,602,3152,78.8
8933,Morumbi,135,3,4,2,2500,1170,3670,27.185184
8934,Jardim Paulista,75,2,1,1,3050,1100,4150,55.333332
8935,Outro,70,2,2,1,1800,747,2547,36.385715
8936,Butantã,50,2,1,1,1400,450,1850,37.0
8937,Outro,60,2,2,1,1300,500,1800,30.0
8938,Brooklin,37,1,1,1,2000,800,2800,75.675674
8939,Morumbi,110,2,4,2,2800,1300,4100,37.272728
8940,Outro,48,2,1,1,2300,500,2800,58.333332
8941,Jardim América,200,3,3,2,10000,3000,13000,65.0
8942,Vila Uberabinha,45,1,1,1,1900,500,2400,53.333332
8943,Higienópolis,62,2,2,2,4800,747,5547,89.46774
8944,Outro,58,2,1,1,1300,460,1760,30.344828
8945,Vila Carrão,36,2,1,0,1500,120,1620,45.0
8946,Morumbi,320,4,5,5,3000,2971,5971,18.659374
8947,Outro,41,2,1,0,1200,0,1200,29.268293
8948,Freguesia do Ó,50,2,2,1,1800,650,2450,49.0
8949,Jardim Prudência,64,2,2,1,2620,600,3220,50.3125
8950,Vila Madalena,72,2,2,1,4700,950,5650,78.47222
8951,Pinheiros,50,1,2,1,3100,740,3840,76.8
8952,Outro,98,3,4,2,3000,1200,4200,42.857143
8953,Jaguaré,63,2,2,1,2000,440,2440,38.73016
8954,Santana,44,1,1,1,1600,600,2200,50.0
8955,Outro,80,3,2,1,3100,505,3605,45.0625
8956,Higienópolis,93,3,3,1,3600,1100,4700,50.537636
8957,Móoca,58,2,1,1,2000,470,2470,42.58621
8958,Jardim América,79,2,2,1,4000,1050,5050,63.92405
8959,Bela Vista,100,3,2,1,2400,980,3380,33.8
8960,Perdizes,96,3,3,2,3500,1250,4750,49.479168
8961,Jaguaré,80,2,2,2,1450,685,2135,26.6875
8962,Jabaquara,47,2,1,1,1550,645,2195,46.70213
8963,Brás,40,1,1,1,1500,210,1710,42.75
8964,Itaim Bibi,100,2,3,2,11200,2241,13441,134.41
8965,Brooklin,49,1,1,1,3500,900,4400,89.79592
8966,Paraíso,47,1,1,1,1600,660,2260,48.085106
8967,Butantã,72,2,1,1,1800,0,1800,25.0
8968,Campo Belo,45,1,2,1,2800,352,3152,70.04444
8969,Tatuapé,60,2,1,1,2100,450,2550,42.5
8970,Vila Guarani,65,3,2,2,1900,801,2701,41.553844
8971,Outro,32,1,1,0,800,0,800,25.0
8972,Outro,32,1,1,0,1250,100,1350,42.1875
8973,Outro,55,2,1,1,1200,440,1640,29.818182
8974,Paraíso,102,3,2,1,3800,1325,5125,50.2451
8975,Jardim Anália Franco,52,1,1,1,2950,500,3450,66.34615
8976,Jardim Paulista,189,3,4,1,4800,2588,7388,39.089947
8977,Jardim Marajoara,50,2,1,2,1460,490,1950,39.0
8978,Consolação,110,2,2,0,2500,750,3250,29.545454
8979,Panamby,70,1,1,1,2400,994,3394,48.485714
8980,Vila Mariana,68,2,2,0,2000,452,2452,36.058823
8981,Outro,76,3,2,1,3400,550,3950,51.973682
8982,Santana,38,1,1,1,1500,735,2235,58.81579
8983,Barra Funda,90,3,3,1,2600,750,3350,37.22222
8984,Morumbi,50,1,2,1,2700,750,3450,69.0
8985,Vila Andrade,58,2,1,2,1800,670,2470,42.58621
8986,Santa Cecília,78,2,2,0,2100,721,2821,36.166668
8987,Pompeia,155,3,5,3,12000,2130,14130,91.16129
8988,Santo Amaro,65,2,2,2,3200,1060,4260,65.53846
8989,Moema,55,2,2,2,2750,810,3560,64.72727
8990,Sumaré,65,3,1,6,2200,738,2938,45.2
8991,Bela Vista,76,2,1,1,3300,860,4160,54.736843
8992,Vila Santa Catarina,80,3,2,1,1500,747,2247,28.0875
8993,Outro,32,1,1,0,1150,150,1300,40.625
8994,Perdizes,84,3,2,1,2800,972,3772,44.904762
8995,Jardim Prudência,80,2,2,2,4500,975,5475,68.4375
8996,Consolação,65,1,1,1,1350,1013,2363,36.353848
8997,Cerqueira César,29,1,1,1,2000,1051,3051,105.206894
8998,Cidade Monções,75,2,2,2,5800,1200,7000,93.333336
8999,Indianópolis,75,2,3,1,3800,1160,4960,66.13333
9000,Outro,55,2,1,1,1360,540,1900,34.545456
9001,Moema,240,4,7,2,13000,3941,16941,70.5875
9002,Brooklin,180,3,3,3,9000,1500,10500,58.333332
9003,Brooklin,68,2,2,1,5000,900,5900,86.76471
9004,Outro,86,3,3,2,3000,760,3760,43.720932
9005,Vila Mariana,90,2,2,1,2500,844,3344,37.155556
9006,Liberdade,54,2,1,1,3000,630,3630,67.22222
9007,Vila Carrão,84,2,2,2,3600,600,4200,50.0
9008,Vila Buarque,120,2,1,1,3000,840,3840,32.0
9009,Vila Leopoldina,70,2,2,1,2300,750,3050,43.57143
9010,Vila Mascote,83,2,2,2,4500,699,5199,62.638554
9011,Morumbi,60,1,1,1,1900,1172,3072,51.2
9012,Vila Mariana,84,2,2,1,2650,521,3171,37.75
9013,Morumbi,50,1,1,1,1650,322,1972,39.44
9014,Cambuci,100,3,3,1,1950,980,2930,29.3
9015,Outro,73,2,1,1,1200,600,1800,24.657534
9016,Vila Leopoldina,93,2,2,2,3800,800,4600,49.462364
9017,Vila Mascote,84,3,1,2,2300,1303,3603,42.892857
9018,Butantã,24,1,1,0,1300,0,1300,54.166668
9019,Paraíso,80,2,1,0,2300,160,2460,30.75
9020,Bela Vista,110,3,2,1,3300,964,4264,38.763638
9021,Vila Guarani,56,2,1,1,2000,600,2600,46.42857
9022,Santa Cecília,140,2,4,1,3200,1670,4870,34.785713
9023,Outro,57,2,1,1,950,0,950,16.666666
9024,Vila Carrão,160,4,4,2,2500,1200,3700,23.125
9025,República,32,1,1,1,1000,785,1785,55.78125
9026,Chácara Santo Antônio,112,3,3,2,5800,840,6640,59.285713
9027,Vila Andrade,68,2,2,2,2420,550,2970,43.67647
9028,Campo Belo,154,3,5,3,10000,1000,11000,71.42857
9029,Campo Belo,90,3,2,2,3000,1200,4200,46.666668
9030,Moema,110,3,2,2,4000,1055,5055,45.954544
9031,Outro,38,1,1,1,1800,320,2120,55.789474
9032,Vila Clementino,274,4,6,4,15000,4200,19200,70.07299
9033,Pinheiros,180,3,5,4,8000,3600,11600,64.44444
9034,Vila Mariana,68,1,1,1,1900,661,2561,37.661766
9035,Santa Cecília,100,2,3,1,2800,922,3722,37.22
9036,Outro,63,2,2,2,4500,890,5390,85.55556
9037,Bela Vista,110,3,3,1,2500,1038,3538,32.163635
9038,Outro,80,2,1,1,1100,395,1495,18.6875
9039,Indianópolis,42,1,2,1,1750,550,2300,54.761906
9040,Campo Belo,161,3,3,3,11000,1500,12500,77.639755
9041,Itaim Bibi,50,1,2,1,2800,856,3656,73.12
9042,Outro,55,2,1,1,2200,450,2650,48.18182
9043,Brooklin,39,1,1,1,2400,500,2900,74.35897
9044,Tatuapé,50,1,1,1,2700,400,3100,62.0
9045,Vila Mariana,80,3,2,1,2600,740,3340,41.75
9046,Vila Nova Conceição,55,2,1,1,3500,1685,5185,94.27273
9047,Itaim Bibi,120,3,2,1,3800,1298,5098,42.483334
9048,Aclimação,39,1,1,1,2260,530,2790,71.53846
9049,Tatuapé,40,1,1,1,2700,794,3494,87.35
9050,Outro,111,3,4,2,7900,1300,9200,82.88288
9051,Perdizes,120,3,1,2,2700,1100,3800,31.666666
9052,Outro,138,4,4,2,6800,805,7605,55.108696
9053,Santo Amaro,45,2,1,0,1600,0,1600,35.555557
9054,Santana,50,1,1,0,1150,180,1330,26.6
9055,Outro,48,2,1,1,1300,300,1600,33.333332
9056,Outro,70,3,2,2,2200,425,2625,37.5
9057,Outro,38,2,1,1,2100,300,2400,63.157894
9058,Pinheiros,72,2,2,2,2300,1420,3720,51.666668
9059,Campo Belo,50,1,1,1,2900,795,3695,73.9
9060,Campo Belo,120,3,4,2,3700,1250,4950,41.25
9061,Vila Guarani,40,1,1,1,1500,460,1960,49.0
9062,Itaim Bibi,224,4,6,4,25000,3064,28064,125.28571
9063,Higienópolis,33,1,1,1,1990,520,2510,76.06061
9064,Outro,70,3,2,1,2000,480,2480,35.42857
9065,Consolação,37,1,1,1,2200,541,2741,74.08108
9066,Outro,250,4,6,4,25000,0,25000,100.0
9067,Outro,49,2,1,1,1400,0,1400,28.571428
9068,Santa Ifigênia,34,1,1,1,2500,523,3023,88.911766
9069,Santo Amaro,210,4,3,4,4000,3800,7800,37.142857
9070,Ipiranga,133,3,4,2,5500,1150,6650,50.0
9071,Jardim Paulista,135,3,4,3,16000,0,16000,118.51852
9072,Vila Mariana,87,3,3,2,3800,1000,4800,55.172413
9073,Itaim Bibi,110,2,3,2,15000,1700,16700,151.81818
9074,Freguesia do Ó,100,3,3,1,1899,860,2759,27.59
9075,Vila Formosa,65,2,2,1,3240,560,3800,58.46154
9076,Vila Mariana,37,1,1,1,1500,514,2014,54.432434
9077,Outro,77,3,2,1,2228,603,2831,36.766235
9078,Outro,55,2,1,1,1700,458,2158,39.236362
9079,Vila Mariana,115,3,3,3,6000,1708,7708,67.026085
9080,Higienópolis,107,3,2,2,4000,1633,5633,52.64486
9081,Jardim América,351,4,4,5,40000,6812,46812,133.36752
9082,Mirandópolis,65,2,1,1,1500,514,2014,30.984615
9083,Pompeia,41,1,1,1,2300,590,2890,70.48781
9084,Vila Leopoldina,57,2,1,1,1900,1080,2980,52.2807
9085,Outro,68,2,1,1,1900,0,1900,27.941177
9086,Brooklin,45,1,1,1,3200,580,3780,84.0
9087,Outro,35,1,1,1,3000,386,3386,96.74286
9088,Itaim Bibi,115,3,3,1,6000,1500,7500,65.21739
9089,Campo Belo,60,2,2,1,3900,743,4643,77.38333
9090,Bela Vista,43,1,1,0,1150,500,1650,38.372093
9091,Outro,93,3,3,2,3100,870,3970,42.68817
9092,Itaim Bibi,190,4,6,3,10900,2100,13000,68.42105
9093,Pinheiros,103,2,2,2,6300,1200,7500,72.81554
9094,Brooklin,45,1,1,1,2000,850,2850,63.333332
9095,Móoca,90,3,3,2,2500,950,3450,38.333332
9096,Chácara Santo Antônio,37,1,1,1,2000,540,2540,68.64865
9097,Vila Leopoldina,83,3,2,2,3300,950,4250,51.20482
9098,Vila Carrão,40,2,1,0,1300,150,1450,36.25
9099,Aclimação,58,2,1,1,1600,490,2090,36.03448
9100,Morumbi,107,2,3,2,2500,1680,4180,39.065422
9101,Santana,40,1,1,0,1100,100,1200,30.0
9102,Jardim Paulista,35,1,1,1,1600,509,2109,60.25714
9103,Vila Mariana,165,3,5,4,8000,1450,9450,57.272728
9104,Vila Clementino,100,3,4,2,5600,1350,6950,69.5
9105,Campo Belo,66,2,1,1,3300,718,4018,60.878788
9106,Saúde,95,3,2,2,4300,681,4981,52.43158
9107,Cambuci,72,2,1,1,2000,668,2668,37.055557
9108,Outro,30,1,1,0,1300,0,1300,43.333332
9109,Centro,65,2,2,1,3500,900,4400,67.69231
9110,Outro,56,2,1,1,1500,515,2015,35.982143
9111,Jardim Marajoara,60,3,1,1,1800,436,2236,37.266666
9112,Pinheiros,102,3,2,2,4476,1491,5967,58.5
9113,Brooklin,70,3,3,1,2200,836,3036,43.37143
9114,Jardim Paulista,65,2,2,2,4000,850,4850,74.61539
9115,Bela Vista,150,2,3,2,18000,2200,20200,134.66667
9116,Saúde,40,1,1,1,1200,1300,2500,62.5
9117,Alto da Lapa,117,3,3,2,2300,1276,3576,30.564102
9118,Jardim Paulista,66,1,1,1,8000,0,8000,121.21212
9119,Santana,65,3,2,2,2200,622,2822,43.415386
9120,Santa Cecília,60,2,1,0,2800,680,3480,58.0
9121,Brooklin,75,2,2,1,2500,849,3349,44.65333
9122,Vila Mariana,80,2,3,1,2500,840,3340,41.75
9123,Vila Mariana,51,2,1,1,1700,623,2323,45.54902
9124,Brooklin,52,2,1,1,3402,949,4351,83.67308
9125,Vila Leopoldina,70,2,2,1,2000,598,2598,37.114285
9126,Pinheiros,44,1,1,1,3500,0,3500,79.545456
9127,Outro,90,3,2,1,1400,440,1840,20.444445
9128,Morumbi,70,2,2,2,3500,850,4350,62.142857
9129,Brooklin,52,2,2,1,2500,843,3343,64.28846
9130,Tatuapé,35,1,1,1,2200,360,2560,73.14286
9131,Outro,55,2,1,1,1200,815,2015,36.636364
9132,Outro,60,2,2,0,1300,0,1300,21.666666
9133,Cambuci,39,1,1,1,2260,530,2790,71.53846
9134,Outro,211,3,6,3,3500,1948,5448,25.819904
9135,Moema,94,3,3,2,4200,1137,5337,56.776596
9136,Jardim Prudência,65,3,1,2,1850,10,1860,28.615385
9137,Itaim Bibi,98,2,3,1,4900,1174,6074,61.97959
9138,Brooklin,60,2,2,2,5500,0,5500,91.666664
9139,Paraíso,66,2,2,1,3500,880,4380,66.36364
9140,Outro,61,3,1,1,1300,650,1950,31.967213
9141,Ipiranga,120,3,1,3,4600,0,4600,38.333332
9142,Jardins,125,3,2,1,7500,1550,9050,72.4
9143,Bela Vista,33,1,1,0,1300,487,1787,54.151516
9144,Outro,50,2,1,1,1200,600,1800,36.0
9145,Pinheiros,63,2,2,1,2400,1060,3460,54.920635
9146,Itaim Bibi,110,2,2,2,12000,0,12000,109.09091
9147,Bela Vista,50,1,1,1,2400,490,2890,57.8
9148,Casa Verde,68,2,1,1,2300,654,2954,43.441177
9149,Higienópolis,113,3,4,1,5000,1995,6995,61.902657
9150,Outro,78,3,1,1,1550,440,1990,25.512821
9151,Alto de Pinheiros,260,4,4,5,12000,3600,15600,60.0
9152,Tatuapé,60,2,2,1,2850,493,3343,55.716667
9153,Jabaquara,40,1,1,1,1200,405,1605,40.125
9154,Outro,55,1,1,1,3500,600,4100,74.545456
9155,Outro,50,2,2,1,1250,250,1500,30.0
9156,Jardim Paulista,42,1,1,1,4000,0,4000,95.2381
9157,Vila Mariana,140,2,2,2,3300,1038,4338,30.985714
9158,Brás,40,1,1,1,1700,400,2100,52.5
9159,Consolação,120,4,3,2,6000,1250,7250,60.416668
9160,Moema,170,3,3,2,14000,2200,16200,95.29412
9161,Vila Mariana,36,1,1,1,2799,620,3419,94.97222
9162,Cambuci,30,1,1,0,1200,300,1500,50.0
9163,Jardim Paulista,65,2,2,1,2800,756,3556,54.70769
9164,Alto de Pinheiros,210,3,5,3,18151,4112,22263,106.01428
9165,Vila Mascote,90,2,2,2,2000,836,2836,31.51111
9166,Moema,45,1,1,1,1800,700,2500,55.555557
9167,Butantã,56,2,1,0,1490,405,1895,33.839287
9168,Vila Mascote,37,1,1,0,1850,150,2000,54.054054
9169,Outro,51,1,1,1,3500,584,4084,80.07843
9170,Butantã,60,2,1,1,2150,523,2673,44.55
9171,Vila Romana,98,3,4,2,3900,750,4650,47.44898
9172,Aclimação,42,1,1,1,1900,580,2480,59.04762
9173,Campo Belo,60,2,1,1,2500,990,3490,58.166668
9174,Alto Da Boa Vista,70,2,2,2,4500,853,5353,76.47143
9175,Higienópolis,200,3,3,2,4300,1627,5927,29.635
9176,Itaim Bibi,86,2,1,1,3500,790,4290,49.88372
9177,Outro,65,2,2,1,3000,691,3691,56.784615
9178,Consolação,35,1,1,1,3500,360,3860,110.28571
9179,Paraíso,60,2,2,1,4200,1350,5550,92.5
9180,Vila Olímpia,65,1,2,2,6000,970,6970,107.23077
9181,Água Branca,128,4,4,2,5500,1050,6550,51.171875
9182,Perdizes,68,2,3,2,3000,1180,4180,61.47059
9183,Higienópolis,60,2,2,1,5000,725,5725,95.416664
9184,Indianópolis,97,2,2,1,1900,1147,3047,31.41237
9185,Jabaquara,35,1,1,1,1300,390,1690,48.285713
9186,Santa Cecília,82,3,3,1,3000,990,3990,48.658535
9187,Vila Leopoldina,96,2,3,2,4700,1500,6200,64.583336
9188,Tatuapé,69,2,2,1,2200,450,2650,38.405796
9189,Perdizes,140,2,4,3,8100,1700,9800,70.0
9190,Tatuapé,40,1,1,1,1600,679,2279,56.975
9191,Outro,44,1,1,1,1600,536,2136,48.545456
9192,Cambuci,55,2,1,1,1200,300,1500,27.272728
9193,Perdizes,36,1,1,1,2150,463,2613,72.583336
9194,Vila Mariana,75,2,2,1,1950,500,2450,32.666668
9195,Outro,50,2,1,1,1200,0,1200,24.0
9196,Vila Prudente,75,3,2,1,1600,710,2310,30.8
9197,Vila Nova Conceição,60,2,1,1,2800,1401,4201,70.01667
9198,Indianópolis,31,1,1,0,3000,580,3580,115.48387
9199,Perdizes,64,2,2,1,2700,790,3490,54.53125
9200,Moema,134,2,3,2,15000,2145,17145,127.94776
9201,Outro,38,1,1,0,900,0,900,23.68421
9202,Móoca,330,4,7,6,7950,3390,11340,34.363636
9203,Vila Madalena,172,3,5,3,6400,2800,9200,53.488373
9204,Outro,50,2,1,0,1200,90,1290,25.8
9205,Bom Retiro,90,2,2,0,1600,300,1900,21.11111
9206,Sumaré,218,3,4,4,10800,3567,14367,65.90367
9207,Pinheiros,59,1,1,1,4100,800,4900,83.05085
9208,Chácara Santo Antônio,147,2,5,2,12000,1100,13100,89.11565
9209,Santa Cecília,33,1,1,1,2000,530,2530,76.666664
9210,Santa Cecília,160,3,3,4,7500,1700,9200,57.5
9211,Brooklin,49,1,2,1,3000,580,3580,73.061226
9212,Itaim Bibi,50,1,1,1,2700,755,3455,69.1
9213,Consolação,52,1,1,0,2000,562,2562,49.26923
9214,Outro,55,2,1,0,1600,430,2030,36.909092
9215,Vila Buarque,30,1,1,0,1100,470,1570,52.333332
9216,Ipiranga,55,2,1,0,1500,487,1987,36.127274
9217,Vila Olímpia,156,3,4,4,14000,1600,15600,100.0
9218,Moema,190,4,5,4,12000,2850,14850,78.1579
9219,Jardim Paulista,100,2,2,1,2850,1177,4027,40.27
9220,Vila Nova Conceição,57,1,1,0,1900,500,2400,42.105263
9221,Móoca,100,3,4,2,4500,510,5010,50.1
9222,Liberdade,50,2,1,0,1300,581,1881,37.62
9223,Jardim Paulista,106,3,2,2,7000,1934,8934,84.28302
9224,Vila Leopoldina,48,1,1,1,1950,454,2404,50.083332
9225,Outro,18,1,1,1,1000,150,1150,63.88889
9226,Vila Nova Conceição,105,2,2,1,6600,1480,8080,76.95238
9227,Vila Olímpia,100,3,2,2,3150,973,4123,41.23
9228,Vila Nova Conceição,126,3,5,2,7350,2228,9578,76.01588
9229,Pinheiros,100,2,2,1,2300,778,3078,30.78
9230,Chácara Santo Antônio,38,1,1,1,2300,482,2782,73.210526
9231,Butantã,50,2,1,1,2500,307,2807,56.14
9232,Moema,77,3,2,1,3800,975,4775,62.012985
9233,Vila Nova Conceição,386,4,5,4,37000,6850,43850,113.601036
9234,Bela Vista,32,1,1,1,1000,440,1440,45.0
9235,Vila Nova Conceição,234,3,5,4,36000,3000,39000,166.66667
9236,Outro,62,2,2,1,2400,500,2900,46.774193
9237,Pirituba,44,2,1,1,1650,300,1950,44.31818
9238,Tatuapé,64,3,1,1,1500,670,2170,33.90625
9239,Vila Mariana,85,2,2,1,3150,790,3940,46.35294
9240,Outro,60,2,2,1,2700,0,2700,45.0
9241,Vila Mariana,50,1,1,1,1100,954,2054,41.08
9242,Bela Vista,35,1,1,1,2400,1,2401,68.6
9243,Aclimação,39,1,1,1,2260,530,2790,71.53846
9244,Vila Olímpia,60,2,1,1,2400,871,3271,54.516666
9245,Aclimação,45,1,1,1,1700,610,2310,51.333332
9246,Jardim Anália Franco,164,3,5,4,10000,1443,11443,69.77439
9247,Cerqueira César,41,1,1,0,1390,384,1774,43.26829
9248,Outro,45,2,1,0,1500,0,1500,33.333332
9249,Outro,45,1,1,0,1400,216,1616,35.91111
9250,Vila Mariana,45,1,1,1,3120,830,3950,87.77778
9251,Saúde,60,2,2,1,2500,720,3220,53.666668
9252,Ipiranga,68,2,1,1,2600,622,3222,47.382355
9253,Vila Olímpia,78,2,2,1,9999,864,10863,139.26923
9254,Jardim Paulista,150,3,2,1,4500,1718,6218,41.453335
9255,República,24,1,1,0,1150,270,1420,59.166668
9256,Outro,62,3,1,1,1350,450,1800,29.032259
9257,Tatuapé,242,4,5,4,16000,1450,17450,72.10744
9258,Outro,45,1,1,0,1100,250,1350,30.0
9259,Brás,82,2,1,0,1500,340,1840,22.439024
9260,Outro,55,2,2,2,2500,799,3299,59.98182
9261,Brooklin,55,1,1,2,3100,970,4070,74.0
9262,Vila Buarque,50,1,1,0,1300,575,1875,37.5
9263,Cidade Monções,75,2,2,2,6800,1200,8000,106.666664
9264,Chácara Santo Antônio,186,3,4,3,8500,2530,11030,59.301075
9265,Outro,56,2,2,1,1950,590,2540,45.357143
9266,Jabaquara,33,1,1,0,1180,0,1180,35.757576
9267,Jardim Paulista,87,2,3,1,9500,1600,11100,127.586205
9268,Outro,54,2,1,1,1200,460,1660,30.74074
9269,Água Branca,105,3,3,1,2300,960,3260,31.047619
9270,Santa Cecília,28,1,1,1,1200,491,1691,60.392857
9271,Barra Funda,45,1,1,1,2300,550,2850,63.333332
9272,Brooklin,132,3,5,3,11500,1220,12720,96.36364
9273,Jaguaré,17,1,1,0,790,0,790,46.47059
9274,Vila Santa Catarina,55,2,1,1,1000,623,1623,29.50909
9275,Móoca,50,2,1,0,1300,500,1800,36.0
9276,Itaim Bibi,146,3,5,2,15000,1707,16707,114.4315
9277,Campo Belo,35,1,1,1,1800,570,2370,67.71429
9278,Bela Vista,35,1,1,1,1050,715,1765,50.42857
9279,Outro,70,2,2,1,2300,600,2900,41.42857
9280,Móoca,60,2,2,1,2000,120,2120,35.333332
9281,Brooklin,20,1,1,0,2450,0,2450,122.5
9282,Brooklin,60,2,1,1,2500,962,3462,57.7
9283,Morumbi,361,4,4,4,8000,2115,10115,28.01939
9284,Campo Belo,37,1,1,1,2050,560,2610,70.54054
9285,Vila Madalena,57,1,1,1,4450,1084,5534,97.08772
9286,Outro,50,2,2,1,850,600,1450,29.0
9287,Brooklin,57,1,2,1,3500,1128,4628,81.192986
9288,Vila Mascote,48,1,1,1,920,516,1436,29.916666
9289,Bela Vista,54,2,1,1,3400,936,4336,80.296295
9290,Liberdade,45,1,1,0,1000,300,1300,28.88889
9291,Vila Mascote,53,1,2,1,2800,400,3200,60.377357
9292,Higienópolis,44,1,1,1,2200,1000,3200,72.72727
9293,Vila Andrade,48,2,1,1,1700,390,2090,43.541668
9294,Bela Vista,78,2,2,2,5000,550,5550,71.15385
9295,Campo Belo,51,1,1,1,3200,590,3790,74.31373
9296,Outro,55,1,1,0,1800,279,2079,37.8
9297,Tatuapé,123,3,2,2,2541,771,3312,26.926828
9298,Jardim Marajoara,75,3,2,2,1500,706,2206,29.413334
9299,Outro,85,3,2,2,1850,780,2630,30.941177
9300,Barra Funda,45,1,1,0,1200,369,1569,34.866665
9301,Liberdade,50,1,1,1,1700,420,2120,42.4
9302,Higienópolis,70,2,1,0,2220,675,2895,41.357143
9303,Vila Olímpia,128,3,4,3,12400,1550,13950,108.984375
9304,Vila Mariana,38,1,1,1,3000,440,3440,90.52631
9305,Moema,31,1,1,1,3400,31,3431,110.67742
9306,Moema,210,3,5,3,21700,2000,23700,112.85714
9307,Vila Olímpia,74,2,2,2,5450,853,6303,85.175674
9308,Outro,70,3,2,1,2000,350,2350,33.57143
9309,Butantã,30,1,1,0,1200,350,1550,51.666668
9310,Paraíso,80,2,3,2,3200,901,4101,51.2625
9311,Bom Retiro,78,2,1,0,1600,100,1700,21.794872
9312,Higienópolis,202,4,6,4,6485,2500,8985,44.480198
9313,Outro,30,1,1,0,1000,222,1222,40.733334
9314,Jardins,110,3,3,1,4300,1445,5745,52.227272
9315,Butantã,17,1,1,0,1350,0,1350,79.411766
9316,Pinheiros,40,1,1,1,3000,770,3770,94.25
9317,Santana,62,2,1,1,1750,735,2485,40.080647
9318,Morumbi,58,2,2,1,1500,600,2100,36.206898
9319,Brooklin,95,2,2,0,2950,869,3819,40.2
9320,Outro,78,2,2,1,2000,350,2350,30.128204
9321,Pinheiros,270,4,6,4,14000,3500,17500,64.81481
9322,Perdizes,110,3,3,2,3500,1050,4550,41.363636
9323,Vila Guarani,42,1,1,1,1250,658,1908,45.42857
9324,Outro,70,3,2,1,2300,670,2970,42.42857
9325,Vila Formosa,71,3,1,1,1400,370,1770,24.929577
9326,Vila Mariana,30,1,1,0,1400,130,1530,51.0
9327,Ipiranga,31,1,1,1,1500,474,1974,63.677418
9328,Jabaquara,56,2,2,2,1600,543,2143,38.267857
9329,Santa Cecília,70,2,1,0,1800,160,1960,28.0
9330,Consolação,39,1,1,1,2200,392,2592,66.46154
9331,Outro,286,5,5,4,11000,2800,13800,48.251747
9332,Pinheiros,163,3,4,2,5000,1704,6704,41.128834
9333,Jardim Paulista,600,2,3,2,43000,1511,44511,74.185
9334,Outro,104,3,3,2,3800,810,4610,44.326923
9335,Vila Mariana,78,2,2,2,3100,970,4070,52.179485
9336,Bela Vista,57,1,1,0,1200,430,1630,28.59649
9337,Vila Nova Conceição,78,1,1,1,9192,2308,11500,147.4359
9338,Jardim Paulista,55,2,1,1,2800,950,3750,68.181816
9339,Jardim Europa,140,3,1,1,6000,1400,7400,52.857143
9340,Tatuapé,45,1,1,1,2350,458,2808,62.4
9341,Santana,90,3,2,1,1650,916,2566,28.51111
9342,Jardim América,30,1,1,1,1750,720,2470,82.333336
9343,Perdizes,110,3,2,1,2500,1256,3756,34.145454
9344,Bela Vista,63,2,1,1,5600,0,5600,88.888885
9345,Vila Mariana,76,2,2,1,1880,1290,3170,41.710526
9346,Granja Julieta,240,4,4,4,14000,3300,17300,72.083336
9347,Itaim Bibi,46,1,1,1,3943,815,4758,103.434784
9348,Santana,68,2,1,1,1700,750,2450,36.02941
9349,Outro,75,3,1,1,1500,770,2270,30.266666
9350,Saúde,40,1,1,1,2500,782,3282,82.05
9351,Ipiranga,67,2,2,1,3800,539,4339,64.76119
9352,Outro,40,2,1,0,1400,100,1500,37.5
9353,Vila Nova Conceição,85,2,2,0,3000,660,3660,43.058823
9354,Santo Amaro,85,3,2,1,4000,0,4000,47.058823
9355,Outro,60,2,1,1,1600,250,1850,30.833334
9356,Outro,35,1,2,1,1350,750,2100,60.0
9357,Vila Mariana,45,1,1,0,1500,160,1660,36.88889
9358,Liberdade,60,2,1,1,3000,750,3750,62.5
9359,Outro,64,2,1,1,1300,670,1970,30.78125
9360,Vila Mariana,20,1,1,1,2500,400,2900,145.0
9361,Consolação,120,2,3,1,5400,1419,6819,56.825
9362,Granja Julieta,38,1,1,1,2500,507,3007,79.13158
9363,Vila Prudente,104,2,3,2,3600,812,4412,42.423077
9364,Pompeia,60,2,2,1,2200,930,3130,52.166668
9365,Morumbi,65,3,1,1,1550,490,2040,31.384615
9366,Centro,35,1,1,0,700,350,1050,30.0
9367,Outro,63,2,2,2,2500,629,3129,49.666668
9368,Jardim América,85,2,2,0,3000,926,3926,46.188236
9369,Bela Vista,35,1,1,1,1300,1151,2451,70.02857
9370,Cidade Monções,70,1,1,1,5500,994,6494,92.77143
9371,Outro,50,2,1,1,1300,350,1650,33.0
9372,Brooklin,75,2,2,1,2900,1250,4150,55.333332
9373,República,30,1,1,1,2400,950,3350,111.666664
9374,Jardim Anália Franco,109,3,2,2,4000,874,4874,44.715595
9375,Vila Olímpia,60,2,1,1,2600,950,3550,59.166668
9376,Campo Belo,47,1,1,1,2600,574,3174,67.53191
9377,Aclimação,34,1,1,1,1950,615,2565,75.44118
9378,Moema,70,2,3,1,3500,785,4285,61.214287
9379,Bela Vista,50,2,1,1,3490,790,4280,85.6
9380,Higienópolis,90,2,2,1,2600,960,3560,39.555557
9381,Santa Cecília,50,2,1,1,1800,500,2300,46.0
9382,Campo Belo,50,1,1,1,3700,428,4128,82.56
9383,Vila Mariana,90,2,1,1,2000,1148,3148,34.97778
9384,Outro,75,3,2,1,1300,700,2000,26.666666
9385,Pinheiros,110,3,2,1,7500,1550,9050,82.27273
9386,Aclimação,176,4,5,3,8500,1260,9760,55.454544
9387,Jardim Paulista,280,4,5,2,10000,4540,14540,51.92857
9388,Bela Vista,25,1,1,0,1850,290,2140,85.6
9389,Vila Clementino,68,2,2,1,2500,882,3382,49.735294
9390,Higienópolis,164,3,2,2,4985,2400,7385,45.030487
9391,Liberdade,44,1,1,1,1850,660,2510,57.045456
9392,Outro,71,3,2,1,2100,550,2650,37.323944
9393,Campo Belo,70,1,1,1,4500,1150,5650,80.71429
9394,Vila Buarque,86,1,1,0,2100,440,2540,29.534883
9395,Bela Vista,48,1,1,1,3200,0,3200,66.666664
9396,Itaim Bibi,50,1,2,1,2800,856,3656,73.12
9397,Pinheiros,50,2,1,1,3170,800,3970,79.4
9398,Pinheiros,88,2,2,2,9700,1380,11080,125.90909
9399,Outro,96,3,3,2,3500,1018,4518,47.0625
9400,Indianópolis,86,2,2,1,3000,772,3772,43.860466
9401,Outro,200,4,6,4,8000,3200,11200,56.0
9402,Outro,100,3,3,2,2900,1134,4034,40.34
9403,Vila Olímpia,127,3,4,2,12000,1400,13400,105.51181
9404,Vila Nova Conceição,128,3,3,3,5000,2250,7250,56.640625
9405,Vila Olímpia,48,1,1,2,8500,0,8500,177.08333
9406,Vila Madalena,78,2,2,2,2040,538,2578,33.05128
9407,Mirandópolis,50,2,1,0,1500,750,2250,45.0
9408,Pompeia,75,3,2,2,3000,950,3950,52.666668
9409,Outro,50,2,1,0,1200,483,1683,33.66
9410,Vila Leopoldina,153,3,4,3,9000,1200,10200,66.666664
9411,Jardim América,160,3,4,2,6500,2200,8700,54.375
9412,Outro,69,2,1,1,2200,450,2650,38.405796
9413,Perdizes,55,2,2,1,3000,470,3470,63.090908
9414,Moema,170,3,4,3,13000,2296,15296,89.97647
9415,Brooklin,80,3,3,1,2700,843,3543,44.2875
9416,Vila Buarque,35,1,1,1,1300,800,2100,60.0
9417,Pinheiros,90,3,3,2,6300,1100,7400,82.22222
9418,Vila Clementino,45,1,1,0,1800,0,1800,40.0
9419,Consolação,33,1,1,1,1600,575,2175,65.90909
9420,Jardim Europa,190,3,4,2,10000,4050,14050,73.947365
9421,Vila Madalena,104,3,3,3,6700,1800,8500,81.73077
9422,Outro,100,2,1,1,1900,0,1900,19.0
9423,Itaim Bibi,128,3,4,3,12000,1750,13750,107.421875
9424,Outro,49,2,1,1,2200,485,2685,54.795918
9425,Santa Cecília,85,2,2,0,2600,840,3440,40.47059
9426,Jardim Paulista,168,3,2,1,6000,1800,7800,46.42857
9427,Itaim Bibi,190,3,3,3,10000,2263,12263,64.54211
9428,Vila Olímpia,67,2,2,1,2600,969,3569,53.268658
9429,Outro,47,2,1,1,1000,200,1200,25.531916
9430,Outro,60,2,2,1,1800,773,2573,42.883335
9431,República,35,1,1,0,1300,555,1855,53.0
9432,Itaim Bibi,40,1,1,1,5000,700,5700,142.5
9433,Vila Mariana,70,2,2,1,2500,770,3270,46.714287
9434,Santa Cecília,30,1,1,1,2000,616,2616,87.2
9435,Vila Olímpia,45,1,1,1,3800,654,4454,98.977776
9436,Brooklin,134,3,4,2,10000,1300,11300,84.32836
9437,Itaim Bibi,130,3,3,2,6500,2249,8749,67.3
9438,Pinheiros,91,2,2,1,3000,1100,4100,45.054947
9439,Moema,31,1,1,1,4000,360,4360,140.64516
9440,Vila Madalena,25,1,1,0,2100,700,2800,112.0
9441,Morumbi,64,2,2,1,2250,460,2710,42.34375
9442,Vila Guarani,94,3,3,1,3600,600,4200,44.68085
9443,Santana,92,3,3,2,2750,1250,4000,43.47826
9444,Outro,97,3,3,2,2800,790,3590,37.01031
9445,Itaim Bibi,85,2,2,2,4500,1285,5785,68.05882
9446,Vila Leopoldina,74,2,3,1,2500,0,2500,33.783783
9447,Cidade Monções,38,1,1,1,3300,550,3850,101.31579
9448,Moema,48,1,2,1,3180,949,4129,86.020836
9449,Outro,58,2,1,1,1300,0,1300,22.413794
9450,Itaim Bibi,45,1,1,1,1800,762,2562,56.933334
9451,Campos Eliseos,34,1,1,1,1300,451,1751,51.5
9452,Saúde,50,1,1,1,2700,0,2700,54.0
9453,Brooklin,156,3,5,3,10000,1800,11800,75.64103
9454,Saúde,85,3,2,1,2000,780,2780,32.705883
9455,Higienópolis,134,4,3,1,4890,1844,6734,50.25373
9456,Jardim Prudência,52,2,1,1,2500,680,3180,61.153847
9457,Outro,120,3,4,2,5500,890,6390,53.25
9458,Vila Olímpia,89,3,2,2,6170,914,7084,79.595505
9459,Vila Mariana,67,2,2,1,3000,550,3550,52.985073
9460,Vila Carrão,84,2,2,2,3600,600,4200,50.0
9461,Bela Vista,42,1,1,1,2700,431,3131,74.54762
9462,Itaim Bibi,105,3,3,1,5500,1346,6846,65.2
9463,Campo Belo,110,3,4,2,4000,1127,5127,46.609093
9464,Pirituba,74,3,2,2,3500,0,3500,47.2973
9465,Outro,50,2,1,1,1300,430,1730,34.6
9466,Campo Belo,50,1,2,1,3500,650,4150,83.0
9467,Outro,55,2,1,1,1000,300,1300,23.636364
9468,Brooklin,50,1,2,1,3150,651,3801,76.02
9469,Bela Vista,52,1,1,0,2500,390,2890,55.576923
9470,Bela Vista,32,1,1,0,1500,375,1875,58.59375
9471,Pinheiros,160,3,4,2,5300,1800,7100,44.375
9472,Bela Vista,53,2,2,1,2300,863,3163,59.679245
9473,Campo Belo,177,3,5,4,6447,3191,9638,54.451977
9474,Saúde,34,1,1,1,1500,600,2100,61.764706
9475,Jardim Marajoara,64,3,2,1,1570,780,2350,36.71875
9476,Paraíso,140,3,3,2,3850,1950,5800,41.42857
9477,Outro,48,2,1,1,1000,190,1190,24.791666
9478,Pinheiros,76,2,2,1,2780,882,3662,48.18421
9479,Outro,38,1,1,1,1000,943,1943,51.13158
9480,Perdizes,168,4,3,2,4300,1933,6233,37.10119
9481,Higienópolis,168,4,2,3,5700,2750,8450,50.29762
9482,Outro,271,4,4,4,15000,3500,18500,68.265686
9483,Vila Prudente,56,2,1,1,2770,0,2770,49.464287
9484,Jardim Anália Franco,156,3,4,4,3300,1427,4727,30.301283
9485,Vila Mascote,103,3,3,2,3000,1200,4200,40.7767
9486,Santo Amaro,280,4,6,3,10000,2300,12300,43.92857
9487,Brooklin,85,2,3,2,8500,1110,9610,113.05882
9488,Outro,100,3,3,3,3900,1000,4900,49.0
9489,Brás,50,2,1,1,1600,370,1970,39.4
9490,Outro,40,1,1,1,950,320,1270,31.75
9491,Santa Cecília,65,1,1,0,1200,572,1772,27.261538
9492,Paraíso,65,2,1,1,3350,880,4230,65.07692
9493,Cidade Monções,172,3,3,3,8770,2000,10770,62.61628
9494,Campo Belo,75,2,2,1,1180,1384,2564,34.18667
9495,Vila Buarque,45,2,1,1,1400,500,1900,42.22222
9496,Chácara Santo Antônio,143,3,5,2,6200,1050,7250,50.6993
9497,Outro,49,2,1,1,900,390,1290,26.32653
9498,Brooklin,67,1,2,2,4000,793,4793,71.537315
9499,Santana,49,1,1,1,2350,507,2857,58.30612
9500,Outro,50,2,1,1,1450,525,1975,39.5
9501,Outro,74,2,2,1,2440,1401,3841,51.905407
9502,Vila Romana,172,3,4,4,13985,1800,15785,91.773254
9503,Outro,65,3,1,1,1150,570,1720,26.461538
9504,Outro,24,1,1,1,1200,212,1412,58.833332
9505,Jaguaré,70,3,2,2,2400,705,3105,44.357143
9506,Vila Santa Catarina,147,3,4,2,5000,1200,6200,42.176872
9507,Perdizes,80,2,2,1,2700,998,3698,46.225
9508,Itaim Bibi,40,1,1,1,4200,583,4783,119.575
9509,Campo Belo,268,3,1,2,15800,2450,18250,68.097015
9510,Outro,75,2,2,1,2800,917,3717,49.56
9511,Saúde,70,2,2,1,1860,970,2830,40.42857
9512,Campo Belo,201,4,4,4,14000,2300,16300,81.09453
9513,Vila Mariana,80,2,1,1,2500,750,3250,40.625
9514,Aclimação,60,2,1,0,1400,369,1769,29.483334
9515,Outro,90,3,2,1,1600,710,2310,25.666666
9516,Móoca,55,2,2,1,2700,270,2970,54.0
9517,Jardim Prudência,69,3,2,1,2204,760,2964,42.95652
9518,Barra Funda,128,4,3,2,5500,1200,6700,52.34375
9519,Alto da Lapa,92,1,1,1,3200,1,3201,34.79348
9520,Brooklin,43,1,1,1,2100,850,2950,68.60465
9521,Moema,36,1,1,1,1500,1150,2650,73.611115
9522,Aclimação,105,2,3,2,7200,0,7200,68.57143
9523,Brooklin,98,2,3,2,8750,1700,10450,106.63265
9524,Santa Ifigênia,44,1,1,1,2700,664,3364,76.454544
9525,Outro,42,2,1,0,1100,270,1370,32.61905
9526,Brooklin,157,3,3,2,4000,1510,5510,35.095543
9527,Cerqueira César,100,2,2,1,4300,1124,5424,54.24
9528,Outro,59,2,2,1,1500,730,2230,37.79661
9529,Paraíso,77,2,2,1,7000,1000,8000,103.8961
9530,Brooklin,127,3,3,3,7000,1700,8700,68.50394
9531,Jardim Paulista,110,3,3,2,4000,1835,5835,53.045456
9532,Outro,86,2,3,2,4300,820,5120,59.534885
9533,Jardim Marajoara,50,2,1,1,1600,650,2250,45.0
9534,Brás,48,2,1,1,1700,360,2060,42.916668
9535,Granja Julieta,75,2,1,2,3800,750,4550,60.666668
9536,Pinheiros,120,3,3,2,3900,1496,5396,44.966667
9537,Outro,68,3,1,1,1700,650,2350,34.558823
9538,Chácara Klabin,70,3,2,1,2700,929,3629,51.842857
9539,Vila Mariana,84,2,1,1,3600,522,4122,49.07143
9540,Campo Belo,42,1,1,1,2700,545,3245,77.2619
9541,Outro,157,4,4,4,7000,1400,8400,53.503185
9542,Vila Romana,94,2,2,2,4900,750,5650,60.106384
9543,Água Branca,58,2,2,1,2500,550,3050,52.58621
9544,Itaim Bibi,61,1,2,2,3500,1823,5323,87.2623
9545,Higienópolis,41,1,1,1,1900,660,2560,62.439026
9546,Jabaquara,38,1,1,1,1800,349,2149,56.55263
9547,Outro,45,2,1,1,1000,427,1427,31.711111
9548,Cerqueira César,72,2,2,1,2600,832,3432,47.666668
9549,Itaim Bibi,49,1,1,1,3000,1000,4000,81.63265
9550,Água Branca,128,3,4,2,10350,801,11151,87.11719
9551,Santa Cecília,110,2,1,0,2000,570,2570,23.363636
9552,Campo Belo,180,4,4,2,2900,1875,4775,26.527779
9553,Pinheiros,63,2,2,1,3300,1050,4350,69.04762
9554,Saúde,55,2,2,1,1665,954,2619,47.618183
9555,Vila Olímpia,27,1,1,1,4000,0,4000,148.14815
9556,Vila Uberabinha,56,2,2,1,2100,936,3036,54.214287
9557,Vila Cruzeiro,60,1,1,1,3100,535,3635,60.583332
9558,Vila Leopoldina,158,3,5,2,7500,1200,8700,55.06329
9559,Outro,74,3,2,1,1700,500,2200,29.72973
9560,Jardim Paulista,223,3,5,4,20000,3422,23422,105.03139
9561,Higienópolis,66,2,2,1,3000,970,3970,60.151516
9562,Vila Nova Conceição,161,3,4,4,12000,2300,14300,88.81988
9563,Santana,52,2,1,1,1400,529,1929,37.096153
9564,Ipiranga,237,4,4,3,10000,1800,11800,49.78903
9565,Paraíso,71,2,2,1,3100,797,3897,54.887325
9566,Brooklin,189,3,4,3,10000,2500,12500,66.137566
9567,Vila Madalena,70,1,1,1,5700,985,6685,95.5
9568,Consolação,57,2,2,1,5800,600,6400,112.2807
9569,Liberdade,25,1,1,0,1700,447,2147,85.88
9570,Vila Mariana,60,2,2,1,2800,685,3485,58.083332
9571,Outro,50,2,1,1,1000,290,1290,25.8
9572,Outro,61,2,2,1,2500,210,2710,44.42623
9573,Outro,50,2,1,1,1000,584,1584,31.68
9574,Vila Madalena,79,2,3,2,5000,1370,6370,80.63291
9575,Outro,64,2,2,1,1100,790,1890,29.53125
9576,Outro,50,2,1,1,1600,400,2000,40.0
9577,Higienópolis,303,4,4,4,9500,5620,15120,49.90099
9578,Morumbi,78,3,2,1,1800,788,2588,33.179485
9579,Lapa,70,2,1,0,1600,290,1890,27.0
9580,Vila Clementino,57,2,1,1,3200,621,3821,67.03509
9581,Santana,58,2,2,0,1200,680,1880,32.41379
9582,Móoca,70,3,1,1,1900,735,2635,37.642857
9583,Outro,67,2,2,1,3200,790,3990,59.55224
9584,Jardim Paulista,100,1,2,1,13000,0,13000,130.0
9585,Vila Andrade,96,2,2,2,3300,800,4100,42.708332
9586,Bela Vista,28,1,1,0,1100,374,1474,52.642857
9587,Vila Leopoldina,82,3,2,2,3300,950,4250,51.82927
9588,Perdizes,100,3,2,1,2500,790,3290,32.9
9589,Bela Vista,42,1,1,1,2700,431,3131,74.54762
9590,Vila Mariana,40,1,1,0,1600,858,2458,61.45
9591,Outro,60,2,2,1,1300,539,1839,30.65
9592,Brás,55,2,1,1,1300,600,1900,34.545456
9593,Santo Amaro,130,3,2,2,7000,1150,8150,62.692307
9594,Morumbi,190,3,3,2,4875,681,5556,29.242105
9595,Ipiranga,39,1,1,1,1800,420,2220,56.923077
9596,Itaim Bibi,62,1,2,1,12000,0,12000,193.54839
9597,Higienópolis,122,2,3,1,3500,1100,4600,37.704918
9598,Jardim América,120,2,2,0,4500,1466,5966,49.716667
9599,Jardim Paulista,500,5,7,7,60000,7000,67000,134.0
9600,Vila Leopoldina,172,3,4,3,6200,1520,7720,44.88372
9601,Itaim Bibi,236,4,6,4,15000,3940,18940,80.254234
9602,Freguesia do Ó,53,2,1,2,1915,535,2450,46.226414
9603,Ipiranga,80,2,2,1,1800,700,2500,31.25
9604,Aclimação,78,2,2,2,2500,230,2730,35.0
9605,Brooklin,124,3,5,2,7500,1056,8556,69.0
9606,Consolação,48,1,1,1,1800,439,2239,46.645832
9607,Pinheiros,43,1,1,1,3000,818,3818,88.790695
9608,Ipiranga,59,2,1,1,2070,760,2830,47.966103
9609,Itaim Bibi,130,3,3,2,6500,2250,8750,67.30769
9610,Pinheiros,75,2,2,0,2200,900,3100,41.333332
9611,Brooklin,55,2,1,1,2500,962,3462,62.945454
9612,Outro,226,4,5,4,6000,2800,8800,38.938053
9613,Vila Olímpia,62,1,2,1,4850,1500,6350,102.41936
9614,Outro,57,2,2,1,1400,800,2200,38.596493
9615,Outro,45,2,1,1,1400,0,1400,31.11111
9616,Butantã,57,2,2,2,1600,1100,2700,47.36842
9617,Santana,44,1,1,1,2100,523,2623,59.613636
9618,Outro,64,2,1,1,1400,700,2100,32.8125
9619,Jardim Europa,97,2,2,1,5500,1890,7390,76.18557
9620,Barra Funda,33,1,1,0,1800,290,2090,63.333332
9621,Vila Olímpia,65,2,2,2,2700,983,3683,56.661537
9622,Outro,55,2,1,1,1600,650,2250,40.909092
9623,Vila Mascote,37,2,1,0,2100,150,2250,60.81081
9624,Vila Nova Conceição,50,2,1,1,1350,810,2160,43.2
9625,Moema,45,1,2,1,1600,830,2430,54.0
9626,Cidade Monções,70,2,1,1,4450,712,5162,73.74286
9627,Cerqueira César,155,1,1,2,9000,2448,11448,73.85806
9628,República,261,3,3,1,8540,4100,12640,48.42912
9629,Jardim Paulista,72,1,2,1,4500,800,5300,73.611115
9630,Jardim Marajoara,82,3,2,1,2200,800,3000,36.585365
9631,Jardins,206,3,5,4,20000,3350,23350,113.34952
9632,Vila Guarani,58,2,1,1,1400,850,2250,38.793102
9633,Cerqueira César,170,3,5,3,7560,2284,9844,57.905884
9634,Pinheiros,69,2,2,1,3400,830,4230,61.304348
9635,Jabaquara,47,2,1,1,1500,600,2100,44.68085
9636,Jardim América,209,3,4,4,30000,4200,34200,163.63637
9637,Vila Clementino,85,3,3,2,3200,1150,4350,51.17647
9638,Liberdade,70,1,1,0,1200,450,1650,23.571428
9639,Itaim Bibi,77,1,2,1,4000,870,4870,63.246754
9640,Pompeia,61,2,2,1,2500,930,3430,56.229507
9641,Pinheiros,36,1,1,1,6500,0,6500,180.55556
9642,Outro,50,2,1,1,742,258,1000,20.0
9643,Campo Belo,160,3,3,3,5200,2000,7200,45.0
9644,Indianópolis,210,4,5,4,12500,0,12500,59.52381
9645,Vila Romana,200,4,2,3,6000,2000,8000,40.0
9646,Itaim Bibi,60,2,2,1,2200,550,2750,45.833332
9647,Outro,62,2,1,1,1150,420,1570,25.32258
9648,Brooklin,85,3,3,2,3600,823,4423,52.035294
9649,Outro,44,2,1,0,1300,0,1300,29.545454
9650,Santana,164,4,4,2,3500,1530,5030,30.670732
9651,Outro,89,2,1,1,2500,889,3389,38.07865
9652,Pinheiros,65,2,2,1,4400,820,5220,80.30769
9653,Jardim América,105,2,3,1,5300,1038,6338,60.361904
9654,Moema,45,1,1,0,2600,0,2600,57.77778
9655,Vila Buarque,25,1,1,0,2000,365,2365,94.6
9656,Tatuapé,137,3,3,3,3000,1395,4395,32.08029
9657,Paraíso,147,3,3,2,3800,1530,5330,36.258503
9658,Moema,123,3,4,2,8000,1253,9253,75.227646
9659,Outro,50,2,1,1,1500,500,2000,40.0
9660,Vila Mariana,70,2,1,0,2200,310,2510,35.857143
9661,Vila Nova Conceição,57,2,2,1,2800,1259,4059,71.210526
9662,Paraíso,60,1,1,0,1850,350,2200,36.666668
9663,Vila Nova Conceição,401,3,3,5,45000,5300,50300,125.43641
9664,Vila Mariana,119,3,2,2,6200,1400,7600,63.865547
9665,Vila Uberabinha,120,4,2,0,6000,1250,7250,60.416668
9666,Indianópolis,170,4,4,2,6000,1576,7576,44.564705
9667,Itaim Bibi,50,1,1,0,4300,100,4400,88.0
9668,Outro,43,2,1,0,1300,250,1550,36.046513
9669,Butantã,65,2,2,2,1700,730,2430,37.384617
9670,Panamby,58,2,2,1,1500,600,2100,36.206898
9671,Cambuci,60,2,2,1,2700,790,3490,58.166668
9672,Brooklin,120,3,3,2,6500,1650,8150,67.916664
9673,Itaim Bibi,80,2,1,2,2900,1083,3983,49.7875
9674,Santa Cecília,30,1,1,1,2200,435,2635,87.833336
9675,Jardim Paulista,50,2,1,1,2600,837,3437,68.74
9676,Pompeia,60,2,2,2,2600,900,3500,58.333332
9677,Santa Cecília,30,1,1,0,1200,385,1585,52.833332
9678,Jardim Paulista,130,3,3,1,4200,1757,5957,45.82308
9679,Itaim Bibi,153,2,4,1,16000,1800,17800,116.33987
9680,Higienópolis,64,2,1,1,2000,669,2669,41.703125
9681,Consolação,40,1,1,1,2250,590,2840,71.0
9682,Casa Verde,40,1,1,0,750,0,750,18.75
9683,Granja Julieta,168,3,5,3,8000,1300,9300,55.357143
9684,Santa Cecília,34,1,1,1,2500,450,2950,86.76471
9685,Cerqueira César,40,1,1,1,1700,590,2290,57.25
9686,Pinheiros,50,1,1,0,2700,651,3351,67.02
9687,Casa Verde,78,3,2,2,1800,800,2600,33.333332
9688,Itaim Bibi,48,1,2,1,2000,687,2687,55.979168
9689,Vila Olímpia,56,2,2,2,2750,1130,3880,69.28571
9690,Outro,49,2,1,1,2530,336,2866,58.489796
9691,Vila Olímpia,55,1,1,1,4000,850,4850,88.181816
9692,Bela Vista,60,1,1,0,1350,525,1875,31.25
9693,Higienópolis,45,1,1,1,3000,1165,4165,92.55556
9694,Vila Guarani,49,1,1,1,1500,350,1850,37.7551
9695,Pirituba,52,2,1,1,1550,470,2020,38.846153
9696,Moema,130,3,2,2,3200,0,3200,24.615385
9697,Vila Clementino,70,2,1,1,2000,918,2918,41.685715
9698,Vila Olímpia,70,2,1,1,8000,975,8975,128.21428
9699,Outro,84,3,2,2,3800,560,4360,51.904762
9700,Vila Buarque,60,2,1,0,2500,450,2950,49.166668
9701,Liberdade,55,2,1,1,1700,600,2300,41.81818
9702,Jardim Anália Franco,131,3,1,3,5500,1400,6900,52.671757
9703,Pinheiros,55,2,1,0,2100,467,2567,46.672726
9704,Outro,62,2,2,1,2800,550,3350,54.032257
9705,Itaim Bibi,118,3,4,2,7000,2041,9041,76.618645
9706,Chácara Santo Antônio,54,2,1,1,2800,550,3350,62.037037
9707,Brooklin,45,1,1,1,2200,870,3070,68.22222
9708,Pompeia,81,3,3,2,2800,898,3698,45.65432
9709,Vila Clementino,60,2,2,1,3500,580,4080,68.0
9710,Pirituba,49,2,1,1,2300,540,2840,57.959183
9711,Vila Mariana,64,2,2,1,2400,550,2950,46.09375
9712,Ipiranga,15,1,1,0,1050,0,1050,70.0
9713,Bela Vista,41,1,1,1,3400,662,4062,99.07317
9714,Bela Vista,165,3,2,1,3390,1337,4727,28.648485
9715,Consolação,65,1,1,1,1450,850,2300,35.384617
9716,Mirandópolis,27,1,1,0,900,200,1100,40.74074
9717,Outro,110,3,4,2,5500,1200,6700,60.909092
9718,Outro,64,2,1,1,1500,282,1782,27.84375
9719,Outro,60,2,1,1,1160,240,1400,23.333334
9720,Cerqueira César,100,2,3,1,6000,1638,7638,76.38
9721,Outro,50,1,1,1,4000,742,4742,94.84
9722,Cambuci,36,1,1,1,1530,660,2190,60.833332
9723,Pinheiros,140,3,4,2,13000,1550,14550,103.92857
9724,Santo Amaro,53,1,2,1,2990,875,3865,72.92453
9725,Vila Leopoldina,140,3,3,2,5500,1400,6900,49.285713
9726,Cambuci,27,1,1,0,1300,150,1450,53.703705
9727,Itaim Bibi,35,1,1,1,2800,750,3550,101.42857
9728,Santa Ifigênia,46,1,1,1,1800,1300,3100,67.391304
9729,Jardim Paulista,60,2,2,0,1800,886,2686,44.766666
9730,Campo Belo,130,3,5,2,4980,1400,6380,49.076923
9731,Pompeia,40,1,1,1,2100,530,2630,65.75
9732,Liberdade,43,2,1,1,1600,450,2050,47.67442
9733,Morumbi,180,4,4,2,3600,1890,5490,30.5
9734,Pirituba,56,2,1,1,1300,524,1824,32.57143
9735,Jardim Paulista,30,1,1,1,2300,830,3130,104.333336
9736,Santana,253,4,6,4,6000,2680,8680,34.3083
9737,Jardim América,240,3,2,3,15000,3000,18000,75.0
9738,Outro,45,2,1,0,1000,50,1050,23.333334
9739,Lapa,62,2,3,1,2800,580,3380,54.51613
9740,Pinheiros,35,1,1,1,3500,500,4000,114.28571
9741,República,39,1,1,1,1750,750,2500,64.10256
9742,Jardim Paulista,35,1,1,0,1500,400,1900,54.285713
9743,Outro,43,1,1,1,1550,545,2095,48.720932
9744,Vila Olímpia,65,2,2,1,2500,1200,3700,56.923077
9745,Outro,54,2,1,1,1380,625,2005,37.12963
9746,Jaguaré,52,2,1,1,1400,403,1803,34.673077
9747,Moema,50,1,2,1,2591,831,3422,68.44
9748,Cidade Monções,70,2,2,1,4200,770,4970,71.0
9749,Bela Vista,63,2,1,2,3900,1293,5193,82.42857
9750,Jardim Marajoara,68,3,2,1,2500,0,2500,36.764706
9751,Outro,55,2,1,1,1100,380,1480,26.90909
9752,Outro,55,2,1,1,1000,503,1503,27.327272
9753,Santa Cecília,49,2,1,1,2500,480,2980,60.816326
9754,Jardim Paulista,54,2,1,1,3300,467,3767,69.75926
9755,Perdizes,80,2,2,1,3700,703,4403,55.0375
9756,Outro,54,2,1,1,1000,220,1220,22.592592
9757,Indianópolis,40,1,1,1,2100,800,2900,72.5
9758,Brooklin,43,1,1,1,1800,630,2430,56.511627
9759,Vila Olímpia,95,3,4,2,9100,1300,10400,109.47369
9760,Jabaquara,78,3,2,1,1300,599,1899,24.346153
9761,Vila Leopoldina,128,4,4,2,5500,1500,7000,54.6875
9762,Campo Belo,47,1,1,1,2299,618,2917,62.06383
9763,Jaguaré,55,2,1,1,1500,470,1970,35.81818
9764,Butantã,75,2,2,1,2200,660,2860,38.133335
9765,Vila Nova Conceição,36,1,1,1,2836,967,3803,105.638885
9766,Mirandópolis,100,3,2,0,1800,0,1800,18.0
9767,Brooklin,34,1,1,1,2800,350,3150,92.64706
9768,Vila Mariana,54,2,1,1,2300,630,2930,54.25926
9769,Vila Nova Conceição,232,3,5,3,23000,2519,25519,109.99569
9770,Barra Funda,67,2,1,1,3000,720,3720,55.52239
9771,Vila Santa Catarina,65,3,2,2,1500,944,2444,37.6
9772,Outro,83,2,3,2,4500,699,5199,62.638554
9773,Bela Vista,45,1,1,0,1600,0,1600,35.555557
9774,Bela Vista,50,2,1,0,2200,705,2905,58.1
9775,Barra Funda,53,1,1,1,2800,403,3203,60.433964
9776,Perdizes,67,2,2,2,3800,900,4700,70.149254
9777,Jardim Marajoara,113,2,2,1,3300,1100,4400,38.938053
9778,Jardim Marajoara,93,3,3,2,2200,960,3160,33.978493
9779,Moema,70,2,2,1,3000,880,3880,55.42857
9780,Vila Madalena,90,1,2,1,3000,1400,4400,48.88889
9781,Campo Belo,161,3,5,3,12000,1800,13800,85.71429
9782,Perdizes,45,1,1,1,2200,602,2802,62.266666
9783,Perdizes,30,1,1,1,1980,570,2550,85.0
9784,Jardim Paulista,60,2,1,2,2800,1000,3800,63.333332
9785,Outro,48,2,1,1,2600,0,2600,54.166668
9786,Consolação,117,3,3,1,3700,1206,4906,41.931625
9787,Pompeia,70,2,1,2,6500,1340,7840,112.0
9788,Jardim Paulista,68,2,1,1,1800,1200,3000,44.117645
9789,Vila Clementino,280,3,4,4,15000,4368,19368,69.171425
9790,Jardim Paulista,78,2,3,2,5540,1360,6900,88.46154
9791,Brooklin,35,1,1,1,2300,525,2825,80.71429
9792,Consolação,65,2,1,1,2700,0,2700,41.53846
9793,Vila Prudente,50,2,1,1,1800,300,2100,42.0
9794,Vila Olímpia,70,2,2,1,5500,700,6200,88.57143
9795,Vila Clementino,93,2,3,1,2350,1200,3550,38.172043
9796,Moema,50,1,1,1,550,2700,3250,65.0
9797,Outro,84,3,3,2,2500,584,3084,36.714287
9798,Moema,66,2,2,1,2100,936,3036,46.0
9799,Pinheiros,70,1,2,1,1850,634,2484,35.485714
9800,Cidade Monções,245,4,4,4,20000,2250,22250,90.81633
9801,Moema,28,1,1,0,890,2100,2990,106.78571
9802,Liberdade,28,1,1,0,2100,250,2350,83.92857
9803,Itaim Bibi,49,1,1,1,3000,999,3999,81.61224
9804,Brooklin,254,4,5,3,13500,2244,15744,61.984253
9805,Higienópolis,45,1,1,0,1699,390,2089,46.422222
9806,Bela Vista,45,1,1,1,1600,722,2322,51.6
9807,Pinheiros,76,2,2,1,3200,826,4026,52.973682
9808,Vila Madalena,48,2,1,1,2000,320,2320,48.333332
9809,Paraíso,171,3,4,3,16000,2693,18693,109.31579
9810,Cidade Monções,145,3,4,2,5200,991,6191,42.696552
9811,Chácara Inglesa,68,2,2,1,2500,800,3300,48.52941
9812,Saúde,70,2,2,1,1850,653,2503,35.75714
9813,Outro,45,1,1,0,1300,50,1350,30.0
9814,Vila Mariana,90,3,2,1,2500,900,3400,37.77778
9815,Campo Belo,83,2,3,2,5100,800,5900,71.084335
9816,Liberdade,50,1,1,0,1100,390,1490,29.8
9817,Pirituba,50,2,1,1,1350,267,1617,32.34
9818,Outro,70,3,2,2,2700,760,3460,49.42857
9819,Outro,40,2,1,1,2100,446,2546,63.65
9820,Outro,48,2,1,1,1400,133,1533,31.9375
9821,Vila Carrão,81,2,2,2,2300,727,3027,37.37037
9822,Aclimação,46,1,1,1,1000,451,1451,31.543478
9823,Vila Madalena,45,1,1,1,2300,730,3030,67.333336
9824,Morumbi,199,3,4,3,2300,2400,4700,23.61809
9825,Jardim Paulista,94,3,2,1,4300,793,5093,54.18085
9826,Santo Amaro,31,1,1,1,2500,642,3142,101.354836
9827,Campo Belo,70,2,2,2,3900,777,4677,66.814285
9828,Outro,49,2,1,1,1000,400,1400,28.571428
9829,Bela Vista,45,1,1,1,1700,690,2390,53.11111
9830,Vila Mariana,90,3,3,1,3400,885,4285,47.61111
9831,Vila Mascote,45,2,1,0,2100,200,2300,51.11111
9832,Pompeia,68,2,2,1,3200,980,4180,61.47059
9833,Outro,96,2,3,2,9500,3058,12558,130.8125
9834,Outro,52,1,1,1,2300,500,2800,53.846153
9835,Morumbi,60,2,2,1,1750,900,2650,44.166668
9836,Saúde,70,3,1,2,1500,1050,2550,36.42857
9837,Bela Vista,157,3,2,0,2999,400,3399,21.649681
9838,Outro,62,2,3,2,2150,790,2940,47.419353
9839,Santa Cecília,80,2,2,0,2500,400,2900,36.25
9840,Cambuci,48,2,1,0,1500,480,1980,41.25
9841,Butantã,25,1,1,0,2790,0,2790,111.6
9842,Vila Prudente,70,2,1,0,1250,0,1250,17.857143
9843,Consolação,55,1,1,1,5200,1450,6650,120.90909
9844,Pompeia,104,3,3,2,4500,834,5334,51.28846
9845,Pinheiros,95,3,2,2,5500,1268,6768,71.2421
9846,Pinheiros,75,2,2,1,3900,793,4693,62.573334
9847,Vila Santa Catarina,65,2,2,2,1500,1000,2500,38.46154
9848,Itaim Bibi,262,3,5,4,32000,4200,36200,138.16794
9849,Vila Madalena,70,2,2,1,4000,797,4797,68.52857
9850,Vila Mariana,31,1,1,1,2420,528,2948,95.09677
9851,Chácara Santo Antônio,65,2,2,1,4500,741,5241,80.63077
9852,Brooklin,55,2,2,1,2800,1014,3814,69.34545
9853,Itaim Bibi,122,3,2,2,10000,1800,11800,96.72131
9854,Vila Olímpia,70,2,1,1,2200,700,2900,41.42857
9855,Indianópolis,102,3,4,2,4000,1762,5762,56.490196
9856,Outro,75,2,2,2,4400,1172,5572,74.293335
9857,Vila Clementino,39,1,1,0,1399,397,1796,46.05128
9858,Outro,40,1,1,0,1250,70,1320,33.0
9859,Tatuapé,90,3,1,0,2600,800,3400,37.77778
9860,Jardim América,90,2,2,1,3600,1410,5010,55.666668
9861,Vila Cruzeiro,37,1,1,1,2300,512,2812,76.0
9862,Outro,49,1,2,1,3100,550,3650,74.4898
9863,Itaim Bibi,90,2,1,1,5700,996,6696,74.4
9864,Alto de Pinheiros,55,2,1,1,1850,640,2490,45.272728
