,District,Area (m²),Bedrooms,Bathrooms,Garage Cars,Rent (R$),Condominium Fee (R$),Total Value (R$),Value per m²
0,Vila Nova Conceição,100,3,3,1,8500,600,9100,91.0
1,Centro,70,2,2,1,2100,780,2880,41.142857
2,Moema,110,2,3,2,4200,1400,5600,50.909092
3,Liberdade,39,1,1,1,2700,540,3240,83.07692
4,Campo Belo,45,1,1,1,1950,580,2530,56.22222
5,Other,70,2,2,1,3200,700,3900,55.714287
6,Tatuapé,20,1,1,0,1240,117,1357,67.85
7,Vila Madalena,48,1,1,1,2200,982,3182,66.291664
8,Vila Leopoldina,61,2,2,1,2900,650,3550,58.19672
9,Jardim Paulista,100,1,2,1,3750,1200,4950,49.5
10,Vila Andrade,74,2,2,2,2900,660,3560,48.10811
11,Other,55,2,1,1,1490,0,1490,27.09091
12,Moema,144,4,6,2,5700,1640,7340,50.97222
13,Jardins,72,2,2,1,5700,1123,6823,94.763885
14,Jardim Marajoara,72,1,1,1,1495,720,2215,30.76389
15,Perdizes,65,2,1,2,1700,800,2500,38.46154
16,Other,76,2,2,1,2350,1050,3400,44.736843
17,Vila Clementino,34,1,1,1,1750,505,2255,66.32353
18,Indianópolis,36,1,1,0,3200,450,3650,101.388885
19,Indianópolis,70,2,2,1,2400,907,3307,47.24286
20,Jardim Paulista,57,1,1,1,3380,1600,4980,87.36842
21,Other,75,3,2,1,2100,0,2100,28.0
22,Consolação,50,1,1,0,2000,600,2600,52.0
23,Vila Mariana,44,1,1,0,1800,410,2210,50.227272
24,Vila Mariana,54,2,1,1,2300,630,2930,54.25926
25,Other,66,1,2,1,2780,750,3530,53.484848
26,Other,60,2,1,1,2000,550,2550,42.5
27,Indianópolis,31,1,1,1,1260,1700,2960,95.48387
28,Itaim Bibi,100,3,3,1,2700,1300,4000,40.0
29,Pinheiros,35,1,1,1,3800,548,4348,124.22857
30,Brás,36,1,1,1,1900,420,2320,64.44444
31,Brás,29,1,1,0,1200,380,1580,54.482758
32,Vila Leopoldina,68,3,2,1,2350,780,3130,46.02941
33,Other,60,2,2,1,2500,550,3050,50.833332
34,Other,60,2,2,1,3500,800,4300,71.666664
35,Indianópolis,75,2,2,1,2400,1093,3493,46.573334
36,Brooklin,68,2,2,1,2665,1032,3697,54.367645
37,Itaim Bibi,95,2,1,0,4199,925,5124,53.936844
38,Jardim Paulista,77,2,2,1,5900,900,6800,88.31169
39,Brooklin,50,1,2,1,2100,730,2830,56.6
40,Santa Cecília,105,3,2,1,3000,1250,4250,40.47619
41,Consolação,50,2,1,1,1700,650,2350,47.0
42,Moema,65,2,1,1,3800,410,4210,64.76923
43,Brás,56,2,2,1,3000,500,3500,62.5
44,Cerqueira César,69,2,2,2,2800,1100,3900,56.52174
45,Other,183,3,2,0,2200,590,2790,15.245902
46,Other,100,4,2,1,3200,1100,4300,43.0
47,Barra Funda,65,2,2,1,2000,780,2780,42.76923
48,Jardim Paulista,45,1,1,1,3900,760,4660,103.55556
49,Barra Funda,60,2,2,1,2100,506,2606,43.433334
50,Moema,48,1,1,1,5000,780,5780,120.416664
51,Other,65,2,1,1,1200,300,1500,23.076923
52,Other,55,3,1,1,1650,547,2197,39.945454
53,Tatuapé,97,3,2,1,3000,0,3000,30.927835
54,Santana,45,1,1,0,1900,713,2613,58.066666
55,Other,90,2,2,1,1700,800,2500,27.777779
56,Chácara Santo Antônio,30,1,1,0,1656,900,2556,85.2
57,Perdizes,115,2,2,1,2599,1157,3756,32.66087
58,Cerqueira César,90,2,2,2,7300,1300,8600,95.55556
59,Centro,56,1,1,0,1600,0,1600,28.571428
60,Brooklin,47,1,1,1,2800,536,3336,70.97872
61,Other,105,2,4,3,3800,1600,5400,51.42857
62,Vila Madalena,77,2,2,1,2400,795,3195,41.493507
63,Higienópolis,62,2,1,0,1811,689,2500,40.322582
64,Other,74,2,3,2,5900,850,6750,91.21622
65,Consolação,50,1,1,0,2125,475,2600,52.0
66,Jardim Paulista,75,2,2,1,3000,1200,4200,56.0
67,Perdizes,21,1,1,0,1100,250,1350,64.28571
68,Other,50,2,1,1,2000,500,2500,50.0
69,Saúde,70,3,2,1,2100,901,3001,42.87143
70,Jardins,62,2,1,0,1900,640,2540,40.967743
71,Vila Mariana,48,1,1,0,1350,530,1880,39.166668
72,Vila Clementino,121,3,5,2,3900,1683,5583,46.140495
73,Higienópolis,127,3,2,1,3000,900,3900,30.708662
74,Vila Mariana,131,3,2,1,3300,1480,4780,36.48855
75,Tatuapé,20,1,1,0,1240,117,1357,67.85
76,Other,47,2,1,1,1250,380,1630,34.68085
77,Centro,51,1,1,0,2050,350,2400,47.058823
78,Other,118,3,4,2,5000,1642,6642,56.288136
79,Bela Vista,38,1,1,0,1508,439,1947,51.236843
80,Vila Leopoldina,56,2,2,1,3400,535,3935,70.26786
81,Barra Funda,38,1,1,1,1500,479,1979,52.07895
82,Liberdade,20,1,1,0,2450,0,2450,122.5
83,Vila Olímpia,64,2,2,1,4490,840,5330,83.28125
84,Other,79,2,2,2,2800,700,3500,44.3038
85,Mirandópolis,37,1,1,1,2700,450,3150,85.13513
86,Other,105,3,3,1,2900,867,3767,35.87619
87,Moema,75,2,3,2,6000,960,6960,92.8
88,Other,141,3,4,2,3700,1700,5400,38.29787
89,Chácara Santo Antônio,40,1,1,1,3000,590,3590,89.75
90,Other,54,1,1,1,2000,550,2550,47.22222
91,Other,67,2,2,1,2600,819,3419,51.02985
92,Pinheiros,30,1,1,1,2200,450,2650,88.333336
93,Pinheiros,90,3,3,2,6300,1100,7400,82.22222
94,Other,75,2,2,1,1500,651,2151,28.68
95,Centro,50,1,1,0,1100,500,1600,32.0
96,Butantã,72,3,1,1,1500,618,2118,29.416666
97,Vila Prudente,80,2,2,1,1800,798,2598,32.475
98,Cerqueira César,60,2,1,1,1800,977,2777,46.283333
99,Vila Mariana,110,3,3,1,5900,990,6890,62.636364
100,Brooklin,35,1,1,1,1570,530,2100,60.0
101,Indianópolis,92,3,3,1,3000,790,3790,41.195652
102,Other,97,2,3,2,2350,1230,3580,36.907215
103,Other,52,2,1,1,1000,424,1424,27.384615
104,Jardim Paulista,50,1,1,1,2500,603,3103,62.06
105,Campo Belo,47,1,1,1,3250,800,4050,86.17021
106,Moema,115,2,1,1,8500,1239,9739,84.68696
107,Santana,66,1,2,1,3400,780,4180,63.333332
108,Other,101,3,4,2,3300,950,4250,42.07921
109,Higienópolis,35,1,1,1,1750,519,2269,64.828575
110,Morumbi,47,1,1,0,1199,420,1619,34.446808
111,Itaim Bibi,117,2,2,1,7750,1190,8940,76.410255
112,Other,47,1,1,1,1000,0,1000,21.276596
113,Other,76,3,2,1,1800,724,2524,33.210526
114,Other,50,2,1,1,2000,480,2480,49.6
115,Santo Amaro,85,3,2,2,4200,0,4200,49.411766
116,Itaim Bibi,118,2,2,1,6000,1650,7650,64.830505
117,Vila Buarque,40,1,1,1,2500,450,2950,73.75
118,Bela Vista,64,2,1,1,2000,615,2615,40.859375
119,Jardim Paulista,105,2,2,1,5000,1100,6100,58.095238
120,Vila Mariana,110,3,2,1,3200,1150,4350,39.545456
121,Pompeia,48,1,1,1,2300,650,2950,61.458332
122,Other,65,3,1,1,1200,580,1780,27.384615
123,Other,50,2,1,1,1950,330,2280,45.6
124,Consolação,35,1,1,1,3000,600,3600,102.85714
125,Vila Mariana,100,3,4,3,3100,1340,4440,44.4
126,Other,65,2,2,1,2800,691,3491,53.70769
127,Other,62,2,3,1,3000,453,3453,55.69355
128,Pompeia,46,1,1,1,2300,586,2886,62.739132
129,Cidade Monções,44,1,2,1,2000,616,2616,59.454544
130,Móoca,62,2,2,1,2100,458,2558,41.258064
131,Aclimação,45,1,1,0,2400,0,2400,53.333332
132,Brooklin,96,2,3,2,8250,1420,9670,100.729164
133,Other,73,3,2,2,2100,605,2705,37.054794
134,Bela Vista,48,1,1,0,2600,0,2600,54.166668
135,Jaguaré,70,3,2,2,2300,700,3000,42.857143
136,Other,16,1,1,0,550,90,640,40.0
137,Vila Olímpia,70,1,1,1,5800,0,5800,82.85714
138,Barra Funda,65,2,2,1,2100,511,2611,40.16923
139,Cerqueira César,111,3,3,1,3300,1699,4999,45.036037
140,Bela Vista,40,1,1,0,1600,408,2008,50.2
141,Vila Olímpia,83,2,2,1,2500,1572,4072,49.06024
142,Lapa,67,2,2,2,3500,490,3990,59.55224
143,Jardim Paulista,52,1,1,0,2700,350,3050,58.653847
144,Other,21,1,1,1,990,300,1290,61.42857
145,Other,52,2,2,1,1900,0,1900,36.53846
146,Barra Funda,38,1,1,0,1700,377,2077,54.657894
147,Other,45,1,1,0,1300,250,1550,34.444443
148,Liberdade,46,1,1,0,1500,333,1833,39.847828
149,Perdizes,140,3,3,2,4500,0,4500,32.142857
150,Other,50,1,1,0,1750,100,1850,37.0
151,Paraíso,110,2,2,1,1875,605,2480,22.545454
152,Vila Olímpia,45,1,1,1,4380,700,5080,112.888885
153,Cidade Monções,65,3,2,2,2750,950,3700,56.923077
154,Perdizes,100,3,3,2,3400,1235,4635,46.35
155,Vila Clementino,110,3,3,2,2400,825,3225,29.318182
156,Barra Funda,33,1,1,0,1700,301,2001,60.636364
157,Itaim Bibi,50,1,1,1,2700,755,3455,69.1
158,Vila Prudente,75,3,2,1,3070,500,3570,47.6
159,Jardins,30,1,1,0,1700,440,2140,71.333336
160,Pinheiros,120,3,2,1,2500,0,2500,20.833334
161,Liberdade,60,2,1,0,1900,690,2590,43.166668
162,Other,48,2,1,1,1300,340,1640,34.166668
163,Pompeia,53,2,1,1,1650,757,2407,45.415092
164,Jardim Paulista,78,2,2,1,3200,0,3200,41.025642
165,Higienópolis,90,3,1,0,3000,0,3000,33.333332
166,Vila Mariana,65,2,2,1,1900,490,2390,36.76923
167,Consolação,50,1,1,0,2000,600,2600,52.0
168,Jabaquara,37,2,1,0,1295,0,1295,35.0
169,Consolação,27,1,1,0,1100,361,1461,54.11111
170,Jabaquara,20,1,1,0,1135,185,1320,66.0
171,Other,65,2,1,1,1195,586,1781,27.4
172,Bela Vista,25,1,1,1,1700,600,2300,92.0
173,Pinheiros,75,2,2,0,2400,550,2950,39.333332
174,Vila Mariana,18,1,1,0,1600,0,1600,88.888885
175,Santa Cecília,50,1,1,0,1500,800,2300,46.0
176,Consolação,25,1,1,0,1951,380,2331,93.24
177,Other,90,3,2,1,2800,825,3625,40.27778
178,Centro,37,1,1,1,2200,380,2580,69.72973
179,Cambuci,25,1,1,0,950,0,950,38.0
180,Other,157,4,5,3,8500,1300,9800,62.420383
181,Other,59,2,1,1,900,265,1165,19.745762
182,Ipiranga,25,1,1,0,800,100,900,36.0
183,Other,45,2,1,1,900,0,900,20.0
184,Other,20,1,1,0,890,0,890,44.5
185,Other,65,2,1,1,1800,480,2280,35.076923
186,Vila Mariana,62,2,2,1,2250,700,2950,47.580647
187,Other,100,3,3,2,6390,1040,7430,74.3
188,Perdizes,110,3,3,1,3500,1700,5200,47.272728
189,Other,56,2,2,1,2000,250,2250,40.17857
190,Other,50,1,1,1,2000,780,2780,55.6
191,Santa Cecília,70,2,2,1,2700,667,3367,48.1
192,Brooklin,84,2,3,2,7900,1100,9000,107.14286
193,Brooklin,55,1,1,1,1600,812,2412,43.854546
194,Jaguaré,82,3,3,2,4200,650,4850,59.146343
195,Perdizes,126,3,3,0,3000,1300,4300,34.126984
196,Other,42,1,2,1,1000,622,1622,38.61905
197,Liberdade,30,1,1,0,500,360,860,28.666666
198,Pinheiros,32,1,1,1,2500,800,3300,103.125
199,Tatuapé,80,2,1,0,1390,280,1670,20.875
200,Morumbi,100,2,2,2,3000,1200,4200,42.0
201,Other,45,2,1,1,700,0,700,15.555555
202,Tatuapé,20,1,1,0,950,0,950,47.5
203,Vila Mariana,104,3,2,1,2500,1200,3700,35.576923
204,Vila Mariana,15,1,1,0,1600,0,1600,106.666664
205,Santa Cecília,50,1,1,1,1340,1550,2890,57.8
206,Other,60,3,1,1,1505,345,1850,30.833334
207,Other,64,2,2,1,2000,600,2600,40.625
208,Other,137,3,4,3,3000,1393,4393,32.065693
209,Vila Andrade,58,2,1,1,1600,550,2150,37.068966
210,Cerqueira César,88,2,2,1,2500,0,2500,28.40909
211,Morumbi,50,1,1,1,2700,478,3178,63.56
212,Aclimação,115,3,2,1,2390,865,3255,28.304348
213,Other,66,2,2,2,2800,1000,3800,57.575756
214,Jardins,85,2,3,1,3950,1319,5269,61.988235
215,Santo Amaro,51,2,1,1,1370,430,1800,35.294117
216,Campo Belo,50,1,1,1,3500,420,3920,78.4
217,Vila Mariana,53,2,2,1,2899,950,3849,72.62264
218,Butantã,84,3,2,2,1900,1120,3020,35.95238
219,Brooklin,124,3,4,2,7000,1531,8531,68.798386
220,Other,52,2,1,1,1700,483,2183,41.98077
221,Chácara Santo Antônio,70,2,2,1,2200,800,3000,42.857143
222,Pinheiros,84,2,2,2,3500,1050,4550,54.166668
223,Campo Belo,80,2,2,2,3000,729,3729,46.6125
224,Perdizes,70,2,1,1,2500,880,3380,48.285713
225,Bela Vista,42,1,1,1,1750,375,2125,50.595238
226,Bela Vista,42,1,1,0,2200,415,2615,62.261906
227,Vila Mascote,55,2,1,1,2000,615,2615,47.545456
228,Ipiranga,68,2,2,1,2300,708,3008,44.235294
229,Brooklin,60,2,2,1,2400,580,2980,49.666668
230,Pinheiros,32,1,1,1,2500,770,3270,102.1875
231,Vila Mariana,80,2,2,1,2300,796,3096,38.7
232,Pinheiros,35,1,1,1,3690,790,4480,128.0
233,Brooklin,94,2,3,2,5700,832,6532,69.489365
234,Perdizes,91,3,3,1,3250,950,4200,46.153847
235,Brooklin,116,3,3,2,6000,1300,7300,62.931034
236,Tatuapé,40,1,1,1,1850,400,2250,56.25
237,Moema,62,2,2,1,3000,1150,4150,66.935486
238,Brooklin,60,2,2,1,2700,830,3530,58.833332
239,Other,57,2,1,0,1500,300,1800,31.578947
240,Other,79,2,2,2,5500,656,6156,77.92405
241,Vila Mariana,40,1,1,1,2200,650,2850,71.25
242,Other,36,2,2,0,1200,190,1390,38.61111
243,Consolação,33,1,1,1,2500,383,2883,87.36364
244,Moema,125,3,4,2,8000,1200,9200,73.6
245,Butantã,85,3,2,1,1500,620,2120,24.941177
246,Pompeia,63,2,2,1,3200,550,3750,59.52381
247,Other,50,1,1,0,690,589,1279,25.58
248,Consolação,53,1,1,1,2000,1700,3700,69.81132
249,Brás,55,2,1,1,1450,405,1855,33.727272
250,Moema,74,2,3,1,4100,1250,5350,72.297295
251,Bela Vista,75,1,2,0,2100,511,2611,34.81333
252,Other,100,3,2,0,1500,720,2220,22.2
253,Brooklin,67,2,1,1,3800,860,4660,69.55224
254,Other,55,2,2,1,1500,388,1888,34.327274
255,Móoca,62,4,2,1,2500,400,2900,46.774193
256,Vila Olímpia,48,1,1,1,3300,900,4200,87.5
257,Tatuapé,29,1,1,0,1430,142,1572,54.206898
258,Perdizes,104,3,3,2,7300,989,8289,79.70192
259,Brooklin,30,1,1,1,2200,480,2680,89.333336
260,Vila Buarque,31,1,1,1,1700,557,2257,72.80645
261,Vila Mariana,84,2,2,1,2100,302,2402,28.595238
262,Pinheiros,31,1,1,1,2300,965,3265,105.32258
263,Santana,40,2,1,1,2000,0,2000,50.0
264,Other,47,2,1,0,1400,0,1400,29.787233
265,Jardim Paulista,45,2,1,1,2400,879,3279,72.86667
266,Vila Leopoldina,114,3,4,2,4990,1300,6290,55.175438
267,Other,57,2,1,1,1200,509,1709,29.982456
268,Higienópolis,93,3,2,1,3000,934,3934,42.301075
269,Itaim Bibi,105,2,2,1,4300,993,5293,50.409523
270,Consolação,68,2,1,1,2200,950,3150,46.32353
271,Itaim Bibi,37,1,1,1,2500,920,3420,92.432434
272,Brooklin,85,3,4,2,7300,901,8201,96.48235
273,Other,70,1,1,2,2400,599,2999,42.842857
274,Paraíso,70,2,1,0,2000,509,2509,35.842857
275,Other,97,3,2,2,3500,0,3500,36.082474
276,Cerqueira César,58,2,2,1,2200,763,2963,51.08621
277,Centro,20,1,1,0,1300,354,1654,82.7
278,Other,57,2,1,1,1700,640,2340,41.05263
279,Perdizes,80,3,3,1,2300,1330,3630,45.375
280,Pinheiros,60,2,2,2,2400,1300,3700,61.666668
281,Móoca,60,3,2,1,2000,550,2550,42.5
282,Santa Cecília,72,2,1,0,2000,600,2600,36.11111
283,Jabaquara,55,2,1,1,1000,1021,2021,36.745453
284,Pinheiros,34,1,1,1,3650,450,4100,120.588234
285,Campo Belo,85,2,2,2,3500,1400,4900,57.64706
286,Other,85,1,2,1,4080,1200,5280,62.117645
287,Other,18,1,1,0,1050,40,1090,60.555557
288,Brooklin,34,1,1,1,2800,350,3150,92.64706
289,Vila Prudente,55,2,2,1,1700,278,1978,35.963634
290,Pinheiros,45,2,1,1,2600,750,3350,74.44444
291,Chácara Santo Antônio,104,3,3,2,4500,865,5365,51.58654
292,Other,60,2,1,0,1800,140,1940,32.333332
293,Other,50,2,1,1,1850,540,2390,47.8
294,Brooklin,85,2,2,1,2800,700,3500,41.17647
295,Other,95,2,1,0,2300,100,2400,25.263159
296,Bela Vista,30,1,1,1,1800,514,2314,77.13333
297,Vila Andrade,65,3,2,2,1900,960,2860,44.0
298,Other,56,2,1,1,2000,550,2550,45.535713
299,Campo Belo,170,4,4,2,3900,1530,5430,31.941177
300,Vila Olímpia,50,1,1,1,2620,1095,3715,74.3
301,Ipiranga,35,1,1,1,2450,407,2857,81.62857
302,Vila Madalena,90,3,2,1,3100,527,3627,40.3
303,Pinheiros,108,3,2,1,2340,1138,3478,32.203705
304,Other,74,2,2,2,3200,688,3888,52.54054
305,Santo Amaro,45,1,1,1,2000,528,2528,56.177776
306,Bela Vista,45,1,1,1,3000,544,3544,78.755554
307,Consolação,159,4,5,2,8500,1300,9800,61.63522
308,Other,93,3,2,2,4500,1065,5565,59.83871
309,Moema,70,2,2,1,3000,880,3880,55.42857
310,Butantã,55,2,1,1,1800,700,2500,45.454544
311,Campo Belo,73,2,2,1,2900,850,3750,51.36986
312,Higienópolis,33,1,1,1,1400,600,2000,60.60606
313,Vila Andrade,68,2,2,1,1850,528,2378,34.97059
314,Other,65,2,2,1,2300,420,2720,41.846153
315,Vila Madalena,55,2,2,0,4800,700,5500,100.0
316,Pompeia,80,3,3,2,2800,750,3550,44.375
317,Tatuapé,45,1,1,1,2100,500,2600,57.77778
318,Cerqueira César,40,1,1,1,1600,1300,2900,72.5
319,Jardim Marajoara,50,2,1,1,1500,500,2000,40.0
320,Pinheiros,45,1,1,1,2500,750,3250,72.22222
321,Aclimação,50,2,1,1,1550,550,2100,42.0
322,Other,40,1,1,1,3400,560,3960,99.0
323,Vila Mariana,90,2,2,2,4899,950,5849,64.98889
324,Jardins,41,1,1,1,2600,700,3300,80.48781
325,Jardim Paulista,57,1,2,1,2000,610,2610,45.789474
326,Perdizes,84,2,2,2,4000,850,4850,57.738094
327,Campo Belo,34,1,1,1,2000,500,2500,73.52941
328,Moema,48,1,1,1,2400,982,3382,70.458336
329,Mirandópolis,70,3,2,1,1900,807,2707,38.67143
330,Pinheiros,74,2,1,2,6219,1643,7862,106.24324
331,Cambuci,64,3,2,1,2100,490,2590,40.46875
332,Chácara Santo Antônio,90,2,3,2,6500,700,7200,80.0
333,Other,78,2,2,1,5000,0,5000,64.10256
334,Vila Olímpia,78,2,3,1,2200,1190,3390,43.46154
335,Consolação,29,1,1,0,1300,443,1743,60.103447
336,Campo Belo,60,2,2,1,2999,918,3917,65.28333
337,Other,90,2,2,1,2000,1051,3051,33.9
338,Móoca,90,3,2,2,2500,550,3050,33.88889
339,Pinheiros,60,1,2,0,2200,421,2621,43.683334
340,Vila Clementino,65,2,2,2,2500,1032,3532,54.338463
341,Vila Buarque,33,1,1,1,1200,737,1937,58.696968
342,Vila Andrade,58,2,1,2,1300,815,2115,36.46552
343,Campo Belo,96,3,2,1,3600,1080,4680,48.75
344,Brooklin,70,2,2,1,3000,790,3790,54.142857
345,Brooklin,70,2,2,1,4000,724,4724,67.48572
346,Chácara Santo Antônio,106,2,3,2,5500,1200,6700,63.207546
347,Barra Funda,65,1,2,1,2600,510,3110,47.846153
348,Consolação,35,1,1,1,1600,425,2025,57.857143
349,Bela Vista,23,1,1,0,1200,220,1420,61.739132
350,Ipiranga,60,2,2,1,2500,750,3250,54.166668
351,Other,73,3,2,2,2950,700,3650,50.0
352,Pinheiros,73,2,3,2,3500,1200,4700,64.38356
353,Itaim Bibi,45,1,1,0,1900,625,2525,56.11111
354,Vila Leopoldina,35,1,1,0,1650,305,1955,55.857143
355,Other,50,2,1,1,1400,500,1900,38.0
356,Other,85,4,3,1,2100,900,3000,35.294117
357,Ipiranga,62,1,2,1,3600,560,4160,67.09677
358,Bela Vista,52,2,1,1,4500,475,4975,95.67308
359,Other,40,1,1,0,950,0,950,23.75
360,Barra Funda,35,2,1,0,1820,290,2110,60.285713
361,Moema,60,2,2,1,2550,890,3440,57.333332
362,Móoca,44,1,1,0,1150,280,1430,32.5
363,Vila Andrade,106,3,3,2,6500,0,6500,61.320755
364,Saúde,69,2,1,1,1600,447,2047,29.666666
365,Tatuapé,66,2,2,1,1800,600,2400,36.363636
366,Vila Mariana,77,3,1,2,3500,770,4270,55.454544
367,Saúde,56,2,2,1,2999,551,3550,63.392857
368,Moema,70,2,3,1,3800,832,4632,66.171425
369,Santa Cecília,38,1,1,1,2000,528,2528,66.52631
370,Vila Leopoldina,172,3,5,3,6800,1700,8500,49.418606
371,Moema,75,2,2,1,2400,1027,3427,45.693333
372,Cerqueira César,107,3,3,1,4000,1382,5382,50.299065
373,Vila Olímpia,48,1,2,1,2500,605,3105,64.6875
374,Santana,42,2,1,1,2200,0,2200,52.38095
375,Other,52,2,1,1,1150,370,1520,29.23077
376,Moema,27,1,1,0,2200,314,2514,93.111115
377,Other,75,3,2,1,1400,750,2150,28.666666
378,Cerqueira César,88,4,2,0,2800,824,3624,41.18182
379,Barra Funda,68,2,2,1,2400,600,3000,44.117645
380,Mirandópolis,40,1,1,1,1500,645,2145,53.625
381,Morumbi,79,2,2,2,3200,769,3969,50.240505
382,Vila Mariana,81,2,2,2,3100,0,3100,38.271606
383,Jardim América,100,2,3,1,5000,1050,6050,60.5
384,Santa Cecília,43,1,1,1,2290,800,3090,71.860466
385,Other,65,3,1,1,1500,545,2045,31.461538
386,República,28,1,1,0,1700,250,1950,69.64286
387,Barra Funda,62,2,1,1,2800,730,3530,56.935482
388,Brooklin,45,1,1,1,2500,750,3250,72.22222
389,Saúde,41,1,1,1,1800,723,2523,61.536587
390,Perdizes,43,1,1,0,1500,410,1910,44.418606
391,Jardim Marajoara,72,3,2,1,2200,660,2860,39.72222
392,Other,64,2,2,1,2600,500,3100,48.4375
393,Jardim Marajoara,68,2,2,2,2000,700,2700,39.705883
394,Cidade Monções,38,1,1,1,2900,600,3500,92.10526
395,Other,74,3,1,1,2077,760,2837,38.337837
396,Brooklin,69,2,2,1,5300,520,5820,84.347824
397,Itaim Bibi,118,2,2,1,3500,1043,4543,38.5
398,Perdizes,90,2,1,0,2400,500,2900,32.22222
399,Moema,74,2,1,1,1800,620,2420,32.7027
400,Other,60,2,1,1,1200,570,1770,29.5
401,Saúde,58,2,2,1,2000,763,2763,47.63793
402,Other,40,1,1,0,1300,0,1300,32.5
403,Pinheiros,37,1,1,1,2600,700,3300,89.189186
404,Jardim Paulista,80,2,2,0,2800,380,3180,39.75
405,Brooklin,130,3,4,2,5000,1480,6480,49.846153
406,Other,50,1,1,0,690,589,1279,25.58
407,Itaim Bibi,46,1,2,1,2200,1000,3200,69.565216
408,Brooklin,111,3,3,2,6500,980,7480,67.38739
409,Paraíso,109,3,3,1,3100,1152,4252,39.009174
410,Santa Cecília,67,1,1,0,1200,620,1820,27.164179
411,Other,73,3,2,1,2500,750,3250,44.52055
412,Moema,100,3,3,1,5500,950,6450,64.5
413,Other,121,3,5,2,6500,1100,7600,62.809917
414,Pinheiros,60,2,1,0,1950,430,2380,39.666668
415,Vila Mascote,87,3,3,2,2500,1100,3600,41.37931
416,Cidade Monções,125,3,3,2,4750,1300,6050,48.4
417,Pinheiros,87,2,3,1,3500,1080,4580,52.643677
418,Other,63,3,2,1,2000,676,2676,42.47619
419,Other,90,2,2,1,1200,380,1580,17.555555
420,Consolação,51,2,1,1,3100,870,3970,77.84314
421,Vila Mariana,59,2,2,2,2700,1349,4049,68.62712
422,Pompeia,41,1,1,1,2300,593,2893,70.560974
423,Brooklin,37,1,1,1,3300,400,3700,100.0
424,Pinheiros,66,1,1,1,2500,785,3285,49.772728
425,Campo Belo,70,2,3,1,2550,950,3500,50.0
426,Vila Mariana,65,2,2,1,4499,550,5049,77.676926
427,Aclimação,68,2,2,2,5000,750,5750,84.55882
428,Pinheiros,75,2,2,2,3300,890,4190,55.866665
429,Other,64,2,2,1,3300,0,3300,51.5625
430,Santo Amaro,75,3,2,1,1950,580,2530,33.733334
431,Brooklin,75,2,3,2,3300,910,4210,56.133335
432,Other,82,3,2,2,2400,800,3200,39.02439
433,Moema,80,2,2,1,2500,978,3478,43.475
434,Jardim Paulista,120,3,3,1,4000,893,4893,40.775
435,Moema,102,3,3,2,6900,1050,7950,77.94118
436,Other,48,1,1,1,800,480,1280,26.666666
437,Ipiranga,45,1,1,1,1800,556,2356,52.355556
438,Other,148,2,2,2,7900,1269,9169,61.9527
439,Brooklin,90,3,2,2,3500,1103,4603,51.144444
440,Campo Belo,80,2,2,3,5200,900,6100,76.25
441,Campo Belo,60,1,2,0,3100,700,3800,63.333332
442,Moema,125,3,5,2,8499,1250,9749,77.992
443,Brooklin,41,1,1,1,3450,650,4100,100.0
444,Other,56,2,1,1,1400,574,1974,35.25
445,Chácara Santo Antônio,106,3,4,2,5500,1100,6600,62.264153
446,Barra Funda,67,1,2,2,3100,450,3550,52.985073
447,Moema,68,2,2,2,4000,1222,5222,76.79412
448,Other,67,3,2,2,1500,456,1956,29.19403
449,Campo Belo,43,1,2,1,2800,580,3380,78.60465
450,Vila Madalena,42,1,1,1,2200,830,3030,72.14286
451,Brooklin,105,2,3,2,9197,980,10177,96.92381
452,Liberdade,65,2,2,1,3400,550,3950,60.76923
453,Vila Madalena,57,1,2,1,3400,1320,4720,82.807014
454,Moema,73,2,3,2,3900,1400,5300,72.60274
455,Barra Funda,65,2,2,1,3000,510,3510,54.0
456,Tatuapé,212,2,4,3,6500,0,6500,30.660378
457,Liberdade,50,1,1,0,1200,497,1697,33.94
458,Itaim Bibi,80,2,2,1,6200,1220,7420,92.75
459,Vila Mariana,37,1,1,1,1700,576,2276,61.51351
460,Vila Nova Conceição,40,1,1,1,2100,955,3055,76.375
461,Pinheiros,72,2,2,1,6500,633,7133,99.06944
462,Brooklin,98,2,3,2,8000,1600,9600,97.95918
463,Pinheiros,40,1,1,2,3900,910,4810,120.25
464,Cambuci,64,2,2,1,1900,570,2470,38.59375
465,Other,44,2,1,1,1100,320,1420,32.272728
466,Pinheiros,100,3,2,1,2800,1159,3959,39.59
467,Vila Madalena,90,2,4,1,2700,1100,3800,42.22222
468,Other,72,2,2,2,2700,900,3600,50.0
469,Moema,52,1,1,1,3800,1350,5150,99.03846
470,Vila Olímpia,72,2,1,1,3940,860,4800,66.666664
471,Butantã,17,1,1,0,1350,0,1350,79.411766
472,Butantã,50,2,1,1,2200,320,2520,50.4
473,Vila Mariana,83,2,2,0,2500,230,2730,32.891567
474,Pinheiros,57,1,1,1,4200,750,4950,86.8421
475,Santo Amaro,160,4,5,2,6890,1300,8190,51.1875
476,Vila Prudente,44,1,1,1,1000,300,1300,29.545454
477,Vila Clementino,60,2,1,0,2000,550,2550,42.5
478,Móoca,100,3,3,2,4500,510,5010,50.1
479,Paraíso,98,2,2,0,2500,1105,3605,36.785713
480,Itaim Bibi,40,1,1,1,1578,1009,2587,64.675
481,Moema,40,1,1,1,1790,787,2577,64.425
482,Chácara Santo Antônio,106,3,2,2,5485,1100,6585,62.122643
483,Other,51,1,1,1,3300,545,3845,75.39216
484,Itaim Bibi,75,2,1,0,1800,776,2576,34.34667
485,Vila Guarani,53,2,1,1,1700,600,2300,43.396225
486,Higienópolis,68,2,1,0,2300,1150,3450,50.735294
487,Butantã,38,1,1,0,1900,219,2119,55.763157
488,Moema,117,4,4,2,5000,1400,6400,54.700855
489,Other,24,1,1,0,1100,220,1320,55.0
490,Vila Olímpia,56,2,1,1,6500,541,7041,125.73214
491,Brooklin,52,2,1,1,3500,948,4448,85.53846
492,Paraíso,72,2,2,1,1900,779,2679,37.208332
493,Brooklin,94,3,2,2,3600,1000,4600,48.93617
494,Campo Belo,50,1,1,1,2950,700,3650,73.0
495,Pinheiros,110,3,2,0,4500,120,4620,42.0
496,Perdizes,62,3,2,1,2600,810,3410,55.0
497,Moema,72,2,2,2,4150,950,5100,70.833336
498,Bela Vista,52,2,1,1,4500,476,4976,95.69231
499,Perdizes,67,2,2,1,5000,649,5649,84.31343
500,Other,20,1,1,0,1180,40,1220,61.0
501,Pinheiros,90,3,3,2,5200,1298,6498,72.2
502,Santa Cecília,81,2,2,0,2600,400,3000,37.037037
503,Jaguaré,67,2,2,1,1200,592,1792,26.74627
504,República,39,1,1,1,1500,850,2350,60.25641
505,Vila Andrade,70,3,2,2,2000,650,2650,37.857143
506,Vila Mariana,55,2,1,1,1500,770,2270,41.272728
507,Moema,45,1,2,1,2200,500,2700,60.0
508,Cerqueira César,54,2,1,1,3950,540,4490,83.14815
509,Vila Madalena,35,1,1,1,2900,450,3350,95.71429
510,Móoca,52,2,1,1,1950,450,2400,46.153847
511,Other,95,3,2,2,3800,851,4651,48.957893
512,Vila Guarani,52,1,1,0,1000,0,1000,19.23077
513,Other,66,1,1,1,3800,600,4400,66.666664
514,Itaim Bibi,50,1,1,1,2500,771,3271,65.42
515,Moema,44,1,2,1,3100,600,3700,84.09091
516,Brooklin,41,1,1,1,3500,620,4120,100.48781
517,Santana,90,2,2,1,1700,250,1950,21.666666
518,Other,79,2,3,2,4300,660,4960,62.78481
519,Other,45,1,1,1,1600,495,2095,46.555557
520,Butantã,29,1,1,0,1350,170,1520,52.41379
521,Paraíso,120,2,2,0,2500,850,3350,27.916666
522,Pinheiros,64,2,1,1,2500,710,3210,50.15625
523,Butantã,17,1,1,0,1350,0,1350,79.411766
524,Other,62,3,1,1,1800,630,2430,39.19355
525,Ipiranga,45,1,1,1,2100,431,2531,56.244446
526,Other,72,2,2,1,3100,700,3800,52.77778
527,Bela Vista,29,1,1,1,1300,440,1740,60.0
528,Brooklin,44,1,1,1,2600,655,3255,73.97727
529,Aclimação,40,1,1,1,2100,558,2658,66.45
530,Morumbi,131,4,4,3,1598,1527,3125,23.854961
531,Brooklin,70,2,1,1,2000,950,2950,42.142857
532,Other,85,2,1,1,1700,750,2450,28.82353
533,Vila Mariana,80,2,2,1,2500,550,3050,38.125
534,Perdizes,117,3,4,1,6500,1570,8070,68.97436
535,Bela Vista,34,1,1,0,2500,403,2903,85.382355
536,Other,68,3,2,1,2250,525,2775,40.808823
537,Santana,109,3,3,2,2500,1292,3792,34.78899
538,Other,85,2,2,1,1700,680,2380,28.0
539,Vila Mariana,82,3,2,2,3500,1200,4700,57.317074
540,Jabaquara,55,2,1,1,1600,450,2050,37.272728
541,Paraíso,33,1,1,0,2000,380,2380,72.121216
542,Chácara Santo Antônio,130,3,4,2,6700,900,7600,58.46154
543,Vila Leopoldina,48,2,1,2,2300,495,2795,58.229168
544,Perdizes,40,1,1,1,1850,890,2740,68.5
545,Perdizes,92,3,2,2,3300,1205,4505,48.967392
546,Pinheiros,65,2,1,2,5432,1458,6890,106.0
547,Vila Leopoldina,83,3,3,2,3300,950,4250,51.20482
548,Paraíso,160,3,2,1,4900,980,5880,36.75
549,Vila Andrade,60,2,1,1,1800,300,2100,35.0
550,Vila Clementino,55,2,1,1,2200,710,2910,52.909092
551,Paraíso,85,2,1,1,3000,939,3939,46.341175
552,Higienópolis,150,3,2,2,6500,1380,7880,52.533333
553,Pinheiros,87,2,2,1,3500,1028,4528,52.04598
554,Other,80,3,2,2,2350,925,3275,40.9375
555,Brooklin,66,2,2,1,4999,900,5899,89.378784
556,Other,135,3,2,0,2500,1250,3750,27.777779
557,Centro,63,2,2,1,1900,350,2250,35.714287
558,Vila Madalena,70,2,2,1,3050,797,3847,54.95714
559,Itaim Bibi,80,2,2,1,3000,939,3939,49.2375
560,Higienópolis,26,1,1,0,1550,201,1751,67.34615
561,Other,60,2,2,1,3200,584,3784,63.066666
562,Other,76,2,2,1,2700,679,3379,44.460526
563,Other,59,2,1,1,1257,0,1257,21.305084
564,Brooklin,42,1,1,1,1700,675,2375,56.54762
565,Vila Mariana,75,3,3,2,3200,1021,4221,56.28
566,Other,45,1,1,0,1050,0,1050,23.333334
567,Other,86,3,3,2,3000,1083,4083,47.476746
568,Pinheiros,60,2,1,0,2000,485,2485,41.416668
569,Consolação,30,1,1,1,1900,649,2549,84.96667
570,Other,100,3,2,1,3500,1000,4500,45.0
571,Ipiranga,72,2,1,0,1700,163,1863,25.875
572,Bela Vista,130,3,2,1,4000,1090,5090,39.153847
573,Moema,98,3,5,2,4500,1200,5700,58.163265
574,Other,83,2,2,1,2600,516,3116,37.542168
575,Jardim Paulista,90,2,3,1,3500,1346,4846,53.844444
576,Bela Vista,52,2,1,1,2700,398,3098,59.576923
577,Other,78,3,1,1,3000,1125,4125,52.884617
578,Brooklin,60,2,2,1,3985,900,4885,81.416664
579,Chácara Santo Antônio,70,2,2,2,3800,887,4687,66.957146
580,Other,40,2,1,0,1500,106,1606,40.15
581,Aclimação,115,3,2,1,2390,865,3255,28.304348
582,Vila Nova Conceição,100,3,2,1,1950,749,2699,26.99
583,Pinheiros,60,2,1,1,2300,1200,3500,58.333332
584,Itaim Bibi,48,1,1,1,2300,696,2996,62.416668
585,Perdizes,41,1,1,1,1700,773,2473,60.317074
586,Itaim Bibi,49,1,1,1,2500,901,3401,69.408165
587,Vila Nova Conceição,69,1,2,1,5600,1100,6700,97.10145
588,Vila Mariana,67,2,2,1,2200,1050,3250,48.50746
589,Ipiranga,142,3,5,2,5600,1200,6800,47.887325
590,Cerqueira César,40,1,1,1,1850,487,2337,58.425
591,Jardim Paulista,79,2,4,2,8000,1100,9100,115.18987
592,Pinheiros,53,2,1,1,3300,643,3943,74.396225
593,Vila Nova Conceição,85,2,2,1,4000,834,4834,56.870586
594,Other,49,2,1,1,700,280,980,20.0
595,Other,89,3,2,1,1900,760,2660,29.88764
596,Liberdade,60,2,2,1,1200,700,1900,31.666666
597,Other,45,2,1,1,1100,330,1430,31.777779
598,Tatuapé,106,3,4,2,4500,747,5247,49.5
599,Jabaquara,40,1,1,1,1300,0,1300,32.5
600,Vila Mascote,87,2,3,2,3000,750,3750,43.103447
601,Pinheiros,46,1,1,1,3500,794,4294,93.347824
602,Vila Leopoldina,142,4,5,2,6500,1089,7589,53.44366
603,Other,73,2,1,1,1500,880,2380,32.60274
604,Morumbi,84,3,2,1,3500,730,4230,50.357143
605,Vila Mariana,60,2,2,1,3500,931,4431,73.85
606,Morumbi,59,1,2,1,2900,937,3837,65.0339
607,Vila Leopoldina,141,3,5,2,5300,1100,6400,45.39007
608,Campo Belo,60,2,3,1,2300,963,3263,54.383335
609,Vila Olímpia,72,2,2,1,4500,986,5486,76.19444
610,Ipiranga,111,3,4,2,5500,1000,6500,58.55856
611,Pinheiros,51,2,1,1,2970,800,3770,73.92157
612,Other,40,2,1,0,1450,80,1530,38.25
613,Other,65,3,2,1,1515,927,2442,37.56923
614,Bela Vista,46,1,1,1,2700,316,3016,65.565216
615,Moema,57,2,1,1,2300,960,3260,57.19298
616,Pompeia,78,3,1,2,2500,1111,3611,46.294872
617,Aclimação,39,1,1,1,2260,530,2790,71.53846
618,Other,65,2,2,1,2800,386,3186,49.015385
619,Other,87,3,3,1,1600,900,2500,28.735632
620,Vila Andrade,51,2,1,1,2750,350,3100,60.784313
621,Moema,45,1,1,1,1766,684,2450,54.444443
622,Pinheiros,74,2,1,2,5100,1643,6743,91.12162
623,Other,45,2,1,0,950,150,1100,24.444445
624,Chácara Santo Antônio,57,2,1,1,4200,550,4750,83.333336
625,Vila Mariana,50,1,2,1,3499,448,3947,78.94
626,Vila Leopoldina,53,2,1,1,2500,700,3200,60.377357
627,Cambuci,50,2,1,1,1450,520,1970,39.4
628,Jardim Paulista,115,4,4,2,6200,981,7181,62.443478
629,Saúde,35,1,1,1,2000,450,2450,70.0
630,Bela Vista,40,1,1,1,2400,508,2908,72.7
631,Perdizes,62,2,2,1,3000,798,3798,61.258064
632,Vila Guarani,106,3,3,2,4300,955,5255,49.57547
633,Vila Leopoldina,68,2,1,1,2200,648,2848,41.882355
634,Butantã,67,3,2,1,2900,450,3350,50.0
635,Barra Funda,65,2,2,0,2100,680,2780,42.76923
636,Other,69,3,2,2,2250,747,2997,43.434784
637,Itaim Bibi,85,3,2,1,4000,834,4834,56.870586
638,Other,57,2,1,1,1000,0,1000,17.54386
639,Other,50,1,1,0,1300,350,1650,33.0
640,Perdizes,63,2,2,1,4500,850,5350,84.92063
641,Brás,32,1,1,0,1350,300,1650,51.5625
642,Vila Mariana,48,1,1,0,1350,530,1880,39.166668
643,Other,58,2,2,1,2300,507,2807,48.396553
644,Other,70,2,2,1,1300,600,1900,27.142857
645,Campo Belo,74,2,2,2,4500,960,5460,73.78378
646,Brooklin,87,2,2,1,3000,611,3611,41.50575
647,Vila Mascote,85,3,4,2,2400,1090,3490,41.058823
648,Other,45,2,1,1,1450,267,1717,38.155556
649,Campo Belo,45,1,2,1,3000,352,3352,74.48889
650,Other,60,1,1,0,1200,0,1200,20.0
651,Vila Mariana,80,3,1,3,3500,1205,4705,58.8125
652,Morumbi,69,2,3,1,1900,1003,2903,42.072464
653,Pinheiros,86,2,2,1,3100,1264,4364,50.744186
654,Chácara Santo Antônio,74,2,3,2,3300,1080,4380,59.18919
655,Pinheiros,84,2,2,2,7000,1400,8400,100.0
656,Moema,110,3,5,1,5000,1470,6470,58.81818
657,Jardins,130,3,2,1,5200,1200,6400,49.23077
658,Móoca,56,2,1,1,1690,495,2185,39.017857
659,Other,50,2,1,1,1400,290,1690,33.8
660,Santo Amaro,112,3,3,2,3800,1250,5050,45.089287
661,Other,50,2,1,1,1400,465,1865,37.3
662,República,32,1,1,0,1699,435,2134,66.6875
663,Aclimação,86,3,3,2,3500,882,4382,50.953487
664,Perdizes,34,1,2,1,1700,797,2497,73.44118
665,Chácara Santo Antônio,60,2,2,1,2950,630,3580,59.666668
666,Jardim Paulista,110,3,3,1,4000,1263,5263,47.845455
667,Vila Clementino,38,1,1,1,1750,550,2300,60.526318
668,Consolação,83,2,2,1,2100,1073,3173,38.228916
669,Other,65,2,2,1,2100,700,2800,43.076923
670,Pinheiros,50,2,1,0,2600,0,2600,52.0
671,Vila Mariana,77,3,1,2,3100,750,3850,50.0
672,Other,66,2,2,1,2257,650,2907,44.045456
673,Móoca,62,3,2,1,2200,400,2600,41.935482
674,Other,69,2,2,1,4000,0,4000,57.971016
675,Other,83,2,2,2,4200,847,5047,60.807228
676,Vila Andrade,140,3,4,3,4000,1700,5700,40.714287
677,Vila Mariana,31,1,1,1,2420,528,2948,95.09677
678,Other,69,2,2,1,2424,526,2950,42.753624
679,Other,80,2,2,1,2200,651,2851,35.6375
680,Other,90,3,3,1,1950,1098,3048,33.866665
681,Consolação,30,1,1,0,1841,334,2175,72.5
682,Consolação,69,2,2,1,3500,890,4390,63.623188
683,Vila Mariana,18,1,1,0,1375,403,1778,98.77778
684,Vila Mariana,65,2,1,0,2000,401,2401,36.93846
685,Vila Leopoldina,36,1,1,1,1900,758,2658,73.833336
686,Consolação,41,1,1,1,2350,600,2950,71.95122
687,Other,42,2,1,0,1220,280,1500,35.714287
688,Pinheiros,72,2,2,1,5000,900,5900,81.94444
689,Higienópolis,15,1,1,0,1300,450,1750,116.666664
690,Vila Mascote,63,3,1,1,2050,735,2785,44.20635
691,Brooklin,116,3,2,2,6000,1300,7300,62.931034
692,Vila Mariana,60,2,2,1,2000,978,2978,49.633335
693,Campo Belo,43,1,2,1,2700,580,3280,76.27907
694,Vila Buarque,57,1,1,0,1450,0,1450,25.438597
695,Bela Vista,60,2,2,2,2500,700,3200,53.333332
696,Other,52,2,1,1,1400,460,1860,35.76923
697,Other,60,1,2,1,2000,430,2430,40.5
698,Itaim Bibi,45,1,2,1,2550,983,3533,78.51111
699,Bela Vista,37,1,1,1,2000,450,2450,66.21622
700,Other,76,3,1,2,2800,684,3484,45.842106
701,Other,52,2,1,1,1600,270,1870,35.96154
702,Saúde,90,3,2,2,2900,968,3868,42.97778
703,Vila Mariana,86,2,2,1,2600,944,3544,41.2093
704,Other,44,1,2,2,1800,510,2310,52.5
705,Other,118,3,4,2,4700,1455,6155,52.16102
706,Lapa,138,3,5,3,6500,812,7312,52.985508
707,Cidade Monções,31,1,1,1,2200,525,2725,87.90323
708,Higienópolis,42,1,1,1,2990,700,3690,87.85714
709,Cerqueira César,69,2,1,0,2900,565,3465,50.217392
710,Santana,158,3,3,3,3500,1400,4900,31.01266
711,Itaim Bibi,65,2,2,1,2600,867,3467,53.338463
712,Moema,144,4,4,2,5700,1640,7340,50.97222
713,Pinheiros,90,3,3,1,2800,1200,4000,44.444443
714,Other,55,1,1,2,3990,770,4760,86.545456
715,Pinheiros,35,1,1,1,3500,900,4400,125.71429
716,Cerqueira César,29,1,1,1,2800,337,3137,108.17242
717,Cambuci,39,1,1,1,2260,530,2790,71.53846
718,Other,69,3,1,1,1800,688,2488,36.057972
719,Vila Mariana,86,3,3,2,3200,750,3950,45.930233
720,Other,93,3,4,2,2500,992,3492,37.548386
721,Cerqueira César,76,2,2,2,4500,550,5050,66.447365
722,Saúde,37,1,1,1,2500,506,3006,81.24324
723,Perdizes,76,3,3,2,2650,1000,3650,48.026318
724,Other,77,3,2,2,3000,703,3703,48.090908
725,Perdizes,45,1,1,1,1900,564,2464,54.755554
726,Vila Olímpia,55,2,1,1,3000,733,3733,67.87273
727,Paraíso,100,3,1,0,2800,675,3475,34.75
728,Perdizes,82,3,3,2,2400,1290,3690,45.0
729,Brooklin,67,2,1,1,5000,925,5925,88.43284
730,Vila Andrade,47,1,1,1,3500,0,3500,74.46809
731,Jabaquara,49,2,1,1,1500,500,2000,40.816326
732,Other,75,2,2,2,2050,750,2800,37.333332
733,Itaim Bibi,97,2,3,1,3600,1240,4840,49.896908
734,Other,62,2,2,1,2600,720,3320,53.548386
735,Pinheiros,64,2,2,2,2500,1290,3790,59.21875
736,Vila Madalena,36,1,1,1,3200,561,3761,104.47222
737,Vila Olímpia,65,2,2,1,2700,938,3638,55.96923
738,Moema,27,1,1,0,3500,0,3500,129.62962
739,Saúde,35,1,1,1,1700,700,2400,68.57143
740,Jardim Paulista,53,2,2,1,3450,846,4296,81.0566
741,Santa Cecília,30,1,1,1,1500,424,1924,64.13333
742,Other,57,2,2,1,2000,683,2683,47.070175
743,Pinheiros,65,2,1,1,2250,760,3010,46.307693
744,Vila Mascote,91,3,3,2,4900,1020,5920,65.05495
745,Santo Amaro,54,1,2,1,2300,630,2930,54.25926
746,Vila Mariana,95,3,2,2,3880,747,4627,48.705265
747,Perdizes,130,4,6,3,5500,1700,7200,55.384617
748,Other,72,1,2,2,2700,700,3400,47.22222
749,Other,70,3,1,1,1800,312,2112,30.171429
750,Aclimação,170,3,5,3,9000,1300,10300,60.588234
751,Jardim Paulista,120,3,3,2,4300,1250,5550,46.25
752,Pinheiros,48,1,1,1,3500,680,4180,87.083336
753,Santana,120,3,2,2,2850,911,3761,31.341667
754,Barra Funda,43,2,1,0,1500,320,1820,42.32558
755,Pinheiros,53,1,2,1,2900,920,3820,72.07547
756,Ipiranga,135,4,5,2,4200,1450,5650,41.851852
757,Móoca,142,3,3,2,5800,921,6721,47.330986
758,Liberdade,54,2,1,1,1600,671,2271,42.055557
759,Móoca,86,3,2,1,3000,932,3932,45.720932
760,Other,82,3,3,2,3500,1003,4503,54.914635
761,Bela Vista,113,2,2,1,2100,690,2790,24.690266
762,Consolação,30,1,1,1,1800,550,2350,78.333336
763,Butantã,55,2,2,1,1700,705,2405,43.727272
764,Bela Vista,46,1,1,1,3100,381,3481,75.67391
765,Brooklin,36,1,1,1,2150,470,2620,72.77778
766,Bela Vista,75,2,2,1,3700,865,4565,60.866665
767,Brooklin,111,2,4,2,6800,1000,7800,70.27027
768,Santana,66,3,2,2,1950,700,2650,40.151516
769,Other,58,3,1,1,1000,500,1500,25.862068
770,Brooklin,68,2,2,2,8000,900,8900,130.88235
771,Lapa,93,3,2,2,3250,1100,4350,46.774193
772,Moema,74,2,3,2,7000,832,7832,105.83784
773,Ipiranga,68,2,2,1,2300,700,3000,44.117645
774,Santo Amaro,96,3,3,2,3500,920,4420,46.041668
775,Other,53,1,1,1,1520,400,1920,36.226414
776,Other,70,2,2,2,3100,600,3700,52.857143
777,Jardim Paulista,100,2,3,2,8500,1270,9770,97.7
778,Pinheiros,65,2,2,1,4000,975,4975,76.53846
779,Paraíso,110,2,1,1,2950,1200,4150,37.727272
780,Paraíso,124,3,3,2,6000,1100,7100,57.258064
781,Bela Vista,30,1,1,1,1300,514,1814,60.466667
782,Bela Vista,44,1,1,0,2899,475,3374,76.681816
783,Other,60,2,1,2,2500,1090,3590,59.833332
784,Aclimação,40,1,1,1,1900,558,2458,61.45
785,Tatuapé,27,1,1,0,1500,220,1720,63.703705
786,Other,65,3,1,1,1750,380,2130,32.76923
787,Other,53,2,1,1,1310,390,1700,32.07547
788,Other,110,3,3,2,2800,1128,3928,35.70909
789,Perdizes,118,3,3,2,3500,1265,4765,40.381355
790,Jaguaré,62,2,2,1,2300,555,2855,46.048386
791,Moema,67,2,3,2,4000,1300,5300,79.10448
792,Vila Olímpia,32,1,1,1,2340,1010,3350,104.6875
793,Jardim Paulista,107,3,2,1,3500,950,4450,41.588783
794,Moema,40,1,1,1,1899,710,2609,65.225
795,Other,89,3,2,1,1400,721,2121,23.83146
796,Tatuapé,24,1,1,0,1400,250,1650,68.75
797,Saúde,35,1,1,1,2250,445,2695,77.0
798,Brooklin,72,2,2,1,5500,1000,6500,90.27778
799,Other,36,1,1,1,2200,360,2560,71.111115
800,Vila Nova Conceição,70,2,1,0,2900,809,3709,52.985714
801,Other,61,3,2,1,2300,540,2840,46.557377
802,Santana,52,2,1,1,1300,383,1683,32.365383
803,Ipiranga,60,2,1,0,1700,150,1850,30.833334
804,Brooklin,43,1,1,1,3200,650,3850,89.53488
805,Moema,115,3,3,2,5000,1160,6160,53.565216
806,Campo Belo,78,2,2,1,2200,826,3026,38.794872
807,Indianópolis,72,3,2,2,3200,1035,4235,58.819443
808,Vila Clementino,65,2,2,1,2500,1196,3696,56.861538
809,Jardim Paulista,56,1,1,1,2400,655,3055,54.55357
810,Aclimação,70,2,2,3,2200,1212,3412,48.74286
811,Lapa,63,3,2,1,2400,465,2865,45.47619
812,Other,40,2,1,0,1150,0,1150,28.75
813,Vila Olímpia,40,1,1,1,2800,410,3210,80.25
814,Other,65,3,2,1,2000,550,2550,39.23077
815,Mirandópolis,65,2,2,2,2500,1000,3500,53.846153
816,Pompeia,120,2,4,2,7500,1000,8500,70.833336
817,Vila Nova Conceição,41,1,1,1,2890,1091,3981,97.097565
818,Other,27,1,1,0,1200,50,1250,46.296295
819,Butantã,14,1,1,0,1200,0,1200,85.71429
820,Perdizes,60,2,1,2,2800,800,3600,60.0
821,Vila Mariana,36,1,1,1,2050,600,2650,73.611115
822,Perdizes,129,3,1,2,3250,1670,4920,38.139534
823,Cidade Monções,38,1,1,1,3300,560,3860,101.57895
824,Moema,60,2,2,1,2400,865,3265,54.416668
825,Bela Vista,43,1,1,1,3000,0,3000,69.76744
826,Brooklin,72,2,3,2,3500,1120,4620,64.166664
827,Other,70,2,2,1,1900,594,2494,35.62857
828,Vila Mascote,74,3,2,1,1900,635,2535,34.256756
829,Vila Mariana,70,2,2,1,2500,731,3231,46.157143
830,Pinheiros,93,3,1,2,5300,943,6243,67.129036
831,Cerqueira César,95,2,2,1,3000,998,3998,42.08421
832,Other,60,2,1,1,1100,470,1570,26.166666
833,Perdizes,130,4,5,3,5500,1700,7200,55.384617
834,Brooklin,96,1,2,2,7800,1600,9400,97.916664
835,Vila Mariana,65,2,2,1,2400,1180,3580,55.076923
836,Pinheiros,71,2,2,2,6000,970,6970,98.169014
837,Other,82,2,2,2,3000,966,3966,48.365852
838,Vila Clementino,45,1,1,1,2700,645,3345,74.333336
839,Saúde,107,3,1,2,4500,680,5180,48.411217
840,Bela Vista,42,1,1,1,2600,900,3500,83.333336
841,Vila Guarani,57,2,1,1,1900,661,2561,44.929825
842,Saúde,69,2,2,1,2200,680,2880,41.739132
843,Other,44,2,1,0,1500,200,1700,38.636364
844,Jardim Paulista,44,1,1,1,2200,491,2691,61.159092
845,Vila Olímpia,62,2,1,1,1900,849,2749,44.33871
846,Brás,30,1,1,0,800,272,1072,35.733334
847,Cambuci,100,3,2,1,1200,1600,2800,28.0
848,Aclimação,43,1,1,1,2000,547,2547,59.23256
849,Vila Olímpia,65,2,2,1,2950,1013,3963,60.96923
850,Perdizes,45,1,1,1,2250,554,2804,62.31111
851,Brooklin,105,3,3,1,7000,1386,8386,79.86667
852,Vila Madalena,80,2,2,1,3350,780,4130,51.625
853,Brooklin,46,1,2,1,1450,825,2275,49.45652
854,Consolação,35,1,1,1,2300,369,2669,76.25714
855,Vila Andrade,67,3,2,1,2000,652,2652,39.58209
856,Vila Olímpia,65,2,2,1,4300,899,5199,79.98462
857,Cambuci,39,1,1,1,2260,530,2790,71.53846
858,Other,80,3,3,1,2800,632,3432,42.9
859,Pinheiros,30,1,1,1,2200,720,2920,97.333336
860,Vila Nova Conceição,50,1,2,2,2200,1150,3350,67.0
861,Ipiranga,80,3,3,2,2700,1050,3750,46.875
862,Vila Buarque,75,2,1,0,2100,622,2722,36.293335
863,Pinheiros,50,1,1,1,3500,565,4065,81.3
864,Pinheiros,106,3,3,1,6185,1400,7585,71.5566
865,Other,100,2,2,0,3000,1161,4161,41.61
866,Pinheiros,83,2,1,1,3000,925,3925,47.289158
867,Tatuapé,90,2,1,1,1100,600,1700,18.88889
868,Pompeia,72,3,2,2,3100,799,3899,54.15278
869,Vila Mariana,57,2,1,1,3900,653,4553,79.87719
870,Other,58,3,1,1,2000,650,2650,45.689655
871,Bela Vista,40,1,1,1,2200,435,2635,65.875
872,Centro,140,2,2,0,2800,633,3433,24.52143
873,Pinheiros,93,2,2,0,2900,243,3143,33.7957
874,Other,63,2,2,1,2800,460,3260,51.746033
875,Moema,35,1,1,1,2100,850,2950,84.28571
876,Moema,72,3,2,1,3100,974,4074,56.583332
877,Other,45,2,1,1,1500,450,1950,43.333332
878,Vila Nova Conceição,50,1,1,1,4500,1150,5650,113.0
879,Santa Cecília,40,1,1,0,2500,77,2577,64.425
880,Vila Madalena,72,2,2,1,2840,797,3637,50.51389
881,Brooklin,37,1,1,1,2900,690,3590,97.02702
882,Saúde,57,2,2,1,2200,405,2605,45.701756
883,Jardim Paulista,41,1,1,1,1800,875,2675,65.243904
884,Vila Mariana,53,2,2,1,3100,970,4070,76.79245
885,Other,85,2,1,0,2200,630,2830,33.294117
886,Brooklin,55,2,2,1,2500,590,3090,56.18182
887,Brooklin,96,3,3,1,3200,789,3989,41.552082
888,Vila Mariana,42,1,1,1,1800,690,2490,59.285713
889,Moema,80,2,3,1,4000,935,4935,61.6875
890,Other,35,1,1,1,600,579,1179,33.685715
891,Bela Vista,28,1,1,1,1300,521,1821,65.03571
892,Pinheiros,55,1,1,0,1800,750,2550,46.363636
893,Higienópolis,95,2,2,1,2500,968,3468,36.505264
894,Aclimação,55,1,1,0,1500,132,1632,29.672728
895,Brás,65,2,1,1,1700,487,2187,33.646152
896,Consolação,120,2,1,0,2600,771,3371,28.091667
897,Other,63,3,2,2,1800,674,2474,39.26984
898,Vila Nova Conceição,70,2,2,1,3000,1200,4200,60.0
899,Brooklin,70,2,2,1,2100,1000,3100,44.285713
900,Other,64,2,1,1,2450,0,2450,38.28125
901,Consolação,35,1,1,1,2676,304,2980,85.14286
902,Other,33,1,1,1,1350,70,1420,43.030304
903,Liberdade,38,1,1,0,2200,809,3009,79.18421
904,Tatuapé,74,2,2,2,3300,1040,4340,58.648647
905,Moema,45,1,1,1,2550,750,3300,73.333336
906,Jardim Paulista,50,2,1,1,2600,837,3437,68.74
907,Other,28,1,1,0,1600,0,1600,57.142857
908,Vila Mariana,90,3,3,1,4800,0,4800,53.333332
909,Pinheiros,140,3,3,1,5000,1245,6245,44.607143
910,Vila Olímpia,65,2,2,1,4900,880,5780,88.92308
911,Higienópolis,125,3,2,1,4000,0,4000,32.0
912,Bela Vista,42,1,1,1,2500,415,2915,69.40476
913,Santa Cecília,45,1,1,1,1600,622,2222,49.377777
914,Other,77,2,3,1,2806,700,3506,45.532467
915,Jardim Marajoara,63,3,2,1,1700,678,2378,37.746033
916,Vila Guarani,80,2,1,1,1500,700,2200,27.5
917,Jabaquara,56,2,1,1,1300,880,2180,38.92857
918,Pinheiros,45,1,1,1,2000,788,2788,61.955555
919,Ipiranga,50,2,1,1,1700,460,2160,43.2
920,Pinheiros,45,1,1,1,2700,770,3470,77.111115
921,Other,62,2,1,1,1250,0,1250,20.161291
922,Bela Vista,43,1,1,0,1750,557,2307,53.65116
923,Perdizes,106,3,4,2,3100,1339,4439,41.877357
924,Other,47,2,1,1,1100,520,1620,34.468086
925,Santo Amaro,160,3,4,2,4800,1270,6070,37.9375
926,Itaim Bibi,100,2,3,2,5500,1345,6845,68.45
927,Vila Leopoldina,50,2,1,2,2200,630,2830,56.6
928,Consolação,42,1,1,0,1400,300,1700,40.47619
929,Saúde,37,1,1,1,1800,490,2290,61.89189
930,Chácara Santo Antônio,112,3,3,2,5500,840,6340,56.607143
931,Vila Leopoldina,63,2,2,2,2900,810,3710,58.88889
932,Pinheiros,58,2,2,1,2200,882,3082,53.13793
933,Other,70,2,1,1,2200,738,2938,41.971428
934,Other,73,2,2,1,3600,550,4150,56.849316
935,Other,86,3,3,2,2800,892,3692,42.930233
936,Centro,42,1,1,1,1600,551,2151,51.214287
937,Other,38,2,1,1,800,300,1100,28.947369
938,Other,60,2,1,1,1450,0,1450,24.166666
939,Other,45,2,1,1,1700,400,2100,46.666668
940,Jardim Paulista,59,1,1,1,2600,590,3190,54.067795
941,Vila Olímpia,87,3,3,2,6000,910,6910,79.425285
942,Brás,50,2,1,0,2500,500,3000,60.0
943,Vila Olímpia,38,1,1,1,3970,800,4770,125.52631
944,Consolação,38,1,1,1,1900,450,2350,61.842106
945,Other,40,1,1,1,2321,0,2321,58.025
946,Jardim Paulista,50,2,1,1,2600,837,3437,68.74
947,Ipiranga,140,4,4,2,3900,1300,5200,37.142857
948,Brás,32,1,1,0,1400,190,1590,49.6875
949,Chácara Santo Antônio,51,2,2,1,2950,620,3570,70.0
950,Consolação,35,1,1,1,2800,650,3450,98.57143
951,Vila Guarani,60,2,2,2,1300,910,2210,36.833332
952,Vila Nova Conceição,62,2,2,1,4800,873,5673,91.5
953,Jardim América,77,2,2,1,3200,1500,4700,61.03896
954,Móoca,85,2,2,2,3200,685,3885,45.705883
955,Other,45,2,1,1,1200,450,1650,36.666668
956,Móoca,80,3,2,2,2600,760,3360,42.0
957,Other,34,1,1,1,1600,544,2144,63.058823
958,Cerqueira César,91,2,2,1,2200,1550,3750,41.20879
959,Other,82,3,2,2,2470,800,3270,39.878048
960,Saúde,59,2,1,1,1600,400,2000,33.898304
961,Vila Leopoldina,85,3,2,2,4500,980,5480,64.47059
962,Bela Vista,83,2,2,1,3200,1045,4245,51.144577
963,Consolação,40,1,1,1,1800,624,2424,60.6
964,Jaguaré,70,3,2,1,2300,500,2800,40.0
965,Vila Madalena,24,1,1,0,1900,550,2450,102.083336
966,Consolação,40,1,1,1,3000,480,3480,87.0
967,Vila Olímpia,54,1,1,1,3400,660,4060,75.18519
968,Vila Andrade,95,2,1,2,3300,802,4102,43.178947
969,Moema,45,1,1,1,3500,1000,4500,100.0
970,Vila Mariana,120,2,3,2,3700,724,4424,36.866665
971,Cambuci,56,2,1,1,2800,773,3573,63.80357
972,Jardim Paulista,85,2,2,1,3500,1006,4506,53.011765
973,Other,125,3,3,2,4000,1140,5140,41.12
974,Pinheiros,35,1,1,1,3350,444,3794,108.4
975,Campo Belo,65,2,2,1,2700,980,3680,56.615383
976,Jaguaré,70,3,1,1,2800,442,3242,46.314285
977,Other,51,2,1,1,1300,417,1717,33.666668
978,Barra Funda,93,3,3,2,3000,1000,4000,43.010754
979,Butantã,57,2,2,1,1800,825,2625,46.05263
980,Other,64,2,2,1,1700,1200,2900,45.3125
981,Saúde,60,2,2,1,1500,806,2306,38.433334
982,Other,62,2,2,1,2800,628,3428,55.29032
983,Aclimação,35,1,1,1,2100,455,2555,73.0
984,Vila Prudente,61,3,2,1,1980,357,2337,38.311474
985,Tatuapé,160,4,5,3,3415,1560,4975,31.09375
986,Vila Mariana,84,2,1,1,1700,1250,2950,35.11905
987,Vila Madalena,30,1,1,1,2500,615,3115,103.833336
988,Vila Olímpia,89,3,2,2,5800,912,6712,75.41573
989,Vila Olímpia,70,2,2,1,2600,920,3520,50.285713
990,Brooklin,51,1,1,1,2900,573,3473,68.09804
991,Centro,32,1,1,1,1600,483,2083,65.09375
992,Morumbi,65,2,2,1,3300,580,3880,59.692307
993,Brooklin,87,1,1,2,5870,1070,6940,79.77012
994,Jardim Paulista,106,3,3,1,3200,1000,4200,39.622643
995,Other,45,1,1,0,1300,340,1640,36.444443
996,Other,70,3,2,2,2000,851,2851,40.728573
997,Other,50,2,1,1,1800,450,2250,45.0
998,Lapa,54,2,2,1,2300,780,3080,57.037037
999,Saúde,63,2,2,1,2200,980,3180,50.47619
1000,Other,67,2,2,1,2200,780,2980,44.47761
1001,Moema,72,3,1,1,2300,960,3260,45.27778
1002,Vila Mariana,45,1,1,1,2190,660,2850,63.333332
1003,Jardim Paulista,110,3,3,2,3900,1223,5123,46.572727
1004,Chácara Santo Antônio,37,1,1,1,2300,512,2812,76.0
1005,Vila Olímpia,83,2,2,1,2500,1572,4072,49.06024
1006,Bela Vista,28,1,1,0,1200,380,1580,56.42857
1007,Santo Amaro,55,2,2,1,2600,900,3500,63.636364
1008,Tatuapé,54,2,2,1,1800,730,2530,46.851852
1009,Other,42,1,1,1,1400,506,1906,45.38095
1010,Other,45,1,1,1,2200,617,2817,62.6
1011,Pinheiros,85,2,3,1,4500,900,5400,63.52941
1012,Perdizes,42,1,1,1,2400,561,2961,70.5
1013,Vila Mariana,85,2,1,1,3300,798,4098,48.211765
1014,Tatuapé,100,3,3,2,3500,660,4160,41.6
1015,Other,84,3,3,2,3600,619,4219,50.22619
1016,Ipiranga,32,1,1,1,1500,478,1978,61.8125
1017,Bela Vista,26,1,1,0,2000,0,2000,76.92308
1018,Other,98,3,2,2,4100,750,4850,49.489796
1019,Consolação,35,1,1,1,1800,800,2600,74.28571
1020,Other,55,2,1,0,1200,350,1550,28.181818
1021,Other,70,2,2,0,1600,359,1959,27.985714
1022,Bela Vista,99,1,1,1,1300,480,1780,17.979797
1023,Moema,100,3,3,2,2700,1207,3907,39.07
1024,Santo Amaro,58,1,2,0,3300,500,3800,65.51724
1025,Moema,44,1,1,1,2450,610,3060,69.545456
1026,Vila Mascote,74,3,2,1,2200,635,2835,38.31081
1027,Consolação,127,3,3,2,6500,1050,7550,59.44882
1028,Jardins,46,2,1,1,2300,880,3180,69.13043
1029,Pinheiros,45,1,2,1,2650,651,3301,73.35555
1030,Paraíso,110,3,3,2,2700,1220,3920,35.636364
1031,Pompeia,50,1,1,0,1500,150,1650,33.0
1032,Other,38,2,1,0,1100,210,1310,34.473682
1033,Aclimação,60,1,1,0,1480,480,1960,32.666668
1034,Paraíso,100,3,3,2,5500,1455,6955,69.55
1035,Tatuapé,47,1,1,1,2100,686,2786,59.276596
1036,Paraíso,105,3,3,1,5500,1250,6750,64.28571
1037,Liberdade,38,2,1,0,1950,330,2280,60.0
1038,Other,75,3,2,1,2200,0,2200,29.333334
1039,Saúde,60,2,2,1,2000,780,2780,46.333332
1040,Vila Mariana,110,3,2,1,3200,1150,4350,39.545456
1041,Other,73,3,2,2,3100,500,3600,49.315067
1042,Jardins,60,2,2,2,4000,870,4870,81.166664
1043,Vila Mascote,113,2,4,2,4300,1100,5400,47.78761
1044,Higienópolis,38,1,1,1,2350,1252,3602,94.789474
1045,Aclimação,56,1,1,0,1500,340,1840,32.857143
1046,Bela Vista,37,1,1,1,1300,553,1853,50.08108
1047,Vila Mariana,28,2,2,0,2550,635,3185,113.75
1048,Moema,120,4,4,2,5600,1156,6756,56.3
1049,Campo Belo,43,1,1,1,2400,654,3054,71.023254
1050,Vila Mariana,90,3,2,1,2800,515,3315,36.833332
1051,Liberdade,25,1,1,0,1900,447,2347,93.88
1052,Moema,80,3,3,1,3700,935,4635,57.9375
1053,Other,97,3,2,2,2600,912,3512,36.206184
1054,Bela Vista,61,1,1,1,1400,340,1740,28.52459
1055,Other,70,3,2,1,1400,600,2000,28.571428
1056,Moema,50,1,1,1,1650,1057,2707,54.14
1057,Ipiranga,111,3,2,2,5500,950,6450,58.10811
1058,Jardim Paulista,70,1,1,1,6500,1600,8100,115.71429
1059,Vila Mariana,100,3,2,0,2300,500,2800,28.0
1060,Moema,95,3,3,2,5200,1500,6700,70.52631
1061,Morumbi,65,2,2,2,1800,646,2446,37.630768
1062,Vila Mariana,44,2,1,0,2000,564,2564,58.272728
1063,República,48,1,1,1,2990,406,3396,70.75
1064,Other,30,1,1,0,1000,0,1000,33.333332
1065,Santo Amaro,35,2,1,0,1900,200,2100,60.0
1066,Vila Madalena,57,2,2,2,2500,1420,3920,68.77193
1067,Tatuapé,70,3,2,2,2700,617,3317,47.385715
1068,Itaim Bibi,137,3,3,1,4500,1361,5861,42.78102
1069,Pinheiros,83,2,2,1,3000,1220,4220,50.843372
1070,Other,35,1,1,1,1600,566,2166,61.885715
1071,Ipiranga,34,1,1,1,1800,340,2140,62.941177
1072,Jardins,130,2,3,1,5000,1200,6200,47.692307
1073,Pompeia,123,3,1,2,5000,1617,6617,53.79675
1074,Vila Mascote,165,3,5,3,6500,887,7387,44.769695
1075,Other,38,2,1,1,950,623,1573,41.394737
1076,Morumbi,71,2,2,2,2200,606,2806,39.521126
1077,Other,40,1,1,0,950,0,950,23.75
1078,Other,50,2,1,0,1100,0,1100,22.0
1079,Tatuapé,50,1,1,1,2350,391,2741,54.82
1080,Brooklin,37,1,1,1,3500,780,4280,115.675674
1081,Other,127,3,4,4,7000,1450,8450,66.53543
1082,Other,48,1,1,1,3000,665,3665,76.354164
1083,Jardim Paulista,55,1,2,1,3700,980,4680,85.09091
1084,Other,125,3,4,3,3800,0,3800,30.4
1085,Other,30,1,1,0,900,0,900,30.0
1086,Tatuapé,75,2,1,1,1100,300,1400,18.666666
1087,Móoca,52,2,1,1,2400,397,2797,53.78846
1088,Jardim Marajoara,58,2,1,1,1866,634,2500,43.103447
1089,Vila Olímpia,45,1,1,1,2900,776,3676,81.68889
1090,Pinheiros,90,2,1,2,6500,989,7489,83.21111
1091,Other,87,3,2,2,2700,880,3580,41.149426
1092,Perdizes,45,1,1,1,2400,560,2960,65.77778
1093,Campo Belo,35,1,1,1,2300,750,3050,87.14286
1094,Pinheiros,64,2,2,2,4800,841,5641,88.140625
1095,Bela Vista,40,1,1,2,2000,600,2600,65.0
1096,Moema,27,1,1,0,2500,590,3090,114.44444
1097,Pinheiros,85,2,2,1,3000,1200,4200,49.411766
1098,Morumbi,64,2,2,2,3000,580,3580,55.9375
1099,Other,58,3,1,1,1500,400,1900,32.75862
1100,Other,90,3,2,2,3500,1450,4950,55.0
1101,Pinheiros,24,1,1,0,2400,300,2700,112.5
1102,Vila Mariana,100,3,1,2,5000,600,5600,56.0
1103,Brooklin,98,3,3,2,4500,1168,5668,57.836735
1104,Other,180,3,3,2,4700,1660,6360,35.333332
1105,Vila Leopoldina,70,1,1,1,2800,710,3510,50.142857
1106,Vila Nova Conceição,70,2,1,1,2200,783,2983,42.614285
1107,Higienópolis,44,1,1,1,3000,1165,4165,94.65909
1108,Higienópolis,65,2,1,1,1800,950,2750,42.307693
1109,Vila Olímpia,124,3,2,2,4350,1350,5700,45.967743
1110,Moema,65,2,2,2,3000,994,3994,61.446156
1111,Bela Vista,84,2,3,0,6300,1300,7600,90.47619
1112,Vila Leopoldina,56,2,2,1,1900,688,2588,46.214287
1113,Other,78,2,1,1,1680,0,1680,21.538462
1114,Bela Vista,56,2,2,1,2950,820,3770,67.32143
1115,Vila Mascote,64,2,1,2,2800,667,3467,54.171875
1116,Other,63,2,2,1,1500,650,2150,34.126984
1117,Other,75,3,2,1,1800,607,2407,32.093334
1118,Higienópolis,113,3,2,1,3600,1450,5050,44.690266
1119,Moema,61,2,2,1,2800,890,3690,60.491802
1120,Barra Funda,60,2,1,0,1600,240,1840,30.666666
1121,Consolação,38,1,1,1,1300,1200,2500,65.789474
1122,Barra Funda,31,1,1,0,1500,330,1830,59.032257
1123,Morumbi,135,3,4,2,2600,1700,4300,31.851852
1124,Other,85,3,2,2,3700,690,4390,51.64706
1125,Butantã,47,2,1,1,1100,699,1799,38.276596
1126,Other,49,1,2,1,3100,570,3670,74.89796
1127,Other,55,2,1,1,1550,1,1551,28.2
1128,Other,55,2,1,1,1250,347,1597,29.036364
1129,Other,77,2,2,2,6200,980,7180,93.24675
1130,Other,54,2,1,1,1600,545,2145,39.72222
1131,Liberdade,50,1,1,1,1400,470,1870,37.4
1132,Bela Vista,63,2,1,2,3950,1263,5213,82.74603
1133,Chácara Santo Antônio,65,2,2,1,2650,615,3265,50.23077
1134,Jardim Paulista,50,1,1,1,2300,700,3000,60.0
1135,Pinheiros,60,2,1,1,2800,800,3600,60.0
1136,Jardim Paulista,35,1,1,1,1680,584,2264,64.685715
1137,Perdizes,63,2,1,1,5000,850,5850,92.85714
1138,Jabaquara,55,2,1,1,1000,700,1700,30.90909
1139,Other,55,2,1,1,1150,450,1600,29.09091
1140,Pinheiros,40,1,1,1,3410,856,4266,106.65
1141,Aclimação,45,2,1,0,1700,550,2250,50.0
1142,Vila Clementino,87,3,3,2,5000,1300,6300,72.413795
1143,Other,108,3,3,1,2800,1300,4100,37.962963
1144,Vila Guarani,94,2,2,2,4200,650,4850,51.595745
1145,Pompeia,80,3,3,2,3000,906,3906,48.825
1146,Brás,90,2,2,0,1300,290,1590,17.666666
1147,Moema,68,2,2,1,5000,0,5000,73.52941
1148,Other,57,2,1,1,1200,425,1625,28.508772
1149,Other,48,2,1,1,1600,267,1867,38.895832
1150,Brooklin,51,1,1,1,3100,590,3690,72.35294
1151,Vila Clementino,90,3,2,1,2500,617,3117,34.633335
1152,Vila Leopoldina,151,3,5,3,7500,1690,9190,60.860928
1153,Other,127,3,3,2,4200,880,5080,40.0
1154,Other,50,2,1,1,1470,508,1978,39.56
1155,Vila Mariana,78,3,3,2,2600,820,3420,43.846153
1156,Brás,64,2,2,1,2200,509,2709,42.328125
1157,Vila Buarque,39,1,1,1,1699,645,2344,60.102566
1158,Brás,36,1,1,0,1000,227,1227,34.083332
1159,Cambuci,50,1,1,0,1700,380,2080,41.6
1160,Morumbi,90,2,3,2,2350,898,3248,36.08889
1161,Vila Mariana,53,2,2,1,2500,990,3490,65.84906
1162,Móoca,38,1,1,0,2500,350,2850,75.0
1163,Other,77,2,2,1,2699,640,3339,43.363636
1164,Other,142,3,4,2,6000,1150,7150,50.35211
1165,Saúde,42,1,1,1,1800,723,2523,60.07143
1166,Aclimação,88,3,3,1,3000,830,3830,43.522728
1167,Campo Belo,39,1,1,1,1700,716,2416,61.94872
1168,Paraíso,70,2,2,2,4900,640,5540,79.14286
1169,Other,60,2,2,1,2700,600,3300,55.0
1170,Barra Funda,105,3,3,2,4000,1100,5100,48.57143
1171,Campo Belo,43,1,1,1,1600,670,2270,52.7907
1172,Tatuapé,106,3,1,2,3900,740,4640,43.773586
1173,Barra Funda,47,1,1,1,2000,700,2700,57.446808
1174,Vila Andrade,181,3,2,2,3800,663,4463,24.65746
1175,Other,83,3,2,1,2800,680,3480,41.92771
1176,Butantã,67,2,2,1,3000,600,3600,53.731342
1177,Bela Vista,75,1,2,1,4300,1500,5800,77.333336
1178,Móoca,60,2,1,1,1600,200,1800,30.0
1179,Other,48,2,1,1,649,351,1000,20.833334
1180,Perdizes,86,3,3,1,3000,850,3850,44.76744
1181,Other,64,2,2,2,1800,628,2428,37.9375
1182,Other,92,3,2,2,2700,833,3533,38.402172
1183,Other,50,2,1,1,1500,500,2000,40.0
1184,Vila Nova Conceição,72,3,2,2,4200,955,5155,71.59722
1185,Vila Mariana,43,1,1,1,1650,460,2110,49.069767
1186,Other,68,3,2,1,2700,943,3643,53.57353
1187,Other,45,1,1,1,1550,900,2450,54.444443
1188,Vila Clementino,94,3,4,2,5000,1300,6300,67.02128
1189,Jardim Paulista,90,1,2,1,3200,1500,4700,52.22222
1190,Itaim Bibi,100,2,2,1,3100,799,3899,38.99
1191,Vila Mariana,49,1,1,1,1650,940,2590,52.857143
1192,Vila Mariana,55,2,2,1,3500,790,4290,78.0
1193,Vila Mascote,60,2,1,1,2450,550,3000,50.0
1194,Tatuapé,117,3,2,3,2900,1318,4218,36.05128
1195,Other,50,2,1,1,920,380,1300,26.0
1196,Campo Belo,71,2,2,2,4501,1360,5861,82.54929
1197,Other,84,3,2,2,3000,867,3867,46.035713
1198,Vila Olímpia,70,1,2,1,5240,1000,6240,89.14286
1199,República,40,1,1,1,2000,550,2550,63.75
1200,Vila Mariana,33,1,1,0,1400,450,1850,56.060608
1201,Other,65,3,3,1,1900,460,2360,36.307693
1202,Itaim Bibi,45,1,1,1,2550,983,3533,78.51111
1203,Ipiranga,64,2,1,1,2600,700,3300,51.5625
1204,Vila Buarque,55,2,1,1,2400,702,3102,56.4
1205,Cerqueira César,78,2,2,1,2500,1600,4100,52.564102
1206,Higienópolis,55,2,2,1,2490,904,3394,61.70909
1207,Other,102,3,4,2,3800,950,4750,46.568626
1208,Other,58,2,1,1,1290,580,1870,32.24138
1209,Higienópolis,193,3,2,1,6000,1701,7701,39.901554
1210,Brooklin,90,3,3,2,3500,1103,4603,51.144444
1211,Other,75,2,1,0,1800,625,2425,32.333332
1212,Other,55,2,1,1,1500,500,2000,36.363636
1213,Vila Mariana,120,3,3,2,2950,1344,4294,35.783333
1214,Brooklin,78,2,2,1,4500,790,5290,67.82051
1215,Jabaquara,55,2,1,1,1380,600,1980,36.0
1216,Vila Andrade,85,3,2,2,2700,680,3380,39.764706
1217,Other,48,2,1,1,1255,465,1720,35.833332
1218,Vila Guarani,84,2,2,1,1999,613,2612,31.095238
1219,Barra Funda,71,2,2,2,3100,350,3450,48.59155
1220,Perdizes,35,1,1,1,2500,650,3150,90.0
1221,Other,74,2,2,1,3400,900,4300,58.10811
1222,Other,38,1,1,1,1900,512,2412,63.473682
1223,Centro,40,1,1,0,900,300,1200,30.0
1224,Brooklin,84,2,3,2,8500,900,9400,111.90476
1225,Other,65,3,2,1,1800,814,2614,40.215385
1226,Other,22,1,1,0,1100,300,1400,63.636364
1227,Aclimação,82,3,3,2,2400,1087,3487,42.52439
1228,Other,28,1,1,0,650,392,1042,37.214287
1229,Brooklin,96,3,2,2,5300,1150,6450,67.1875
1230,Vila Nova Conceição,62,2,2,1,5000,873,5873,94.72581
1231,Santana,145,3,4,3,4000,1500,5500,37.931034
1232,Pinheiros,120,3,3,2,5000,1300,6300,52.5
1233,Brooklin,63,2,2,2,3000,950,3950,62.698414
1234,Vila Andrade,85,3,2,1,3196,582,3778,44.44706
1235,Other,45,1,1,0,1100,280,1380,30.666666
1236,Other,70,2,1,0,1460,220,1680,24.0
1237,Other,126,2,2,2,3800,950,4750,37.698414
1238,Pinheiros,110,3,2,0,2000,396,2396,21.781818
1239,Pinheiros,50,1,1,0,1500,208,1708,34.16
1240,Aclimação,35,1,1,0,1200,290,1490,42.57143
1241,Bela Vista,53,1,1,0,1350,392,1742,32.867924
1242,Mirandópolis,70,2,2,1,2000,950,2950,42.142857
1243,Bela Vista,38,1,1,0,900,285,1185,31.18421
1244,Jardim Paulista,100,2,1,1,2600,950,3550,35.5
1245,Other,156,4,5,3,4300,1490,5790,37.115383
1246,Santa Cecília,95,2,1,1,3400,0,3400,35.789474
1247,Vila Andrade,33,1,1,1,1400,500,1900,57.575756
1248,Other,42,2,1,1,750,300,1050,25.0
1249,Vila Olímpia,79,2,1,1,2200,530,2730,34.55696
1250,Vila Olímpia,30,1,1,1,2800,600,3400,113.333336
1251,Other,60,1,2,1,1750,616,2366,39.433334
1252,Moema,45,1,1,1,1766,684,2450,54.444443
1253,Vila Mariana,50,1,2,1,2800,856,3656,73.12
1254,Consolação,40,1,1,1,2800,340,3140,78.5
1255,Paraíso,63,2,1,1,1900,844,2744,43.555557
1256,Vila Nova Conceição,45,1,1,1,3600,1000,4600,102.22222
1257,Moema,210,3,4,0,5000,0,5000,23.809525
1258,Vila Olímpia,74,2,1,3,6350,850,7200,97.297295
1259,Liberdade,65,2,2,1,3400,550,3950,60.76923
1260,Saúde,40,1,2,1,2450,490,2940,73.5
1261,Campo Belo,60,2,2,1,4650,680,5330,88.833336
1262,Jardim Paulista,100,2,2,1,3500,1000,4500,45.0
1263,Brooklin,100,3,3,2,4500,1080,5580,55.8
1264,Vila Madalena,58,2,1,1,4400,798,5198,89.62069
1265,Vila Clementino,27,1,1,0,2200,398,2598,96.22222
1266,Other,130,3,4,2,4800,1300,6100,46.923077
1267,Perdizes,103,3,2,1,2000,1290,3290,31.941748
1268,Indianópolis,50,1,2,1,4500,570,5070,101.4
1269,Vila Olímpia,100,3,3,1,3150,690,3840,38.4
1270,Vila Madalena,31,1,1,0,3000,450,3450,111.29032
1271,Brooklin,67,1,1,1,4000,1000,5000,74.62687
1272,Pinheiros,65,2,1,1,2100,760,2860,44.0
1273,Mirandópolis,68,2,2,2,3900,895,4795,70.51471
1274,Consolação,30,1,1,0,1900,415,2315,77.166664
1275,Bela Vista,66,3,2,1,3500,750,4250,64.393936
1276,Pinheiros,63,1,2,1,4500,795,5295,84.04762
1277,Butantã,156,4,4,2,6300,1300,7600,48.71795
1278,Consolação,36,1,1,1,2300,404,2704,75.111115
1279,Other,85,2,1,0,1700,251,1951,22.952942
1280,Tatuapé,66,2,2,2,2600,600,3200,48.484848
1281,Liberdade,28,1,1,0,3000,270,3270,116.78571
1282,Other,50,2,2,1,1400,550,1950,39.0
1283,Jardim Marajoara,92,2,1,2,3800,772,4572,49.695652
1284,Vila Olímpia,66,1,2,1,2300,500,2800,42.424244
1285,Consolação,42,1,1,1,1500,807,2307,54.92857
1286,Vila Clementino,65,2,2,1,3400,720,4120,63.384617
1287,Jardim América,31,1,1,1,2700,587,3287,106.03226
1288,Other,63,2,2,1,5100,800,5900,93.650795
1289,Brás,50,2,1,1,1500,380,1880,37.6
1290,Other,47,2,1,1,1200,550,1750,37.234043
1291,Moema,130,3,3,1,4500,1370,5870,45.153847
1292,Brás,60,2,1,1,1300,490,1790,29.833334
1293,Campo Belo,70,2,2,1,5000,860,5860,83.71429
1294,Vila Madalena,75,2,1,1,3200,0,3200,42.666668
1295,Lapa,48,2,1,1,2200,365,2565,53.4375
1296,Bela Vista,36,1,1,1,2500,410,2910,80.833336
1297,Other,100,3,3,3,3900,0,3900,39.0
1298,Cerqueira César,55,1,1,1,3000,900,3900,70.90909
1299,Santa Cecília,50,1,1,1,2000,606,2606,52.12
1300,Vila Mascote,50,2,1,1,1300,636,1936,38.72
1301,Mirandópolis,85,2,3,2,2800,827,3627,42.67059
1302,Aclimação,118,3,3,2,3500,1360,4860,41.18644
1303,Itaim Bibi,40,1,1,1,3600,579,4179,104.475
1304,Moema,60,2,2,1,2885,787,3672,61.2
1305,Pinheiros,130,3,2,0,2500,607,3107,23.9
1306,Moema,94,3,3,1,5400,1084,6484,68.97872
1307,Other,52,2,1,1,1200,340,1540,29.615385
1308,Vila Mariana,67,2,2,1,3000,935,3935,58.731342
1309,Other,64,2,1,0,1490,160,1650,25.78125
1310,Perdizes,70,2,1,0,1680,333,2013,28.757143
1311,Jardim Paulista,40,1,1,0,1600,130,1730,43.25
1312,Bela Vista,80,2,2,0,3000,536,3536,44.2
1313,Bela Vista,46,1,1,0,1200,319,1519,33.02174
1314,Butantã,17,1,1,0,1350,0,1350,79.411766
1315,Other,100,2,2,1,1900,850,2750,27.5
1316,Brooklin,75,2,2,1,2600,1061,3661,48.81333
1317,Moema,44,1,1,1,3500,962,4462,101.40909
1318,Brooklin,41,1,1,1,3200,580,3780,92.19512
1319,Brooklin,96,3,3,2,4500,1320,5820,60.625
1320,Other,64,3,2,0,1900,815,2715,42.421875
1321,Other,63,3,1,1,2300,731,3031,48.11111
1322,Pinheiros,75,2,1,1,3000,842,3842,51.226665
1323,Other,60,2,1,1,1600,200,1800,30.0
1324,Pinheiros,73,3,3,2,3400,1132,4532,62.08219
1325,Other,47,2,1,1,1350,350,1700,36.17021
1326,Cidade Monções,43,1,1,1,1990,607,2597,60.395348
1327,Butantã,60,4,2,0,2090,0,2090,34.833332
1328,Other,35,1,1,0,1000,0,1000,28.571428
1329,Moema,84,2,2,1,9000,1300,10300,122.61905
1330,Pinheiros,35,1,1,1,1700,446,2146,61.314285
1331,Other,72,2,2,1,920,480,1400,19.444445
1332,Vila Leopoldina,53,2,1,1,2400,540,2940,55.4717
1333,Vila Guarani,56,2,1,1,1690,565,2255,40.267857
1334,Bela Vista,34,1,1,1,2780,850,3630,106.76471
1335,Higienópolis,115,3,2,1,3590,1451,5041,43.83478
1336,Liberdade,92,1,1,0,1300,465,1765,19.184782
1337,Itaim Bibi,70,1,2,1,4500,1172,5672,81.02857
1338,Vila Mascote,85,2,3,2,4500,545,5045,59.35294
1339,Perdizes,80,2,1,1,2300,960,3260,40.75
1340,Santo Amaro,68,2,1,1,2600,0,2600,38.235294
1341,Other,39,1,1,2,2250,595,2845,72.948715
1342,Paraíso,33,1,1,1,1650,1150,2800,84.84849
1343,Pinheiros,80,3,2,1,3200,820,4020,50.25
1344,Other,45,1,1,2,1500,900,2400,53.333332
1345,República,28,1,1,0,2600,450,3050,108.92857
1346,Other,60,2,2,1,2000,880,2880,48.0
1347,Consolação,40,1,1,1,1400,635,2035,50.875
1348,Other,85,2,2,2,2000,1038,3038,35.741177
1349,Other,43,1,1,1,2200,568,2768,64.37209
1350,Vila Mariana,40,1,2,1,2200,490,2690,67.25
1351,Tatuapé,73,2,2,2,3000,650,3650,50.0
1352,Paraíso,165,3,3,1,3300,1340,4640,28.121212
1353,Vila Mariana,68,2,2,2,2500,800,3300,48.52941
1354,Vila Madalena,126,3,2,2,7950,922,8872,70.4127
1355,Other,52,2,1,1,1500,780,2280,43.846153
1356,Pinheiros,128,2,3,1,4000,600,4600,35.9375
1357,Pinheiros,40,1,1,1,3410,856,4266,106.65
1358,Other,33,1,1,0,1401,0,1401,42.454544
1359,Vila Leopoldina,55,2,2,1,2500,900,3400,61.81818
1360,Other,50,2,2,1,1000,800,1800,36.0
1361,Moema,95,2,2,2,3500,690,4190,44.105263
1362,Brooklin,67,2,2,2,4200,800,5000,74.62687
1363,Pinheiros,98,2,2,1,5000,980,5980,61.02041
1364,Other,64,2,2,1,1400,805,2205,34.453125
1365,Brás,20,1,1,0,1100,240,1340,67.0
1366,Cerqueira César,32,1,1,0,3300,500,3800,118.75
1367,Saúde,34,1,1,1,1700,560,2260,66.47059
1368,Jardim Paulista,84,2,3,1,4750,1490,6240,74.28571
1369,Other,38,2,1,0,1000,160,1160,30.526316
1370,Vila Olímpia,92,3,1,1,2300,620,2920,31.73913
1371,Vila Olímpia,73,2,3,2,5699,0,5699,78.0685
1372,Other,38,2,1,1,1600,100,1700,44.736843
1373,Other,55,1,1,0,1170,340,1510,27.454546
1374,Vila Andrade,66,2,2,1,2750,800,3550,53.78788
1375,Other,16,1,1,0,1100,0,1100,68.75
1376,Vila Mariana,150,3,4,3,5000,1412,6412,42.746666
1377,Pinheiros,90,3,3,1,3800,948,4748,52.755554
1378,Vila Olímpia,70,2,2,1,7270,950,8220,117.42857
1379,Other,70,3,2,1,2400,446,2846,40.657143
1380,Vila Mariana,51,2,1,1,3399,450,3849,75.47059
1381,Vila Buarque,35,1,1,0,1200,360,1560,44.57143
1382,Itaim Bibi,43,1,2,1,2560,960,3520,81.860466
1383,Vila Clementino,110,3,2,1,2800,1150,3950,35.909092
1384,Other,51,2,1,1,850,150,1000,19.607843
1385,Itaim Bibi,107,3,3,1,4700,1300,6000,56.074768
1386,Cerqueira César,40,1,1,1,2200,501,2701,67.525
1387,Other,30,1,1,0,1200,110,1310,43.666668
1388,Other,45,1,1,0,1800,450,2250,50.0
1389,Campo Belo,75,2,2,2,3400,1400,4800,64.0
1390,Moema,87,2,3,2,4300,1573,5873,67.505745
1391,Other,76,3,2,2,2900,950,3850,50.657894
1392,Brooklin,42,1,1,1,1700,612,2312,55.04762
1393,Bela Vista,100,3,2,0,2400,660,3060,30.6
1394,Higienópolis,110,2,1,1,3600,1063,4663,42.390907
1395,Vila Andrade,168,3,4,3,8000,1285,9285,55.267857
1396,Bela Vista,50,2,1,0,2200,705,2905,58.1
1397,Other,62,3,2,1,1700,484,2184,35.225807
1398,Móoca,102,3,3,2,5000,905,5905,57.89216
1399,Vila Leopoldina,61,2,2,1,2900,650,3550,58.19672
1400,Jardim Paulista,35,1,1,1,1750,680,2430,69.42857
1401,Brooklin,44,1,1,1,3450,490,3940,89.545456
1402,Vila Mascote,107,3,5,3,5000,800,5800,54.20561
1403,Jardim Paulista,100,1,2,2,6000,1350,7350,73.5
1404,Tatuapé,75,2,1,0,2000,467,2467,32.893333
1405,Consolação,145,2,1,1,6500,1390,7890,54.41379
1406,Vila Olímpia,63,2,2,1,5500,998,6498,103.14286
1407,Paraíso,89,3,1,1,3000,1218,4218,47.393257
1408,Other,68,2,2,1,2000,800,2800,41.17647
1409,Other,38,2,1,0,950,150,1100,28.947369
1410,Vila Prudente,85,2,2,1,1800,0,1800,21.17647
1411,Santo Amaro,72,3,3,2,3200,785,3985,55.34722
1412,Other,76,3,3,2,1850,816,2666,35.07895
1413,Vila Nova Conceição,60,2,2,1,2200,721,2921,48.683334
1414,Other,68,2,1,0,1080,580,1660,24.411764
1415,Aclimação,41,1,1,1,1700,590,2290,55.853657
1416,Vila Madalena,96,2,3,1,3500,1300,4800,50.0
1417,Brooklin,41,1,1,1,3500,675,4175,101.82927
1418,Santo Amaro,125,3,4,2,5800,1667,7467,59.736
1419,Other,62,2,1,1,2600,615,3215,51.85484
1420,Vila Madalena,90,2,2,2,2995,895,3890,43.22222
1421,Pinheiros,145,3,4,2,7500,1450,8950,61.724136
1422,Moema,42,1,1,1,2200,1200,3400,80.95238
1423,Cambuci,55,2,1,1,1500,600,2100,38.18182
1424,Other,50,1,1,1,1500,408,1908,38.16
1425,Other,43,2,1,1,1000,500,1500,34.88372
1426,Other,58,2,1,1,2650,450,3100,53.448277
1427,Brás,48,1,1,1,2500,0,2500,52.083332
1428,Other,60,2,1,1,1900,460,2360,39.333332
1429,Saúde,28,1,1,0,1600,120,1720,61.42857
1430,Chácara Santo Antônio,55,1,2,1,3300,1150,4450,80.90909
1431,Móoca,82,3,3,2,2500,1000,3500,42.682926
1432,Jardim Paulista,45,1,1,1,3000,0,3000,66.666664
1433,Vila Olímpia,25,1,1,1,2100,950,3050,122.0
1434,Moema,53,1,2,1,2650,618,3268,61.660378
1435,Vila Mascote,70,2,2,1,2200,800,3000,42.857143
1436,Moema,75,2,3,1,3900,1000,4900,65.333336
1437,Other,68,2,1,1,1600,600,2200,32.35294
1438,Vila Mariana,50,1,2,1,2300,730,3030,60.6
1439,Other,86,3,3,2,2800,914,3714,43.186047
1440,Other,67,2,1,1,1150,322,1472,21.97015
1441,Brooklin,120,3,3,2,4000,1680,5680,47.333332
1442,Other,98,3,1,2,4500,800,5300,54.081635
1443,Other,57,2,2,2,1800,1017,2817,49.42105
1444,Ipiranga,68,2,2,1,2300,708,3008,44.235294
1445,Chácara Santo Antônio,95,2,3,2,6100,725,6825,71.8421
1446,Vila Prudente,56,2,1,1,1491,400,1891,33.767857
1447,Jabaquara,49,2,2,1,1300,389,1689,34.469387
1448,Other,55,2,1,1,1900,800,2700,49.090908
1449,Other,52,2,1,1,1499,450,1949,37.48077
1450,Itaim Bibi,47,1,1,1,2500,720,3220,68.510635
1451,Morumbi,181,3,2,2,3800,664,4464,24.662983
1452,Campo Belo,48,1,1,1,1600,390,1990,41.458332
1453,Butantã,20,1,1,0,1590,0,1590,79.5
1454,Bela Vista,62,2,2,1,3500,649,4149,66.91936
1455,Moema,70,2,3,1,3380,880,4260,60.857143
1456,Other,77,2,2,1,1700,900,2600,33.766235
1457,Jardim Marajoara,92,3,3,2,3400,800,4200,45.652172
1458,Other,54,2,2,1,1350,404,1754,32.48148
1459,República,48,1,1,1,2990,406,3396,70.75
1460,Vila Prudente,53,2,1,1,1400,517,1917,36.16981
1461,Paraíso,160,3,3,2,3000,1350,4350,27.1875
1462,Brooklin,80,2,2,2,5650,800,6450,80.625
1463,Vila Prudente,62,2,2,1,1900,593,2493,40.20968
1464,Vila Leopoldina,53,2,1,1,2300,700,3000,56.603775
1465,Ipiranga,130,3,5,3,4000,1300,5300,40.76923
1466,Vila Mariana,93,3,2,1,3400,575,3975,42.741936
1467,Pinheiros,72,2,2,2,4750,1080,5830,80.97222
1468,Perdizes,60,2,2,1,2600,660,3260,54.333332
1469,Brooklin,38,1,1,1,2800,570,3370,88.68421
1470,Pompeia,60,2,2,1,2500,889,3389,56.483334
1471,Vila Nova Conceição,105,2,2,1,5000,1100,6100,58.095238
1472,Tatuapé,71,3,2,2,2700,617,3317,46.71831
1473,Vila Madalena,70,2,2,2,5300,1340,6640,94.85714
1474,Vila Olímpia,59,1,2,1,3000,903,3903,66.15254
1475,Moema,74,2,2,1,1500,638,2138,28.891891
1476,Tatuapé,64,3,1,1,1500,670,2170,33.90625
1477,Santa Cecília,42,1,1,1,2600,870,3470,82.61905
1478,Vila Mascote,55,2,1,1,1350,750,2100,38.18182
1479,Perdizes,70,1,1,0,2000,0,2000,28.571428
1480,Santo Amaro,115,3,3,2,4998,900,5898,51.286957
1481,Pinheiros,34,1,1,1,3300,483,3783,111.26471
1482,Saúde,116,3,3,2,3400,1514,4914,42.36207
1483,Other,55,2,1,1,1100,675,1775,32.272728
1484,Morumbi,65,3,1,1,1700,450,2150,33.076923
1485,Other,55,2,1,1,1250,350,1600,29.09091
1486,Pompeia,108,3,2,2,3800,920,4720,43.703705
1487,Other,36,1,1,1,1800,450,2250,62.5
1488,Vila Mariana,33,1,1,0,1500,100,1600,48.484848
1489,Santa Cecília,110,2,2,1,1900,1000,2900,26.363636
1490,Moema,110,3,4,2,4100,1356,5456,49.6
1491,Cerqueira César,65,2,1,0,2500,700,3200,49.23077
1492,Other,52,2,1,1,1100,605,1705,32.78846
1493,Other,80,2,2,1,1700,651,2351,29.3875
1494,Saúde,38,1,2,1,1800,497,2297,60.44737
1495,Higienópolis,104,2,3,1,3000,705,3705,35.625
1496,Moema,80,2,3,2,3300,1040,4340,54.25
1497,Bela Vista,60,2,1,1,2600,780,3380,56.333332
1498,Other,82,3,2,1,3150,515,3665,44.69512
1499,Centro,40,1,1,0,900,300,1200,30.0
1500,Bela Vista,50,1,1,0,1300,450,1750,35.0
1501,Saúde,68,3,1,1,1700,828,2528,37.17647
1502,Saúde,95,2,3,2,3000,672,3672,38.65263
1503,Vila Madalena,25,1,1,0,2100,700,2800,112.0
1504,Paraíso,47,2,1,0,2600,600,3200,68.085106
1505,Pinheiros,67,2,1,1,2800,670,3470,51.791046
1506,Jardim Paulista,45,1,1,1,1575,1200,2775,61.666668
1507,Liberdade,58,2,2,1,1800,555,2355,40.603447
1508,Vila Buarque,45,1,1,1,1500,606,2106,46.8
1509,Jardim Paulista,110,3,2,1,6203,1500,7703,70.027275
1510,Other,40,1,1,1,2500,460,2960,74.0
1511,Vila Leopoldina,35,1,1,0,2200,300,2500,71.42857
1512,Pinheiros,55,2,1,2,2600,869,3469,63.072727
1513,Pinheiros,30,1,1,1,1800,1447,3247,108.23333
1514,Other,31,1,1,1,1900,450,2350,75.80645
1515,Other,45,2,1,0,1390,380,1770,39.333332
1516,Perdizes,86,3,4,2,3500,1089,4589,53.360466
1517,Tatuapé,28,1,1,0,1200,50,1250,44.642857
1518,Aclimação,45,1,1,1,1500,589,2089,46.422222
1519,Brooklin,84,2,3,2,6500,910,7410,88.21429
1520,Jardim Marajoara,70,3,2,2,1945,595,2540,36.285713
1521,Other,35,1,1,0,1200,289,1489,42.54286
1522,Other,52,2,1,1,1300,420,1720,33.076923
1523,Other,64,2,1,0,1000,310,1310,20.46875
1524,República,153,2,2,0,2800,650,3450,22.549019
1525,Barra Funda,93,3,2,2,6000,1100,7100,76.344086
1526,Vila Olímpia,111,3,3,2,7500,1170,8670,78.10811
1527,Vila Andrade,96,2,2,2,3490,700,4190,43.645832
1528,Other,50,2,1,0,700,0,700,14.0
1529,Vila Buarque,105,2,1,1,2700,664,3364,32.038094
1530,Tatuapé,55,2,1,1,1800,730,2530,46.0
1531,Other,50,2,1,1,1480,496,1976,39.52
1532,Aclimação,34,1,1,1,2190,481,2671,78.55882
1533,Cambuci,29,1,1,0,1300,230,1530,52.75862
1534,Bela Vista,50,2,1,0,1400,683,2083,41.66
1535,Vila Nova Conceição,48,2,1,1,1900,560,2460,51.25
1536,Pinheiros,57,2,1,1,2000,556,2556,44.842106
1537,Brooklin,68,2,2,1,2664,1031,3695,54.338234
1538,Barra Funda,50,2,1,1,2000,527,2527,50.54
1539,Jabaquara,42,1,1,2,1200,347,1547,36.833332
1540,Vila Mariana,67,2,2,1,2200,1050,3250,48.50746
1541,Saúde,61,2,2,2,2100,730,2830,46.393444
1542,Pinheiros,80,2,1,0,2900,240,3140,39.25
1543,Moema,60,1,2,1,4300,843,5143,85.71667
1544,Pinheiros,32,1,1,1,2000,750,2750,85.9375
1545,Barra Funda,65,2,2,2,2950,785,3735,57.46154
1546,Indianópolis,90,3,3,1,3000,1301,4301,47.788887
1547,Vila Olímpia,60,2,1,1,2700,831,3531,58.85
1548,Jardim Paulista,96,2,3,1,3000,1300,4300,44.791668
1549,Vila Mariana,42,1,1,1,2500,410,2910,69.28571
1550,Other,56,2,2,1,2600,780,3380,60.357143
1551,Brooklin,49,1,1,1,2600,558,3158,64.44898
1552,Vila Mariana,80,2,2,1,2300,760,3060,38.25
1553,Brooklin,50,1,1,1,4000,550,4550,91.0
1554,Other,65,1,2,2,3500,957,4457,68.56923
1555,Brooklin,38,1,1,1,3000,0,3000,78.947365
1556,Chácara Santo Antônio,53,2,2,1,3500,650,4150,78.30189
1557,Vila Olímpia,81,2,2,1,3300,800,4100,50.617283
1558,Other,70,2,1,2,2500,800,3300,47.142857
1559,Bela Vista,32,1,1,1,1600,395,1995,62.34375
1560,Móoca,50,2,1,1,2150,0,2150,43.0
1561,Barra Funda,86,2,2,1,3600,550,4150,48.255814
1562,Jardim Paulista,98,2,3,1,4500,1100,5600,57.142857
1563,Morumbi,72,2,1,2,1600,781,2381,33.069443
1564,Brooklin,55,2,2,1,2800,548,3348,60.872726
1565,Vila Olímpia,55,2,2,1,2500,1149,3649,66.34545
1566,Moema,73,2,3,2,4650,1240,5890,80.68493
1567,Itaim Bibi,120,3,2,1,4600,0,4600,38.333332
1568,Liberdade,68,2,1,1,2400,640,3040,44.705883
1569,Pinheiros,51,2,1,1,2970,800,3770,73.92157
1570,Aclimação,37,1,1,1,2160,530,2690,72.702705
1571,Other,65,2,1,1,1530,566,2096,32.246155
1572,Bela Vista,86,2,2,1,4300,846,5146,59.837208
1573,Tatuapé,36,1,1,1,1400,336,1736,48.22222
1574,Bela Vista,42,1,1,1,3550,513,4063,96.7381
1575,Other,60,2,2,1,1690,506,2196,36.6
1576,Other,32,2,1,1,1400,200,1600,50.0
1577,República,49,1,1,1,2850,550,3400,69.38776
1578,Chácara Santo Antônio,138,4,4,2,6800,1000,7800,56.52174
1579,Pompeia,84,2,2,1,2200,636,2836,33.761906
1580,Lapa,64,2,1,1,1450,368,1818,28.40625
1581,Jardim Marajoara,78,2,2,2,2035,910,2945,37.75641
1582,Pinheiros,49,2,1,1,2900,657,3557,72.591835
1583,Centro,55,2,1,0,1800,550,2350,42.727272
1584,Consolação,42,1,1,0,1270,404,1674,39.857143
1585,Itaim Bibi,41,1,1,1,3300,400,3700,90.243904
1586,Pinheiros,66,2,2,1,4858,1351,6209,94.07576
1587,Itaim Bibi,37,1,1,1,2500,920,3420,92.432434
1588,Other,37,2,1,0,1200,0,1200,32.432434
1589,Pinheiros,45,1,1,1,1800,926,2726,60.577778
1590,Vila Prudente,30,1,1,0,1099,100,1199,39.966667
1591,Ipiranga,53,1,1,1,1100,569,1669,31.490566
1592,Pinheiros,110,3,3,1,3800,1125,4925,44.772728
1593,Vila Mariana,110,3,5,2,5600,1320,6920,62.909092
1594,Saúde,60,2,1,1,2050,652,2702,45.033333
1595,Consolação,35,1,1,1,2299,365,2664,76.11429
1596,Tatuapé,63,2,2,1,2000,452,2452,38.920635
1597,Vila Mariana,31,1,1,1,2420,528,2948,95.09677
1598,Vila Leopoldina,117,4,2,2,6000,1300,7300,62.39316
1599,Moema,70,2,3,2,4500,830,5330,76.14286
1600,Pinheiros,49,1,2,1,2500,772,3272,66.77551
1601,Butantã,68,3,2,1,1300,850,2150,31.617647
1602,Other,81,3,2,3,2600,1000,3600,44.444443
1603,Other,28,1,1,0,1100,100,1200,42.857143
1604,Other,52,2,1,1,1200,317,1517,29.173077
1605,Brooklin,40,1,1,1,2300,500,2800,70.0
1606,Other,50,2,1,0,1300,0,1300,26.0
1607,Other,100,3,3,2,3900,1100,5000,50.0
1608,Campo Belo,73,2,2,2,4000,980,4980,68.21918
1609,Consolação,35,1,1,1,2200,650,2850,81.42857
1610,Pinheiros,62,2,2,1,4500,950,5450,87.90323
1611,Other,68,3,2,1,1600,500,2100,30.882353
1612,Other,103,3,3,2,4800,1076,5876,57.048542
1613,Other,35,1,1,1,1850,695,2545,72.71429
1614,Other,101,2,3,2,4990,868,5858,58.0
1615,Vila Clementino,75,2,2,1,2700,990,3690,49.2
1616,Other,82,3,2,2,2450,850,3300,40.243904
1617,Vila Clementino,90,3,2,1,2900,1355,4255,47.27778
1618,Moema,70,2,2,1,2400,700,3100,44.285713
1619,Vila Olímpia,100,2,4,2,5500,1340,6840,68.4
1620,Vila Nova Conceição,93,2,2,1,2300,980,3280,35.268818
1621,Other,44,2,1,1,1600,225,1825,41.477272
1622,Jardim Marajoara,50,2,1,1,1670,550,2220,44.4
1623,Tatuapé,55,2,1,1,1200,659,1859,33.8
1624,Itaim Bibi,71,2,2,2,4950,1053,6003,84.54929
1625,Mirandópolis,55,1,1,0,1900,0,1900,34.545456
1626,Bela Vista,47,1,1,1,2300,567,2867,61.0
1627,Santa Cecília,67,2,2,1,2700,730,3430,51.19403
1628,Other,70,2,2,1,2000,760,2760,39.42857
1629,Brás,60,2,1,0,1400,400,1800,30.0
1630,Saúde,60,2,2,2,2300,871,3171,52.85
1631,Other,130,4,3,1,4500,1500,6000,46.153847
1632,Other,20,1,1,0,1220,40,1260,63.0
1633,Pinheiros,86,3,2,1,3000,1264,4264,49.581394
1634,Other,48,2,1,1,1650,350,2000,41.666668
1635,Vila Olímpia,43,1,1,2,2000,800,2800,65.11628
1636,Pinheiros,110,3,3,1,3400,1610,5010,45.545456
1637,Vila Buarque,37,1,1,1,2145,305,2450,66.21622
1638,Santo Amaro,65,2,1,1,2790,490,3280,50.46154
1639,Other,65,2,1,1,1850,0,1850,28.461538
1640,Aclimação,74,2,2,1,2350,750,3100,41.89189
1641,Jardins,98,3,3,1,3500,995,4495,45.867348
1642,Other,68,2,2,2,2800,1120,3920,57.64706
1643,Ipiranga,83,2,2,1,2500,863,3363,40.518074
1644,Other,68,3,2,2,1600,840,2440,35.882355
1645,Campo Belo,51,1,1,1,3500,0,3500,68.62745
1646,Other,84,3,2,2,2900,800,3700,44.04762
1647,Butantã,44,2,1,1,3500,500,4000,90.90909
1648,Other,75,3,2,1,2000,925,2925,39.0
1649,Moema,70,2,2,1,2500,700,3200,45.714287
1650,Other,128,3,4,2,7300,1200,8500,66.40625
1651,Other,57,2,2,1,1841,659,2500,43.85965
1652,Barra Funda,90,3,2,1,2600,750,3350,37.22222
1653,Other,127,3,5,3,2540,1400,3940,31.023623
1654,Perdizes,56,1,2,2,2300,917,3217,57.44643
1655,Other,47,2,1,0,1000,25,1025,21.80851
1656,Bela Vista,67,2,2,1,2500,727,3227,48.16418
1657,Cambuci,50,1,1,1,1100,316,1416,28.32
1658,Chácara Santo Antônio,100,2,2,2,3800,952,4752,47.52
1659,Bela Vista,51,2,2,1,2950,800,3750,73.52941
1660,Saúde,58,2,2,1,1650,780,2430,41.896553
1661,Bela Vista,103,3,2,1,3500,1085,4585,44.514565
1662,Saúde,28,1,1,1,1300,330,1630,58.214287
1663,Vila Olímpia,76,2,1,1,2900,0,2900,38.157894
1664,Moema,110,3,4,2,6300,1200,7500,68.181816
1665,Aclimação,142,3,5,3,7000,1650,8650,60.915493
1666,Jardins,35,1,1,1,1800,1200,3000,85.71429
1667,Vila Clementino,60,2,2,1,1600,1193,2793,46.55
1668,Bela Vista,28,1,1,1,1300,1000,2300,82.14286
1669,Santa Cecília,40,1,1,1,1850,545,2395,59.875
1670,Liberdade,44,1,1,1,1850,660,2510,57.045456
1671,Vila Mariana,43,1,1,1,1680,551,2231,51.88372
1672,Barra Funda,70,3,2,1,2600,542,3142,44.885715
1673,Other,90,2,1,0,2300,450,2750,30.555555
1674,Other,72,2,1,2,1300,100,1400,19.444445
1675,Other,72,3,2,1,2000,670,2670,37.083332
1676,Moema,65,2,2,2,3400,850,4250,65.38461
1677,Santana,80,2,2,1,1700,405,2105,26.3125
1678,Pompeia,60,2,2,1,2200,896,3096,51.6
1679,Other,60,2,1,1,2000,433,2433,40.55
1680,Jardins,65,2,2,2,5800,1100,6900,106.15385
1681,Other,83,2,2,2,2500,550,3050,36.746986
1682,Moema,107,3,3,1,4500,1030,5530,51.682243
1683,Vila Mariana,40,1,1,1,1900,447,2347,58.675
1684,Other,38,2,1,1,1650,332,1982,52.157894
1685,Morumbi,70,3,2,1,1751,823,2574,36.771427
1686,Tatuapé,90,3,2,2,3800,839,4639,51.544445
1687,Vila Leopoldina,60,2,2,1,2700,540,3240,54.0
1688,Saúde,100,3,3,2,3000,1129,4129,41.29
1689,Santana,25,1,1,0,1000,0,1000,40.0
1690,Vila Clementino,56,2,2,2,3800,1099,4899,87.48214
1691,Campo Belo,75,2,3,1,3790,964,4754,63.386665
1692,Consolação,80,2,2,1,2490,879,3369,42.1125
1693,Móoca,80,3,2,1,2000,550,2550,31.875
1694,Vila Mascote,58,2,1,1,1800,700,2500,43.103447
1695,Perdizes,65,2,2,1,2000,695,2695,41.46154
1696,Itaim Bibi,87,2,2,1,4000,730,4730,54.367817
1697,Pinheiros,44,1,1,1,2900,780,3680,83.63636
1698,Itaim Bibi,115,3,3,1,4300,1116,5416,47.095654
1699,Vila Mariana,53,2,1,1,3599,451,4050,76.41509
1700,Jardins,41,1,1,1,2100,900,3000,73.17073
1701,Other,50,2,1,1,1200,600,1800,36.0
1702,Other,58,2,1,1,1287,206,1493,25.741379
1703,Other,69,3,2,1,2200,490,2690,38.985508
1704,Other,63,2,2,1,2900,630,3530,56.031746
1705,Brás,50,2,1,1,1380,450,1830,36.6
1706,Other,71,3,2,2,2400,945,3345,47.112675
1707,Higienópolis,41,1,1,1,2600,788,3388,82.63415
1708,Centro,30,1,1,0,2000,0,2000,66.666664
1709,Moema,90,3,2,1,3900,895,4795,53.27778
1710,Perdizes,62,2,2,2,3000,720,3720,60.0
1711,Cerqueira César,60,2,1,1,3200,0,3200,53.333332
1712,Vila Clementino,53,1,1,1,1900,630,2530,47.735847
1713,Other,128,4,5,2,5100,1280,6380,49.84375
1714,Vila Nova Conceição,80,3,3,2,3500,1467,4967,62.0875
1715,Vila Olímpia,52,2,1,1,2800,850,3650,70.19231
1716,Moema,40,1,1,1,3100,850,3950,98.75
1717,Other,50,2,1,1,1600,500,2100,42.0
1718,Jardim Paulista,50,2,1,1,2600,837,3437,68.74
1719,Other,45,2,1,0,850,302,1152,25.6
1720,Brooklin,44,1,1,1,3585,585,4170,94.77273
1721,Jardim Paulista,48,1,1,1,3500,0,3500,72.916664
1722,Brooklin,80,2,2,2,5650,800,6450,80.625
1723,Pinheiros,40,1,1,0,2100,202,2302,57.55
1724,Bela Vista,57,2,2,1,3500,552,4052,71.08772
1725,Pinheiros,72,2,2,1,2700,960,3660,50.833332
1726,Itaim Bibi,38,1,1,1,4114,821,4935,129.86842
1727,Other,70,2,1,1,1350,550,1900,27.142857
1728,Pinheiros,95,3,3,2,3500,1214,4714,49.62105
1729,Jardim Paulista,200,4,5,2,6900,1489,8389,41.945
1730,Bela Vista,150,3,3,1,5000,1200,6200,41.333332
1731,Bela Vista,50,1,1,1,3500,850,4350,87.0
1732,Pinheiros,100,2,3,0,2800,510,3310,33.1
1733,Bela Vista,34,1,1,1,1300,1100,2400,70.588234
1734,Other,62,3,2,1,1700,480,2180,35.16129
1735,Other,30,1,1,0,550,334,884,29.466667
1736,Other,80,2,2,1,2000,1071,3071,38.3875
1737,Vila Buarque,32,1,1,0,2100,338,2438,76.1875
1738,Centro,70,1,1,0,1000,571,1571,22.442858
1739,Moema,67,1,2,2,5000,830,5830,87.01492
1740,Consolação,40,1,1,1,2000,620,2620,65.5
1741,Liberdade,61,2,1,1,1100,900,2000,32.786884
1742,Ipiranga,153,3,4,3,5500,1250,6750,44.117645
1743,Vila Clementino,66,2,2,1,3500,973,4473,67.77273
1744,Other,74,2,2,1,3900,469,4369,59.04054
1745,Aclimação,170,3,5,3,8500,1545,10045,59.088234
1746,Vila Mariana,34,1,1,1,2513,1500,4013,118.02941
1747,Pompeia,96,2,2,2,4000,1331,5331,55.53125
1748,Jaguaré,70,3,2,2,2400,600,3000,42.857143
1749,Other,65,2,1,1,1950,733,2683,41.276924
1750,Other,52,2,1,1,900,600,1500,28.846153
1751,Jardim Paulista,86,2,1,0,1800,886,2686,31.232557
1752,Other,66,2,1,1,2100,936,3036,46.0
1753,Brooklin,127,3,5,4,7500,1250,8750,68.89764
1754,Moema,140,4,4,2,5500,1672,7172,51.228573
1755,Vila Madalena,70,2,2,1,4200,900,5100,72.85714
1756,Brooklin,111,2,4,2,7000,1200,8200,73.87387
1757,Brooklin,94,3,2,2,3500,1020,4520,48.085106
1758,Other,40,2,1,0,1350,80,1430,35.75
1759,Santa Cecília,160,3,3,3,7200,1650,8850,55.3125
1760,Vila Olímpia,25,1,1,1,2600,520,3120,124.8
1761,Higienópolis,40,1,1,1,2500,750,3250,81.25
1762,Vila Andrade,79,2,3,2,3650,700,4350,55.06329
1763,Santana,70,3,2,1,1700,700,2400,34.285713
1764,Other,42,2,1,0,1450,0,1450,34.52381
1765,Chácara Santo Antônio,95,3,4,2,6200,680,6880,72.42105
1766,Morumbi,34,1,1,1,1300,500,1800,52.941177
1767,Tatuapé,52,2,1,1,2400,0,2400,46.153847
1768,Pinheiros,80,2,2,2,4500,885,5385,67.3125
1769,Consolação,75,2,1,0,1850,740,2590,34.533333
1770,Other,66,2,2,1,2257,650,2907,44.045456
1771,Consolação,70,2,2,1,6500,800,7300,104.28571
1772,Vila Madalena,68,2,2,1,4500,600,5100,75.0
1773,Chácara Santo Antônio,38,1,1,1,2100,380,2480,65.26316
1774,Vila Olímpia,95,2,3,2,8000,1088,9088,95.663155
1775,Other,58,2,2,1,2000,437,2437,42.017242
1776,Bela Vista,35,1,1,1,1700,400,2100,60.0
1777,Vila Mariana,86,2,2,1,2000,956,2956,34.372093
1778,Other,67,3,1,1,1500,364,1864,27.820896
1779,Other,60,1,1,0,1200,697,1897,31.616667
1780,Moema,42,1,1,1,1720,580,2300,54.761906
1781,Vila Mascote,64,2,2,2,2800,645,3445,53.828125
1782,Other,49,2,1,1,1500,430,1930,39.387756
1783,Barra Funda,65,2,2,1,2100,680,2780,42.76923
1784,Other,69,3,2,1,1450,450,1900,27.536232
1785,Móoca,74,2,1,0,1400,760,2160,29.18919
1786,Bela Vista,70,2,1,0,2600,400,3000,42.857143
1787,Other,80,3,3,2,5200,890,6090,76.125
1788,Campo Belo,110,2,4,3,4500,1700,6200,56.363636
1789,Vila Clementino,58,2,1,1,3800,740,4540,78.27586
1790,Vila Olímpia,70,2,2,1,2200,950,3150,45.0
1791,Vila Olímpia,46,1,1,1,3500,800,4300,93.478264
1792,Pinheiros,50,1,2,1,2300,1043,3343,66.86
1793,Moema,45,1,2,1,2600,540,3140,69.77778
1794,Lapa,63,3,2,1,2000,465,2465,39.126984
1795,Indianópolis,199,3,4,3,6550,1700,8250,41.457287
1796,Other,51,2,1,1,1600,0,1600,31.37255
1797,Vila Clementino,60,2,2,1,2000,498,2498,41.633335
1798,Other,72,2,2,2,4000,750,4750,65.97222
1799,Other,97,3,2,2,2300,1018,3318,34.206184
1800,Vila Mariana,62,2,1,1,2500,817,3317,53.5
1801,Consolação,35,1,1,1,1600,509,2109,60.25714
1802,Santa Cecília,40,2,2,1,2000,502,2502,62.55
1803,Brooklin,45,1,1,1,2000,870,2870,63.77778
1804,Pinheiros,52,1,1,0,1750,685,2435,46.826923
1805,Itaim Bibi,90,2,1,1,3400,1138,4538,50.422222
1806,Vila Andrade,48,2,1,1,2200,430,2630,54.791668
1807,Other,50,2,1,1,1400,150,1550,31.0
1808,Other,35,1,1,0,1200,0,1200,34.285713
1809,Aclimação,39,1,1,1,2260,530,2790,71.53846
1810,Other,70,2,2,1,2500,723,3223,46.04286
1811,Other,75,2,2,1,3200,650,3850,51.333332
1812,Mirandópolis,67,2,2,0,1700,1050,2750,41.044777
1813,Vila Andrade,58,2,1,1,2495,735,3230,55.689655
1814,Jardim Paulista,89,1,2,2,7000,600,7600,85.39326
1815,Other,125,3,4,3,4500,1300,5800,46.4
1816,Other,168,3,3,3,2600,1539,4139,24.636906
1817,Vila Madalena,96,3,2,1,2700,1194,3894,40.5625
1818,Bela Vista,40,1,1,1,2400,440,2840,71.0
1819,Vila Mascote,92,3,3,2,4900,1020,5920,64.347824
1820,Cidade Monções,64,2,2,1,1680,650,2330,36.40625
1821,Brooklin,38,1,1,1,3400,560,3960,104.210526
1822,Other,45,1,1,0,999,100,1099,24.422222
1823,Barra Funda,34,1,1,1,1900,400,2300,67.64706
1824,Aclimação,85,3,3,0,3000,830,3830,45.058823
1825,Bela Vista,65,2,1,0,1800,100,1900,29.23077
1826,Móoca,44,1,1,0,1150,280,1430,32.5
1827,Pinheiros,90,2,2,1,3300,1000,4300,47.77778
1828,Pinheiros,90,3,3,2,5200,1300,6500,72.22222
1829,Vila Olímpia,80,2,2,2,2600,1009,3609,45.1125
1830,Higienópolis,32,1,1,1,1200,780,1980,61.875
1831,Vila Andrade,38,1,1,1,2400,0,2400,63.157894
1832,Other,66,3,1,1,1300,502,1802,27.30303
1833,Vila Prudente,69,3,2,1,2500,460,2960,42.898552
1834,Brooklin,80,2,2,1,4450,1590,6040,75.5
1835,Campo Belo,40,1,1,1,2100,600,2700,67.5
1836,Butantã,65,2,2,1,1900,700,2600,40.0
1837,Other,80,3,3,1,3000,475,3475,43.4375
1838,Móoca,61,3,1,1,2100,400,2500,40.98361
1839,Moema,92,2,2,2,4700,1042,5742,62.413044
1840,Other,100,2,2,1,2600,1150,3750,37.5
1841,Vila Prudente,30,1,1,0,1400,410,1810,60.333332
1842,Higienópolis,45,1,1,1,1900,720,2620,58.22222
1843,Saúde,51,2,1,1,1200,907,2107,41.313725
1844,Other,30,1,1,1,2200,320,2520,84.0
1845,Pinheiros,35,1,1,1,3400,460,3860,110.28571
1846,Saúde,167,4,4,2,4500,1600,6100,36.526947
1847,Other,65,2,2,1,1000,800,1800,27.692308
1848,Other,138,3,2,3,5400,900,6300,45.652172
1849,Cambuci,45,2,1,0,1750,275,2025,45.0
1850,Moema,44,1,1,1,2200,582,2782,63.227272
1851,Jardim Paulista,60,1,1,1,2500,694,3194,53.233334
1852,Bela Vista,45,1,1,1,1700,602,2302,51.155556
1853,Bela Vista,40,1,1,1,1500,675,2175,54.375
1854,Other,84,3,2,1,2500,800,3300,39.285713
1855,Other,60,2,2,1,2600,432,3032,50.533333
1856,Santa Cecília,80,2,2,0,2300,1288,3588,44.85
1857,Other,45,2,1,0,1200,50,1250,27.777779
1858,Bela Vista,25,1,1,0,1100,257,1357,54.28
1859,Aclimação,75,3,2,2,3700,980,4680,62.4
1860,Cambuci,39,1,1,1,2260,530,2790,71.53846
1861,Aclimação,40,1,1,1,1800,758,2558,63.95
1862,Pinheiros,57,1,1,1,4800,781,5581,97.91228
1863,Chácara Santo Antônio,64,2,2,1,2500,1100,3600,56.25
1864,Higienópolis,32,1,1,0,3300,500,3800,118.75
1865,Other,30,1,1,1,2250,320,2570,85.666664
1866,Vila Leopoldina,87,3,2,2,3500,458,3958,45.49425
1867,Moema,35,1,1,1,1700,642,2342,66.91428
1868,Moema,42,1,1,1,2000,800,2800,66.666664
1869,Santa Cecília,70,2,1,1,2300,616,2916,41.657143
1870,Bela Vista,70,2,2,1,2300,772,3072,43.885715
1871,Vila Nova Conceição,50,1,2,2,3639,1400,5039,100.78
1872,Campo Belo,50,1,1,1,1500,650,2150,43.0
1873,Brooklin,126,3,5,2,5550,1044,6594,52.333332
1874,Tatuapé,30,1,1,0,1100,100,1200,40.0
1875,Bela Vista,55,1,1,1,3500,586,4086,74.29091
1876,Bela Vista,36,1,1,0,2000,800,2800,77.77778
1877,Vila Mariana,45,1,1,1,2808,621,3429,76.2
1878,Other,97,3,4,1,2800,750,3550,36.59794
1879,Brooklin,80,2,2,2,5650,800,6450,80.625
1880,Saúde,58,2,2,1,1600,970,2570,44.310345
1881,Pinheiros,60,2,2,1,1800,1145,2945,49.083332
1882,Other,69,3,1,1,2000,688,2688,38.95652
1883,Moema,50,2,1,1,2500,0,2500,50.0
1884,Cerqueira César,55,2,2,1,2100,630,2730,49.636364
1885,Vila Olímpia,40,1,1,1,2300,600,2900,72.5
1886,Jardim Paulista,58,2,1,0,2000,116,2116,36.482758
1887,Other,96,3,1,1,1600,740,2340,24.375
1888,Consolação,38,1,1,1,2500,537,3037,79.92105
1889,Other,47,2,1,1,1200,0,1200,25.531916
1890,Vila Olímpia,66,2,3,1,2200,1190,3390,51.363636
1891,Other,55,2,2,1,2000,430,2430,44.18182
1892,Itaim Bibi,90,2,3,1,3900,1530,5430,60.333332
1893,Vila Andrade,100,3,2,2,2990,948,3938,39.38
1894,Vila Andrade,50,2,1,1,1950,330,2280,45.6
1895,Other,40,1,1,0,1300,250,1550,38.75
1896,Other,49,2,1,1,1200,647,1847,37.69388
1897,Vila Madalena,82,2,2,1,3100,1231,4331,52.817074
1898,Pinheiros,30,1,1,1,2400,940,3340,111.333336
1899,Bela Vista,39,1,1,1,2400,480,2880,73.84615
1900,Brooklin,84,2,3,2,6800,1176,7976,94.95238
1901,Vila Mascote,108,3,2,2,4500,1000,5500,50.925926
1902,Aclimação,46,2,1,1,1799,461,2260,49.130436
1903,Morumbi,87,2,2,2,3300,666,3966,45.58621
1904,Perdizes,153,4,5,3,6500,1700,8200,53.594772
1905,Moema,80,3,2,1,3600,810,4410,55.125
1906,Other,45,1,1,1,2200,450,2650,58.88889
1907,Other,44,1,1,1,1200,740,1940,44.090908
1908,Vila Mascote,147,3,5,2,5000,1150,6150,41.836735
1909,Brooklin,124,2,3,2,7000,1200,8200,66.129036
1910,Other,100,3,2,1,2100,860,2960,29.6
1911,Brooklin,37,1,1,1,2000,800,2800,75.675674
1912,Bela Vista,77,2,1,2,4900,600,5500,71.42857
1913,Vila Clementino,27,1,1,0,2100,740,2840,105.18519
1914,Santa Cecília,70,2,1,0,2000,564,2564,36.62857
1915,Perdizes,40,1,1,1,2500,800,3300,82.5
1916,Tatuapé,74,2,2,1,4500,450,4950,66.89189
1917,Lapa,48,2,1,1,2150,353,2503,52.145832
1918,Other,58,2,1,2,900,580,1480,25.51724
1919,Other,74,3,1,1,2500,500,3000,40.54054
1920,Moema,70,1,1,1,3000,836,3836,54.8
1921,Vila Olímpia,40,1,1,1,2500,413,2913,72.825
1922,Moema,64,2,2,1,2400,1410,3810,59.53125
1923,Santo Amaro,65,1,1,1,2700,615,3315,51.0
1924,Pinheiros,92,3,3,2,2990,1050,4040,43.913044
1925,Chácara Santo Antônio,70,2,2,1,2200,800,3000,42.857143
1926,Other,75,2,2,1,1100,600,1700,22.666666
1927,Other,129,2,3,2,3500,1170,4670,36.20155
1928,Other,31,1,1,1,2420,528,2948,95.09677
1929,Jardim Paulista,85,1,1,1,3000,1418,4418,51.97647
1930,Moema,48,1,1,1,2000,765,2765,57.604168
1931,Pinheiros,24,1,1,1,1800,500,2300,95.833336
1932,Brás,72,3,2,1,2300,707,3007,41.76389
1933,Vila Guarani,102,2,1,1,2000,510,2510,24.607843
1934,Vila Leopoldina,62,2,1,1,2000,800,2800,45.16129
1935,Brooklin,45,1,1,1,2490,750,3240,72.0
1936,Bela Vista,33,1,1,1,2000,395,2395,72.57576
1937,Tatuapé,65,2,1,2,2100,578,2678,41.2
1938,Other,97,3,4,2,3449,830,4279,44.113403
1939,Pinheiros,83,1,1,2,5500,950,6450,77.710846
1940,Pinheiros,65,2,2,1,4200,832,5032,77.41538
1941,Brooklin,82,1,2,2,6800,600,7400,90.243904
1942,Centro,160,3,2,0,2300,948,3248,20.3
1943,Vila Olímpia,100,3,2,1,1800,1420,3220,32.2
1944,Higienópolis,90,3,3,2,4100,1338,5438,60.422222
1945,Vila Olímpia,30,1,1,1,2700,700,3400,113.333336
1946,Other,80,2,1,0,1600,830,2430,30.375
1947,Paraíso,56,2,1,1,2900,1129,4029,71.94643
1948,Pinheiros,100,2,1,1,2100,950,3050,30.5
1949,Santana,76,2,2,1,2000,960,2960,38.94737
1950,Itaim Bibi,87,3,2,0,3000,656,3656,42.022987
1951,Perdizes,43,1,1,1,1500,665,2165,50.34884
1952,Other,70,2,2,1,1800,620,2420,34.57143
1953,Cidade Monções,75,2,2,1,5600,1100,6700,89.333336
1954,Other,57,2,2,1,2400,580,2980,52.2807
1955,Pinheiros,60,2,2,1,4500,805,5305,88.416664
1956,Vila Mascote,60,2,2,1,2100,608,2708,45.133335
1957,Vila Mariana,62,2,2,1,2300,629,2929,47.241936
1958,Saúde,28,1,1,0,1600,120,1720,61.42857
1959,Barra Funda,65,2,2,1,3000,580,3580,55.076923
1960,Moema,76,2,2,1,2800,810,3610,47.5
1961,Other,106,4,2,2,2600,1250,3850,36.320755
1962,Vila Nova Conceição,45,1,1,1,2559,1493,4052,90.04444
1963,Bela Vista,60,2,2,1,2900,540,3440,57.333332
1964,Perdizes,93,2,3,2,5000,750,5750,61.827957
1965,Vila Mariana,58,2,2,1,1700,867,2567,44.25862
1966,Vila Leopoldina,114,3,3,2,4500,1200,5700,50.0
1967,Pinheiros,90,2,1,0,3500,120,3620,40.22222
1968,Vila Clementino,82,2,3,1,1800,1300,3100,37.80488
1969,Other,34,2,1,0,1050,180,1230,36.17647
1970,Bela Vista,36,1,1,1,2100,450,2550,70.833336
1971,Brooklin,147,3,5,3,7000,1573,8573,58.31973
1972,Jardins,48,1,1,1,4500,1200,5700,118.75
1973,Jardim Marajoara,92,3,1,2,3500,772,4272,46.434784
1974,Other,40,1,1,1,2000,354,2354,58.85
1975,Ipiranga,87,1,2,1,2200,1100,3300,37.931034
1976,Perdizes,124,2,4,3,6500,1300,7800,62.903225
1977,Jardins,30,1,1,1,1700,700,2400,80.0
1978,Other,95,2,3,2,4100,880,4980,52.42105
1979,Vila Prudente,64,2,2,1,1850,480,2330,36.40625
1980,Campo Belo,53,1,1,1,4700,450,5150,97.169815
1981,Vila Mariana,179,3,2,0,2500,479,2979,16.642458
1982,Other,50,2,1,0,1200,0,1200,24.0
1983,Butantã,65,3,1,1,1700,547,2247,34.56923
1984,Other,60,2,2,1,1690,557,2247,37.45
1985,Liberdade,18,1,1,0,950,260,1210,67.22222
1986,Perdizes,80,2,2,1,2500,980,3480,43.5
1987,Cambuci,72,2,2,0,2750,800,3550,49.305557
1988,Vila Olímpia,40,1,1,1,3800,400,4200,105.0
1989,Brooklin,108,3,1,1,3250,1491,4741,43.898148
1990,Moema,70,2,1,1,2700,1100,3800,54.285713
1991,Other,54,1,1,1,1100,117,1217,22.537037
1992,Itaim Bibi,72,3,2,2,4400,1256,5656,78.55556
1993,Vila Olímpia,80,2,2,1,4500,1100,5600,70.0
1994,Other,95,3,3,1,1800,1590,3390,35.68421
1995,Vila Olímpia,104,3,2,1,3200,960,4160,40.0
1996,Tatuapé,29,1,1,1,1600,385,1985,68.44827
1997,Other,70,2,2,2,1600,765,2365,33.785713
1998,Other,55,2,2,1,1850,867,2717,49.4
1999,Other,22,1,1,0,2100,362,2462,111.90909
2000,Vila Mariana,64,2,2,1,2800,712,3512,54.875
2001,Other,72,3,2,2,2300,505,2805,38.958332
2002,Saúde,47,1,1,1,1500,375,1875,39.893616
2003,Jardim Paulista,50,1,1,0,2200,0,2200,44.0
2004,Jaguaré,56,2,1,1,2000,516,2516,44.92857
2005,Other,103,3,4,2,3400,870,4270,41.45631
2006,Pinheiros,67,2,2,2,3000,1050,4050,60.44776
2007,Moema,68,1,2,2,5000,958,5958,87.617645
2008,Pinheiros,43,1,1,1,3000,818,3818,88.790695
2009,Moema,120,3,2,2,4500,1638,6138,51.15
2010,Brooklin,66,2,2,1,2500,835,3335,50.530304
2011,Tatuapé,65,2,2,1,1800,897,2697,41.49231
2012,Other,54,2,1,1,2300,550,2850,52.77778
2013,Other,78,3,2,2,3200,692,3892,49.897434
2014,Vila Clementino,65,2,2,1,2600,980,3580,55.076923
2015,Barra Funda,82,2,2,1,4000,685,4685,57.134148
2016,Vila Nova Conceição,42,1,1,1,2300,1300,3600,85.71429
2017,Other,60,2,2,1,3300,620,3920,65.333336
2018,Santana,60,2,1,2,1500,675,2175,36.25
2019,Other,130,3,5,2,4500,1500,6000,46.153847
2020,Santa Cecília,58,1,1,0,1200,442,1642,28.310345
2021,Other,60,2,1,1,2000,700,2700,45.0
2022,Pinheiros,73,2,2,1,4000,740,4740,64.9315
2023,Pinheiros,153,3,3,1,3500,1400,4900,32.026142
2024,Móoca,105,3,4,2,4200,880,5080,48.38095
2025,Vila Clementino,65,2,1,1,2000,650,2650,40.76923
2026,Paraíso,110,2,1,1,2600,1278,3878,35.254547
2027,Centro,48,1,1,0,1090,327,1417,29.520834
2028,Campo Belo,49,1,1,1,2600,575,3175,64.79592
2029,Vila Andrade,91,3,3,3,2300,1425,3725,40.934067
2030,Pompeia,98,3,2,2,3450,900,4350,44.387756
2031,Vila Nova Conceição,86,3,3,2,3500,828,4328,50.32558
2032,Consolação,53,1,1,0,1350,613,1963,37.037735
2033,Other,65,2,1,1,1500,507,2007,30.876923
2034,Brooklin,98,2,3,2,7800,1500,9300,94.89796
2035,Ipiranga,75,2,1,0,1790,70,1860,24.8
2036,República,36,1,1,0,1500,0,1500,41.666668
2037,Other,90,2,1,0,1700,0,1700,18.88889
2038,Vila Mascote,80,3,2,1,4600,700,5300,66.25
2039,Saúde,40,2,2,1,2500,697,3197,79.925
2040,Chácara Santo Antônio,143,3,5,2,8000,988,8988,62.853146
2041,Campo Belo,86,2,2,2,4300,819,5119,59.523254
2042,Santana,115,3,3,2,3200,1383,4583,39.852173
2043,Other,100,2,2,2,2300,430,2730,27.3
2044,Vila Mariana,72,2,2,2,4500,923,5423,75.31944
2045,Jardins,111,2,2,1,3500,1431,4931,44.423424
2046,Jabaquara,44,1,1,1,1150,275,1425,32.386364
2047,Itaim Bibi,83,2,2,1,4200,933,5133,61.843372
2048,Aclimação,55,1,1,1,1400,412,1812,32.945454
2049,Aclimação,57,2,2,1,1800,1024,2824,49.54386
2050,Vila Buarque,40,1,1,1,2800,400,3200,80.0
2051,República,30,1,1,1,2350,480,2830,94.333336
2052,Morumbi,168,3,5,3,5000,1250,6250,37.20238
2053,Pinheiros,75,2,3,1,3100,788,3888,51.84
2054,Vila Mascote,42,1,1,1,2200,500,2700,64.28571
2055,Campo Belo,45,1,1,1,2500,540,3040,67.55556
2056,Other,100,2,3,2,3800,1100,4900,49.0
2057,Aclimação,52,1,1,0,1800,645,2445,47.01923
2058,Santo Amaro,45,1,1,1,2200,380,2580,57.333332
2059,Other,30,1,1,1,1500,608,2108,70.26667
2060,Other,104,3,3,2,3500,1060,4560,43.846153
2061,Jaguaré,70,3,2,2,2499,600,3099,44.271427
2062,Cidade Monções,56,1,1,1,3500,880,4380,78.21429
2063,Itaim Bibi,50,1,1,1,2000,850,2850,57.0
2064,Other,70,1,1,2,3000,550,3550,50.714287
2065,Jardim Paulista,80,3,4,1,4000,1574,5574,69.675
2066,Other,49,2,1,1,1350,188,1538,31.387754
2067,Vila Mariana,45,1,1,1,3600,0,3600,80.0
2068,Santana,51,2,2,1,1950,644,2594,50.862743
2069,Other,96,3,3,2,3400,900,4300,44.791668
2070,Vila Nova Conceição,70,1,2,2,5500,1200,6700,95.71429
2071,Vila Olímpia,65,2,2,1,3400,874,4274,65.753845
2072,Cidade Monções,70,1,1,1,4500,800,5300,75.71429
2073,Morumbi,46,1,1,1,1400,900,2300,50.0
2074,Campo Belo,82,2,3,1,2700,1150,3850,46.951218
2075,Pompeia,36,1,1,1,2000,530,2530,70.27778
2076,Other,115,3,2,3,3600,1170,4770,41.47826
2077,Higienópolis,144,3,3,1,4000,1650,5650,39.23611
2078,Cidade Monções,53,1,1,1,3740,640,4380,82.64151
2079,Other,45,2,1,0,1000,0,1000,22.222221
2080,Consolação,42,1,2,1,2300,603,2903,69.11905
2081,Chácara Santo Antônio,95,3,2,2,4300,720,5020,52.842106
2082,Vila Clementino,62,2,2,1,2500,817,3317,53.5
2083,Vila Prudente,64,2,1,1,2000,480,2480,38.75
2084,Brooklin,111,3,3,2,7500,900,8400,75.675674
2085,Perdizes,117,3,4,2,4190,1625,5815,49.700855
2086,Pinheiros,140,3,3,2,8000,1420,9420,67.28571
2087,Pompeia,45,1,1,1,2000,450,2450,54.444443
2088,Campo Belo,73,2,2,1,2950,850,3800,52.054794
2089,Santa Cecília,40,1,1,1,2400,590,2990,74.75
2090,Other,39,2,1,0,1100,120,1220,31.282051
2091,Other,57,1,1,1,2500,740,3240,56.842106
2092,Other,37,1,1,1,2100,512,2612,70.5946
2093,Aclimação,110,3,2,0,3000,490,3490,31.727272
2094,Perdizes,30,1,1,1,2000,620,2620,87.333336
2095,Other,68,2,2,1,1560,840,2400,35.294117
2096,Other,80,2,2,1,2650,900,3550,44.375
2097,Vila Nova Conceição,65,2,1,1,1390,0,1390,21.384615
2098,Vila Mariana,70,2,2,1,2300,890,3190,45.57143
2099,Other,60,2,2,1,3200,650,3850,64.166664
2100,Other,50,1,1,0,1070,291,1361,27.22
2101,Other,50,2,1,1,1090,640,1730,34.6
2102,Mirandópolis,33,1,1,1,1600,645,2245,68.030304
2103,Vila Mariana,50,1,1,0,1300,261,1561,31.22
2104,Moema,37,1,1,1,2500,700,3200,86.48649
2105,Vila Madalena,50,2,1,1,2000,336,2336,46.72
2106,Consolação,25,1,1,0,2200,287,2487,99.48
2107,Other,90,2,2,2,4900,950,5850,65.0
2108,Higienópolis,50,2,2,1,2300,442,2742,54.84
2109,Pinheiros,73,2,2,1,5500,400,5900,80.821915
2110,Vila Olímpia,67,2,2,1,2900,904,3804,56.77612
2111,Campo Belo,76,1,2,0,4200,1000,5200,68.42105
2112,Barra Funda,70,3,2,1,2500,490,2990,42.714287
2113,Morumbi,72,3,2,2,2200,900,3100,43.055557
2114,Pinheiros,73,2,2,2,3900,1300,5200,71.23288
2115,Bela Vista,49,2,1,0,1600,721,2321,47.367348
2116,Vila Madalena,58,1,1,1,2800,622,3422,59.0
2117,Consolação,43,1,1,1,2300,450,2750,63.953487
2118,Other,68,3,1,1,1500,431,1931,28.397058
2119,Other,85,1,1,1,1300,607,1907,22.435293
2120,Other,80,2,2,2,5650,800,6450,80.625
2121,Aclimação,40,1,1,1,1800,758,2558,63.95
2122,Perdizes,55,1,1,1,1800,577,2377,43.21818
2123,Other,55,3,1,1,1050,509,1559,28.345455
2124,Other,50,2,1,1,1700,593,2293,45.86
2125,Pompeia,75,3,3,2,3800,840,4640,61.866665
2126,Vila Mariana,55,2,1,1,3000,600,3600,65.454544
2127,Barra Funda,51,1,1,1,2500,762,3262,63.960785
2128,Cerqueira César,136,3,4,1,3500,1700,5200,38.235294
2129,Morumbi,75,2,2,2,2500,1100,3600,48.0
2130,Moema,67,2,2,1,2300,922,3222,48.089554
2131,Vila Leopoldina,138,3,2,2,6900,1300,8200,59.420288
2132,Bela Vista,67,2,3,2,3900,750,4650,69.402985
2133,Vila Olímpia,74,2,2,1,4600,850,5450,73.64865
2134,Perdizes,45,2,1,1,1680,890,2570,57.11111
2135,Other,64,2,2,2,3800,650,4450,69.53125
2136,Lapa,94,3,2,2,4700,750,5450,57.97872
2137,Pinheiros,60,3,1,1,2400,383,2783,46.383335
2138,Saúde,57,2,2,1,2600,830,3430,60.175438
2139,Vila Andrade,66,2,2,1,3200,0,3200,48.484848
2140,Vila Olímpia,60,1,2,1,5000,1000,6000,100.0
2141,Other,68,2,2,1,1300,549,1849,27.191177
2142,Itaim Bibi,40,1,1,1,4256,587,4843,121.075
2143,Cambuci,40,1,1,1,1200,600,1800,45.0
2144,Paraíso,102,3,3,1,3800,1266,5066,49.666668
2145,Brooklin,85,3,3,2,3300,870,4170,49.058823
2146,Other,82,2,3,2,3990,605,4595,56.036587
2147,Other,52,2,1,1,1050,460,1510,29.038462
2148,Pinheiros,105,2,2,2,7500,1400,8900,84.7619
2149,Paraíso,70,2,1,0,1900,510,2410,34.42857
2150,Brooklin,62,2,2,2,5000,980,5980,96.451614
2151,Brooklin,51,1,1,1,4100,770,4870,95.4902
2152,Moema,39,1,1,1,1900,668,2568,65.84615
2153,Other,70,2,1,1,1600,620,2220,31.714285
2154,Other,130,3,3,2,5500,1150,6650,51.153847
2155,Other,67,2,2,1,3400,720,4120,61.49254
2156,Centro,50,1,1,0,1550,500,2050,41.0
2157,Vila Andrade,51,2,1,1,1910,371,2281,44.72549
2158,Other,125,3,5,3,4000,950,4950,39.6
2159,Other,48,2,1,1,1600,267,1867,38.895832
2160,Consolação,60,2,1,1,2700,723,3423,57.05
2161,Higienópolis,119,3,1,3,3000,1200,4200,35.294117
2162,Móoca,65,2,1,1,2400,509,2909,44.753845
2163,Campo Belo,41,1,1,1,2550,650,3200,78.04878
2164,Brooklin,51,1,1,1,3400,600,4000,78.43137
2165,Other,65,3,2,1,2100,700,2800,43.076923
2166,Lapa,48,1,1,1,1900,365,2265,47.1875
2167,Santa Cecília,42,2,1,0,1300,385,1685,40.11905
2168,Vila Mascote,156,4,4,2,4100,1500,5600,35.897434
2169,Pinheiros,145,2,4,2,7500,1450,8950,61.724136
2170,Liberdade,62,1,1,0,1190,375,1565,25.241936
2171,Pinheiros,20,1,1,0,2000,0,2000,100.0
2172,Brooklin,45,1,1,1,3400,650,4050,90.0
2173,Vila Mariana,61,2,1,1,1550,1376,2926,47.967213
2174,Pompeia,77,3,2,1,2800,840,3640,47.272728
2175,Vila Madalena,100,3,3,2,2600,1140,3740,37.4
2176,Jardim Paulista,41,1,1,1,1400,1100,2500,60.97561
2177,Centro,134,2,1,0,2200,557,2757,20.574627
2178,Other,48,2,1,1,1905,500,2405,50.104168
2179,Consolação,35,1,1,0,1500,470,1970,56.285713
2180,Vila Mascote,92,3,4,2,2500,1090,3590,39.02174
2181,Cerqueira César,30,1,1,0,1390,451,1841,61.366665
2182,Other,79,2,2,1,5500,1000,6500,82.27848
2183,Vila Leopoldina,143,3,4,2,6200,1460,7660,53.566433
2184,Bela Vista,112,3,3,2,6000,1014,7014,62.625
2185,Chácara Santo Antônio,130,3,3,2,5250,1250,6500,50.0
2186,Campo Belo,51,1,1,1,3200,560,3760,73.72549
2187,Other,52,2,1,1,1400,200,1600,30.76923
2188,Other,72,3,1,1,1980,640,2620,36.38889
2189,Bela Vista,55,2,2,1,3600,900,4500,81.818184
2190,Vila Olímpia,93,3,3,2,9000,1121,10121,108.82796
2191,Moema,85,2,2,1,2300,1000,3300,38.82353
2192,Pinheiros,93,2,1,0,2500,400,2900,31.182796
2193,Consolação,35,1,1,1,2750,550,3300,94.28571
2194,Consolação,28,1,1,0,1950,450,2400,85.71429
2195,Cerqueira César,32,1,1,0,2000,150,2150,67.1875
2196,Campo Belo,82,2,2,1,2000,1149,3149,38.40244
2197,Jardim América,75,2,1,0,2700,601,3301,44.013332
2198,Jardim Paulista,60,2,2,1,2900,1189,4089,68.15
2199,Pinheiros,95,3,4,2,3500,1219,4719,49.673683
2200,Vila Olímpia,65,2,2,1,2500,1200,3700,56.923077
2201,Other,55,2,1,1,2100,515,2615,47.545456
2202,Other,51,2,1,1,1127,273,1400,27.450981
2203,Vila Mariana,80,2,2,1,1700,700,2400,30.0
2204,Jardim Marajoara,92,3,1,2,3500,772,4272,46.434784
2205,Pinheiros,94,3,2,2,5000,1080,6080,64.680855
2206,Aclimação,34,1,1,1,1400,887,2287,67.26471
2207,Aclimação,48,1,2,1,3500,1088,4588,95.583336
2208,Indianópolis,108,3,2,1,4000,1080,5080,47.037037
2209,Other,70,2,1,1,2999,750,3749,53.557144
2210,Jardins,122,3,3,1,5000,1550,6550,53.688526
2211,Other,94,2,3,2,3500,1280,4780,50.851063
2212,Other,55,2,1,1,2009,907,2916,53.01818
2213,Ipiranga,140,4,3,2,3605,1315,4920,35.142857
2214,Bela Vista,48,1,1,1,2450,780,3230,67.291664
2215,Móoca,65,2,2,1,2100,631,2731,42.015385
2216,Morumbi,69,2,2,2,2000,1007,3007,43.579712
2217,Jabaquara,125,2,3,0,1900,250,2150,17.2
2218,Other,76,3,2,2,1500,610,2110,27.763159
2219,Ipiranga,75,2,1,1,2220,0,2220,29.6
2220,Vila Leopoldina,52,1,1,1,1800,650,2450,47.115383
2221,Cerqueira César,45,1,1,1,2000,1300,3300,73.333336
2222,Vila Mariana,90,3,3,1,4000,750,4750,52.77778
2223,Moema,36,1,1,1,1600,539,2139,59.416668
2224,Other,55,1,1,2,2600,1085,3685,67.0
2225,Paraíso,39,1,1,1,1700,875,2575,66.02564
2226,Jardim Paulista,113,2,3,2,7000,1395,8395,74.29204
2227,Consolação,70,2,1,1,1400,883,2283,32.614285
2228,Pinheiros,30,1,1,0,1700,856,2556,85.2
2229,Santana,70,3,2,1,1600,800,2400,34.285713
2230,Tatuapé,40,1,1,1,2800,460,3260,81.5
2231,Vila Leopoldina,35,1,1,0,1800,350,2150,61.42857
2232,Santo Amaro,53,1,1,1,1899,457,2356,44.45283
2233,Itaim Bibi,156,3,4,1,2800,1600,4400,28.205128
2234,Pinheiros,30,1,1,1,3000,550,3550,118.333336
2235,Other,45,2,1,0,550,122,672,14.933333
2236,Perdizes,98,3,3,2,3600,1200,4800,48.97959
2237,Indianópolis,97,2,2,1,5400,0,5400,55.670105
2238,Barra Funda,95,2,1,0,2300,605,2905,30.578947
2239,Mirandópolis,60,1,1,1,1600,571,2171,36.183334
2240,Other,51,1,1,1,3380,590,3970,77.84314
2241,Campo Belo,42,1,1,1,2600,546,3146,74.90476
2242,Other,78,3,3,2,2100,730,2830,36.28205
2243,Vila Olímpia,95,3,2,1,2500,1350,3850,40.526318
2244,Bela Vista,104,3,3,0,2200,955,3155,30.336538
2245,Moema,101,3,3,2,3800,1088,4888,48.396038
2246,Chácara Santo Antônio,85,3,2,1,2750,750,3500,41.17647
2247,Vila Mariana,62,2,2,1,2500,817,3317,53.5
2248,Consolação,59,2,1,0,1500,1050,2550,43.22034
2249,Chácara Santo Antônio,38,1,1,1,1800,482,2282,60.05263
2250,Vila Olímpia,44,1,1,1,3000,750,3750,85.22727
2251,Moema,90,2,2,3,4400,1250,5650,62.77778
2252,Moema,60,1,2,1,4100,843,4943,82.38333
2253,Móoca,61,3,1,1,2200,400,2600,42.62295
2254,Pinheiros,40,1,1,1,4500,687,5187,129.675
2255,Ipiranga,68,2,2,2,2700,604,3304,48.588234
2256,Vila Leopoldina,120,3,3,2,3100,1000,4100,34.166668
2257,Barra Funda,69,2,2,1,2900,540,3440,49.855072
2258,Butantã,68,3,2,2,2400,687,3087,45.39706
2259,Brás,60,2,1,1,1300,490,1790,29.833334
2260,Morumbi,77,2,2,2,2300,700,3000,38.96104
2261,Moema,47,1,2,1,4400,550,4950,105.319145
2262,Other,154,3,4,2,6300,1340,7640,49.61039
2263,Vila Clementino,85,2,2,1,3100,980,4080,48.0
2264,Chácara Santo Antônio,76,2,2,1,3000,872,3872,50.94737
2265,Other,41,1,1,1,1510,735,2245,54.756096
2266,Jardim Paulista,38,1,1,0,1600,130,1730,45.526318
2267,Bela Vista,60,1,1,0,1499,330,1829,30.483334
2268,Pinheiros,26,1,1,1,3200,0,3200,123.07692
2269,Vila Mariana,73,2,2,2,4600,1156,5756,78.84931
2270,Cambuci,176,4,5,3,8500,1260,9760,55.454544
2271,Vila Mariana,94,3,3,2,3190,1314,4504,47.914894
2272,Other,172,3,5,3,5300,1350,6650,38.662792
2273,Other,70,3,3,2,1600,1313,2913,41.614285
2274,Jardim Paulista,80,2,3,1,4500,922,5422,67.775
2275,Other,40,2,1,1,1140,150,1290,32.25
2276,Ipiranga,125,3,4,2,6000,1030,7030,56.24
2277,Other,35,1,1,1,920,0,920,26.285715
2278,Vila Olímpia,45,1,1,1,3000,850,3850,85.55556
2279,Perdizes,42,1,1,1,1900,530,2430,57.857143
2280,Pinheiros,92,2,2,0,3000,350,3350,36.413044
2281,Brooklin,112,3,3,2,3800,1250,5050,45.089287
2282,Other,56,2,1,1,1300,400,1700,30.357143
2283,Other,60,1,1,0,1500,141,1641,27.35
2284,Other,177,3,4,2,7000,1400,8400,47.457626
2285,Ipiranga,39,1,1,1,1300,370,1670,42.820515
2286,Vila Olímpia,45,1,1,1,2200,739,2939,65.31111
2287,Jardim América,127,3,3,2,8000,1500,9500,74.80315
2288,Other,74,3,2,2,3500,590,4090,55.27027
2289,Other,66,1,2,1,3500,750,4250,64.393936
2290,Perdizes,36,1,1,1,2400,460,2860,79.44444
2291,Other,34,1,1,1,1150,250,1400,41.17647
2292,Jardim Paulista,100,1,3,2,3700,1500,5200,52.0
2293,Saúde,104,2,3,2,4200,950,5150,49.51923
2294,Jabaquara,60,3,1,1,1400,558,1958,32.633335
2295,Vila Mariana,50,1,1,1,3000,856,3856,77.12
2296,Moema,156,4,5,3,9000,1584,10584,67.84615
2297,Perdizes,70,2,2,1,2800,650,3450,49.285713
2298,Consolação,30,1,1,0,1450,218,1668,55.6
2299,Vila Mariana,41,1,1,1,2200,1415,3615,88.17073
2300,Consolação,45,1,2,1,2416,947,3363,74.73333
2301,Vila Leopoldina,70,2,2,1,4000,710,4710,67.28571
2302,Higienópolis,50,2,1,1,2400,422,2822,56.44
2303,Other,70,3,2,1,1890,420,2310,33.0
2304,República,56,1,1,0,1700,380,2080,37.142857
2305,Other,45,2,1,1,1250,110,1360,30.222221
2306,Campo Belo,50,1,1,1,1700,651,2351,47.02
2307,Bela Vista,100,3,2,1,2300,1100,3400,34.0
2308,Other,65,3,1,1,1800,409,2209,33.984615
2309,Bela Vista,40,1,1,0,2300,366,2666,66.65
2310,Chácara Santo Antônio,130,3,4,2,6500,855,7355,56.576923
2311,Barra Funda,40,1,1,1,2400,520,2920,73.0
2312,Moema,76,2,3,2,3950,1400,5350,70.39474
2313,Vila Mariana,84,2,2,1,3300,522,3822,45.5
2314,Pinheiros,60,1,1,0,2247,400,2647,44.116665
2315,Saúde,57,2,2,1,2000,405,2405,42.19298
2316,Morumbi,120,3,4,2,2500,1170,3670,30.583334
2317,Other,73,3,1,1,2000,640,2640,36.164383
2318,Higienópolis,42,1,1,1,3500,870,4370,104.04762
2319,Vila Nova Conceição,64,2,2,1,1400,672,2072,32.375
2320,Other,48,2,1,1,1150,466,1616,33.666668
2321,Ipiranga,40,1,1,1,1400,435,1835,45.875
2322,Aclimação,79,2,1,1,1900,576,2476,31.341772
2323,Other,134,3,4,2,4500,1000,5500,41.044777
2324,Pinheiros,66,2,2,1,5400,1144,6544,99.15151
2325,Vila Prudente,95,3,1,2,2500,950,3450,36.31579
2326,Barra Funda,57,2,1,1,2500,576,3076,53.964912
2327,Barra Funda,58,2,1,1,2650,637,3287,56.672413
2328,Other,57,2,1,1,1100,575,1675,29.385965
2329,Vila Olímpia,60,2,1,0,2750,882,3632,60.533333
2330,Cambuci,70,3,2,1,3500,0,3500,50.0
2331,Other,74,2,2,1,1600,939,2539,34.31081
2332,Other,152,3,5,3,8500,1250,9750,64.14474
2333,Brooklin,113,3,2,2,3300,970,4270,37.78761
2334,Tatuapé,70,2,2,2,2400,732,3132,44.74286
2335,Vila Prudente,76,3,2,1,1890,838,2728,35.894737
2336,Vila Olímpia,80,2,2,2,8000,1675,9675,120.9375
2337,Other,68,3,2,1,2100,640,2740,40.294117
2338,Vila Buarque,63,2,2,1,1850,950,2800,44.444443
2339,Pinheiros,85,2,3,2,3980,1520,5500,64.70588
2340,Perdizes,82,3,3,2,2750,1290,4040,49.26829
2341,Pinheiros,72,3,1,1,3400,755,4155,57.708332
2342,Other,60,2,2,1,1580,332,1912,31.866667
2343,Bela Vista,44,1,1,1,1500,480,1980,45.0
2344,Bela Vista,84,2,3,2,6300,1300,7600,90.47619
2345,Mirandópolis,64,2,2,0,1500,520,2020,31.5625
2346,Other,107,3,4,2,4000,750,4750,44.392525
2347,Brooklin,108,3,4,2,4800,1530,6330,58.61111
2348,Vila Mariana,50,2,2,1,2800,845,3645,72.9
2349,Pinheiros,45,1,2,1,2650,825,3475,77.22222
2350,Brooklin,50,1,1,1,3200,600,3800,76.0
2351,Saúde,66,2,2,2,3000,716,3716,56.303032
2352,Other,60,2,1,1,1400,650,2050,34.166668
2353,Jardim Marajoara,60,2,1,1,1540,706,2246,37.433334
2354,Brooklin,45,1,2,1,2000,701,2701,60.02222
2355,Pinheiros,90,3,3,1,3700,1050,4750,52.77778
2356,Vila Mariana,67,2,2,2,5000,908,5908,88.17911
2357,Bela Vista,65,2,2,1,3300,800,4100,63.076923
2358,Other,60,2,2,1,1500,864,2364,39.4
2359,Ipiranga,55,2,1,1,1700,696,2396,43.563637
2360,Higienópolis,41,1,1,1,2300,788,3088,75.31707
2361,Tatuapé,130,2,3,2,6200,800,7000,53.846153
2362,Bela Vista,37,1,1,1,1450,350,1800,48.648647
2363,Jardim Paulista,70,2,2,1,5000,1400,6400,91.42857
2364,Pinheiros,45,1,2,1,2600,707,3307,73.48889
2365,Other,73,2,2,1,3000,762,3762,51.53425
2366,Other,58,2,1,1,1100,553,1653,28.5
2367,Vila Guarani,80,2,2,1,1999,660,2659,33.2375
2368,Other,40,1,1,1,1300,517,1817,45.425
2369,Other,100,3,4,2,2300,1300,3600,36.0
2370,Pinheiros,88,2,1,2,6500,1561,8061,91.60227
2371,Saúde,70,3,2,1,2400,792,3192,45.6
2372,Other,60,2,1,1,1000,210,1210,20.166666
2373,Brooklin,69,2,2,1,5300,530,5830,84.49275
2374,Saúde,70,2,1,0,1200,450,1650,23.571428
2375,Vila Mariana,63,2,1,1,2000,818,2818,44.73016
2376,República,120,2,2,0,2550,800,3350,27.916666
2377,Perdizes,38,1,1,1,1700,806,2506,65.947365
2378,Other,109,3,4,2,5000,860,5860,53.761467
2379,Saúde,85,2,2,1,1900,970,2870,33.764706
2380,Bela Vista,45,1,1,1,1800,686,2486,55.244446
2381,Paraíso,52,2,2,1,1800,589,2389,45.942307
2382,Vila Madalena,32,1,1,0,2000,530,2530,79.0625
2383,Vila Olímpia,43,1,1,1,2200,668,2868,66.69768
2384,Consolação,63,2,2,1,4500,760,5260,83.492065
2385,Pompeia,55,2,1,2,2100,735,2835,51.545456
2386,Other,87,3,2,1,2900,853,3753,43.13793
2387,Other,86,3,2,2,3100,680,3780,43.953487
2388,Moema,45,1,1,1,2000,478,2478,55.066666
2389,Other,50,2,2,2,2200,490,2690,53.8
2390,Other,70,2,2,1,2500,446,2946,42.085712
2391,Moema,100,3,4,2,6000,980,6980,69.8
2392,Cambuci,28,1,1,0,1000,200,1200,42.857143
2393,Morumbi,120,3,3,2,3500,1100,4600,38.333332
2394,Other,80,3,2,2,2500,908,3408,42.6
2395,Móoca,93,2,1,0,1200,623,1823,19.60215
2396,Vila Mariana,120,2,4,1,3700,724,4424,36.866665
2397,Vila Olímpia,93,3,3,2,5500,1650,7150,76.88172
2398,Vila Mariana,85,3,4,2,4000,1226,5226,61.482353
2399,Other,65,2,1,2,2900,984,3884,59.753845
2400,Pinheiros,60,2,1,1,4000,688,4688,78.13333
2401,Tatuapé,148,3,5,3,8000,1150,9150,61.824326
2402,Jardim Marajoara,78,2,2,2,2035,910,2945,37.75641
2403,Indianópolis,55,2,2,2,2750,810,3560,64.72727
2404,Mirandópolis,32,1,1,0,1380,200,1580,49.375
2405,Cerqueira César,32,1,1,1,1700,599,2299,71.84375
2406,Vila Mascote,74,2,2,1,1600,450,2050,27.702703
2407,Other,89,2,2,1,1800,1450,3250,36.516853
2408,Other,96,3,2,1,3300,750,4050,42.1875
2409,Pinheiros,55,2,1,1,1600,460,2060,37.454544
2410,Saúde,17,1,1,0,1000,0,1000,58.82353
2411,Consolação,35,1,1,1,2676,304,2980,85.14286
2412,Itaim Bibi,70,1,1,1,6000,1400,7400,105.71429
2413,Other,56,2,1,1,1400,0,1400,25.0
2414,Perdizes,26,1,1,0,2250,500,2750,105.76923
2415,Other,41,2,1,0,1000,300,1300,31.707317
2416,Vila Madalena,78,1,3,1,6485,1160,7645,98.01282
2417,Jardim Paulista,54,2,2,1,5000,1000,6000,111.111115
2418,Vila Leopoldina,88,2,4,2,3200,617,3817,43.375
2419,Jardim Paulista,66,2,2,1,2200,1055,3255,49.31818
2420,Other,47,2,1,1,1800,450,2250,47.87234
2421,Other,55,2,1,1,1200,500,1700,30.90909
2422,Vila Mariana,42,1,1,1,2400,410,2810,66.90476
2423,Vila Olímpia,55,1,1,1,2100,562,2662,48.4
2424,Brooklin,64,2,2,2,3900,700,4600,71.875
2425,Vila Leopoldina,95,3,3,2,5200,1068,6268,65.97895
2426,Pinheiros,63,2,2,1,3300,1041,4341,68.90476
2427,Itaim Bibi,92,2,3,1,3500,900,4400,47.826088
2428,Jardim Paulista,135,3,3,1,2500,1600,4100,30.37037
2429,Bela Vista,42,1,1,1,1900,466,2366,56.333332
2430,Other,157,3,5,2,7200,1001,8201,52.23567
2431,Other,70,2,1,1,1850,853,2703,38.614285
2432,Chácara Santo Antônio,70,2,1,2,5800,0,5800,82.85714
2433,Brooklin,50,1,1,1,3900,1100,5000,100.0
2434,Chácara Santo Antônio,95,2,2,2,6200,725,6925,72.89474
2435,Vila Olímpia,65,2,2,1,3300,874,4174,64.215385
2436,Other,44,2,1,1,1600,250,1850,42.045456
2437,Morumbi,75,2,2,2,2000,1045,3045,40.6
2438,Butantã,80,3,3,1,2950,1300,4250,53.125
2439,Vila Andrade,42,2,1,0,1000,350,1350,32.142857
2440,Perdizes,75,2,1,0,2000,835,2835,37.8
2441,Vila Nova Conceição,57,1,2,1,5899,1120,7019,123.14035
2442,República,58,1,1,0,1250,490,1740,30.0
2443,Other,53,2,1,1,1650,0,1650,31.132076
2444,Moema,55,1,1,1,1100,980,2080,37.81818
2445,Aclimação,110,3,2,0,3000,490,3490,31.727272
2446,Brooklin,73,2,2,1,4000,845,4845,66.369865
2447,Vila Andrade,60,2,2,1,2300,1210,3510,58.5
2448,Barra Funda,67,2,2,1,2200,540,2740,40.895523
2449,Bela Vista,50,2,2,1,2500,690,3190,63.8
2450,Cerqueira César,24,1,1,0,1500,370,1870,77.916664
2451,Other,64,2,1,1,2200,415,2615,40.859375
2452,Vila Mariana,80,3,3,2,1800,1450,3250,40.625
2453,Other,37,1,1,1,1600,570,2170,58.648647
2454,Other,70,2,2,1,2650,1150,3800,54.285713
2455,Other,48,2,1,1,1086,214,1300,27.083334
2456,Vila Buarque,35,1,1,0,1800,300,2100,60.0
2457,Morumbi,58,2,2,1,1500,672,2172,37.448277
2458,Vila Olímpia,63,1,2,1,6000,1350,7350,116.666664
2459,Vila Olímpia,70,2,2,1,3000,1480,4480,64.0
2460,Jabaquara,50,2,1,1,1470,630,2100,42.0
2461,Itaim Bibi,98,3,3,1,4700,1700,6400,65.30612
2462,Moema,55,2,2,2,2700,881,3581,65.10909
2463,Itaim Bibi,45,1,1,1,2600,908,3508,77.95556
2464,Chácara Santo Antônio,37,1,1,1,2000,540,2540,68.64865
2465,Bela Vista,81,2,2,0,2500,0,2500,30.864197
2466,Other,76,3,2,1,2400,777,3177,41.80263
2467,Other,47,2,1,1,930,420,1350,28.723404
2468,Pinheiros,51,2,1,1,2970,800,3770,73.92157
2469,Vila Clementino,55,2,1,1,2000,800,2800,50.909092
2470,Tatuapé,63,2,2,1,2700,450,3150,50.0
2471,Cerqueira César,30,1,1,0,2300,385,2685,89.5
2472,Vila Mascote,58,2,1,1,2000,696,2696,46.482758
2473,Jardim Paulista,50,1,1,0,2400,603,3003,60.06
2474,Vila Mariana,42,1,1,1,2000,735,2735,65.11905
2475,Vila Mariana,46,1,1,1,4100,0,4100,89.13043
2476,Other,29,1,1,0,950,100,1050,36.206898
2477,Brooklin,95,3,3,0,4750,1328,6078,63.978947
2478,Other,34,1,1,1,1600,560,2160,63.52941
2479,Pompeia,70,3,1,1,2200,738,2938,41.971428
2480,Vila Mariana,90,2,2,1,2200,730,2930,32.555557
2481,Pinheiros,70,2,2,1,4100,805,4905,70.07143
2482,Santa Cecília,120,2,1,0,2350,606,2956,24.633333
2483,Cerqueira César,55,1,1,0,2000,694,2694,48.98182
2484,Indianópolis,108,3,3,2,4500,1356,5856,54.22222
2485,Vila Madalena,32,1,1,0,3300,500,3800,118.75
2486,Saúde,57,2,1,1,1600,698,2298,40.31579
2487,Barra Funda,60,2,1,0,1600,200,1800,30.0
2488,Paraíso,64,2,2,1,2350,751,3101,48.453125
2489,Higienópolis,123,3,2,1,4500,900,5400,43.90244
2490,Other,45,2,1,1,1600,0,1600,35.555557
2491,Vila Mariana,78,2,2,0,2090,330,2420,31.02564
2492,Perdizes,65,2,2,1,2750,838,3588,55.2
2493,Other,51,1,1,1,3189,620,3809,74.68627
2494,Vila Nova Conceição,36,1,1,1,2000,948,2948,81.888885
2495,Cidade Monções,70,1,2,1,4300,712,5012,71.6
2496,Moema,55,2,2,2,3300,780,4080,74.181816
2497,Butantã,55,2,1,2,1330,420,1750,31.818182
2498,Other,45,2,1,1,1500,0,1500,33.333332
2499,Brooklin,66,1,2,1,5700,780,6480,98.181816
2500,Morumbi,142,3,5,2,6000,1150,7150,50.35211
2501,Campo Belo,50,1,1,1,3100,420,3520,70.4
2502,Saúde,70,2,2,2,2600,768,3368,48.114285
2503,Pompeia,77,2,2,2,3950,740,4690,60.909092
2504,Vila Olímpia,81,2,2,1,4500,1150,5650,69.75309
2505,Morumbi,140,3,2,2,3700,1400,5100,36.42857
2506,Vila Olímpia,40,1,1,1,3000,650,3650,91.25
2507,Santo Amaro,78,3,2,1,2850,853,3703,47.474358
2508,Campo Belo,78,2,1,0,1500,430,1930,24.74359
2509,Vila Mariana,88,2,2,1,2000,765,2765,31.420454
2510,Vila Nova Conceição,47,1,1,0,4822,942,5764,122.6383
2511,Jardim Paulista,105,2,2,0,3500,850,4350,41.42857
2512,Santana,40,1,1,2,1800,595,2395,59.875
2513,Moema,147,4,4,2,6200,1700,7900,53.741497
2514,Pinheiros,90,2,1,1,4300,700,5000,55.555557
2515,Itaim Bibi,50,2,1,1,2300,915,3215,64.3
2516,Perdizes,100,3,2,1,2700,1110,3810,38.1
2517,Other,40,2,1,1,1530,330,1860,46.5
2518,Bela Vista,164,4,4,2,5900,1650,7550,46.036587
2519,Other,70,2,1,1,2400,600,3000,42.857143
2520,Other,76,3,3,2,2000,1061,3061,40.276318
2521,Other,49,1,1,0,1300,0,1300,26.530613
2522,Moema,70,2,1,1,3000,836,3836,54.8
2523,Brás,68,2,2,1,2650,538,3188,46.882355
2524,Itaim Bibi,100,2,3,1,5000,1360,6360,63.6
2525,Other,71,2,2,1,1600,674,2274,32.028168
2526,Ipiranga,101,2,4,2,3200,1007,4207,41.653465
2527,Other,49,2,1,1,1150,0,1150,23.469387
2528,Campo Belo,80,2,2,1,2000,636,2636,32.95
2529,Brooklin,63,2,1,1,2000,812,2812,44.634922
2530,Jabaquara,57,3,1,1,1600,380,1980,34.736843
2531,Vila Clementino,115,3,3,2,1500,1668,3168,27.547827
2532,Other,32,2,1,0,1200,190,1390,43.4375
2533,Perdizes,70,2,2,1,3700,587,4287,61.24286
2534,Butantã,44,2,1,1,3000,550,3550,80.681816
2535,Other,50,1,1,1,1300,503,1803,36.06
2536,Pinheiros,126,3,3,2,7900,922,8822,70.01588
2537,Other,55,2,2,2,2500,640,3140,57.090908
2538,Moema,100,3,2,1,2900,895,3795,37.95
2539,Other,63,3,2,1,2000,500,2500,39.68254
2540,Vila Mascote,90,3,2,2,2800,877,3677,40.855556
2541,Jaguaré,70,3,2,0,2400,675,3075,43.92857
2542,Santa Cecília,45,1,1,1,1800,700,2500,55.555557
2543,Brás,62,2,1,1,1200,500,1700,27.419355
2544,Butantã,75,3,3,2,2000,998,2998,39.97333
2545,Santa Cecília,84,2,2,1,2500,950,3450,41.07143
2546,Brooklin,91,2,2,1,2850,1353,4203,46.186813
2547,Chácara Santo Antônio,104,4,4,2,3900,980,4880,46.923077
2548,Santana,18,1,1,0,950,0,950,52.77778
2549,Campo Belo,130,3,5,2,5000,1395,6395,49.192307
2550,Brooklin,41,1,1,1,2700,580,3280,80.0
2551,Other,58,2,1,0,2000,707,2707,46.672413
2552,Vila Clementino,93,2,2,2,6000,1093,7093,76.268814
2553,Vila Guarani,50,1,1,1,1600,640,2240,44.8
2554,Other,47,2,1,1,1000,290,1290,27.446808
2555,Perdizes,78,2,1,2,3200,1154,4354,55.820515
2556,Moema,116,3,4,2,7200,1200,8400,72.413795
2557,República,45,1,1,0,1250,425,1675,37.22222
2558,Vila Clementino,80,2,2,1,2500,817,3317,41.4625
2559,Vila Madalena,80,3,3,2,3800,840,4640,58.0
2560,Perdizes,52,1,2,1,3300,400,3700,71.15385
2561,Santa Cecília,40,1,1,1,1800,655,2455,61.375
2562,Bela Vista,120,2,2,0,2200,603,2803,23.358334
2563,Moema,73,2,1,1,2500,1047,3547,48.589043
2564,Other,75,3,2,1,3300,0,3300,44.0
2565,Santa Cecília,35,1,1,1,1200,452,1652,47.2
2566,Pinheiros,30,1,1,1,2500,686,3186,106.2
2567,Cambuci,50,1,1,0,1700,380,2080,41.6
2568,Cerqueira César,120,2,1,1,3400,0,3400,28.333334
2569,Barra Funda,82,2,2,1,4000,800,4800,58.536587
2570,Brooklin,70,2,2,2,2400,793,3193,45.614285
2571,Perdizes,60,2,1,0,1850,160,2010,33.5
2572,Itaim Bibi,55,1,2,1,2300,710,3010,54.727272
2573,Other,100,2,1,0,1750,897,2647,26.47
2574,Other,165,4,2,3,5600,1411,7011,42.49091
2575,Other,76,2,2,1,3100,670,3770,49.605263
2576,Perdizes,126,3,2,1,4500,659,5159,40.944443
2577,Pinheiros,138,3,3,2,5000,1680,6680,48.405796
2578,Vila Clementino,140,4,4,2,4500,1400,5900,42.142857
2579,Other,44,2,1,1,1500,420,1920,43.636364
2580,Aclimação,36,1,1,1,1200,837,2037,56.583332
2581,Vila Guarani,77,2,2,1,2900,803,3703,48.090908
2582,Jaguaré,74,3,1,2,2500,736,3236,43.72973
2583,Vila Olímpia,60,2,1,1,2200,1064,3264,54.4
2584,Moema,53,2,2,1,2500,520,3020,56.981133
2585,Vila Nova Conceição,127,3,2,2,6000,1414,7414,58.377953
2586,Other,50,2,1,1,1100,259,1359,27.18
2587,Saúde,74,2,2,1,2000,450,2450,33.10811
2588,Moema,40,1,1,1,1899,710,2609,65.225
2589,Other,34,1,1,1,2500,523,3023,88.911766
2590,Pinheiros,44,1,1,1,3500,635,4135,93.97727
2591,Pinheiros,30,1,1,1,2600,400,3000,100.0
2592,Chácara Santo Antônio,70,2,2,0,1900,310,2210,31.571428
2593,Vila Andrade,181,3,2,2,3800,663,4463,24.65746
2594,Aclimação,47,1,1,1,1345,499,1844,39.234043
2595,Other,58,2,1,1,1300,625,1925,33.189655
2596,Vila Olímpia,60,2,1,1,3500,871,4371,72.85
2597,Chácara Santo Antônio,105,3,2,2,4500,988,5488,52.266666
2598,Other,15,2,1,0,1520,110,1630,108.666664
2599,Vila Leopoldina,74,2,3,1,2500,735,3235,43.716217
2600,Higienópolis,96,2,2,1,3500,980,4480,46.666668
2601,Other,40,2,1,0,1200,117,1317,32.925
2602,Other,22,1,1,0,1100,100,1200,54.545456
2603,Perdizes,80,3,3,1,2300,1033,3333,41.6625
2604,Cidade Monções,55,2,2,1,2600,962,3562,64.76363
2605,Other,61,2,2,1,2500,650,3150,51.639343
2606,Other,145,4,5,2,3500,1400,4900,33.793102
2607,Other,88,2,1,0,2100,0,2100,23.863636
2608,Itaim Bibi,62,2,2,1,5000,873,5873,94.72581
2609,Brooklin,56,2,2,1,2800,548,3348,59.785713
2610,Other,44,2,1,1,1200,280,1480,33.636364
2611,Perdizes,65,2,3,2,3000,1175,4175,64.23077
2612,Vila Andrade,57,2,2,1,3000,535,3535,62.017544
2613,Other,48,2,1,1,950,350,1300,27.083334
2614,Aclimação,34,1,1,1,1300,837,2137,62.85294
2615,Paraíso,114,2,4,1,2500,980,3480,30.526316
2616,Butantã,75,2,2,1,1900,900,2800,37.333332
2617,Lapa,138,3,2,3,5400,900,6300,45.652172
2618,Centro,42,1,1,0,1800,470,2270,54.04762
2619,Saúde,52,2,1,1,2500,655,3155,60.673077
2620,Other,55,2,1,1,1000,250,1250,22.727272
2621,Other,47,1,2,1,2950,600,3550,75.53191
2622,Bela Vista,51,2,1,1,2300,400,2700,52.941177
2623,Vila Guarani,74,3,2,2,3500,562,4062,54.89189
2624,Paraíso,36,1,1,0,1500,540,2040,56.666668
2625,Vila Mariana,33,1,1,1,1600,560,2160,65.454544
2626,Other,46,2,1,1,1100,444,1544,33.565216
2627,Campo Belo,70,2,2,2,2950,1100,4050,57.857143
2628,Moema,65,2,2,1,2100,1100,3200,49.23077
2629,Moema,75,2,2,1,3200,780,3980,53.066666
2630,Liberdade,40,1,1,1,1200,615,1815,45.375
2631,Jardim Paulista,104,3,3,1,3200,1400,4600,44.23077
2632,Consolação,138,3,3,1,2500,1200,3700,26.811594
2633,Liberdade,37,1,1,0,1199,334,1533,41.432434
2634,Jardins,60,1,2,1,2700,895,3595,59.916668
2635,Tatuapé,68,2,2,2,2000,548,2548,37.47059
2636,Butantã,38,2,1,1,1300,300,1600,42.105263
2637,Vila Guarani,110,3,4,2,4300,980,5280,48.0
2638,Other,60,3,1,1,1200,602,1802,30.033333
2639,Pinheiros,70,2,1,1,4300,800,5100,72.85714
2640,Other,55,2,1,0,1500,350,1850,33.636364
2641,Brooklin,60,1,2,2,3000,980,3980,66.333336
2642,Tatuapé,48,2,1,1,1300,494,1794,37.375
2643,Brooklin,48,1,1,1,1600,750,2350,48.958332
2644,Aclimação,90,3,3,2,2750,1060,3810,42.333332
2645,Perdizes,107,3,4,2,4300,1650,5950,55.607475
2646,Vila Guarani,65,3,2,1,1650,610,2260,34.76923
2647,Vila Olímpia,44,1,1,1,4000,679,4679,106.34091
2648,Other,70,3,2,1,1600,620,2220,31.714285
2649,Other,62,3,1,1,1750,540,2290,36.935482
2650,Other,60,2,1,1,2500,280,2780,46.333332
2651,Moema,84,2,2,2,2800,1193,3993,47.535713
2652,Campo Belo,63,2,2,1,2000,760,2760,43.809525
2653,Brooklin,86,3,2,1,2300,820,3120,36.279068
2654,Higienópolis,60,2,3,1,2500,680,3180,53.0
2655,Saúde,45,2,1,1,2280,665,2945,65.44444
2656,Bela Vista,60,2,1,0,1970,320,2290,38.166668
2657,Bela Vista,39,1,1,1,1700,423,2123,54.435898
2658,Vila Mariana,65,2,2,1,2650,734,3384,52.06154
2659,Vila Olímpia,65,2,1,1,2500,965,3465,53.307693
2660,Itaim Bibi,70,2,1,1,2400,1020,3420,48.857143
2661,Vila Madalena,134,3,1,1,3100,526,3626,27.059702
2662,Other,80,2,2,2,3000,896,3896,48.7
2663,Cidade Monções,68,2,2,2,4200,800,5000,73.52941
2664,Vila Olímpia,107,2,2,1,3999,970,4969,46.43925
2665,Vila Clementino,115,4,4,3,4200,1350,5550,48.260868
2666,Other,130,3,4,2,4800,1350,6150,47.307693
2667,Móoca,56,2,2,1,2200,580,2780,49.642857
2668,Saúde,70,3,2,2,2400,574,2974,42.485714
2669,Other,126,2,4,2,7300,920,8220,65.2381
2670,Jaguaré,63,2,2,1,2022,440,2462,39.079365
2671,Pinheiros,94,2,2,1,5900,1430,7330,77.97872
2672,Other,50,2,1,1,2350,500,2850,57.0
2673,Other,58,2,2,1,1700,896,2596,44.75862
2674,Vila Madalena,69,2,2,1,6500,376,6876,99.652176
2675,República,38,1,1,0,1200,309,1509,39.710526
2676,Vila Nova Conceição,60,2,2,1,4460,860,5320,88.666664
2677,Santa Cecília,40,1,1,1,1750,545,2295,57.375
2678,Paraíso,55,2,1,1,2300,678,2978,54.145454
2679,Cidade Monções,85,3,2,1,2500,774,3274,38.517647
2680,Other,120,3,2,0,1300,859,2159,17.991667
2681,Bela Vista,32,1,1,1,1400,530,1930,60.3125
2682,Pinheiros,90,3,3,1,3000,750,3750,41.666668
2683,Bela Vista,50,1,1,0,1700,526,2226,44.52
2684,Morumbi,74,3,3,2,2000,750,2750,37.162163
2685,Vila Buarque,25,1,1,0,1300,210,1510,60.4
2686,Santa Cecília,166,3,3,0,3800,1469,5269,31.740963
2687,Jardim Paulista,90,2,1,1,3200,1300,4500,50.0
2688,Brooklin,50,1,2,1,3500,546,4046,80.92
2689,Bela Vista,36,1,1,0,1000,387,1387,38.52778
2690,Other,110,3,3,2,2430,1250,3680,33.454544
2691,Vila Clementino,50,2,1,1,1895,711,2606,52.12
2692,Vila Nova Conceição,70,3,3,1,3500,915,4415,63.07143
2693,Bela Vista,70,2,1,0,2000,390,2390,34.142857
2694,Saúde,42,1,1,1,2100,530,2630,62.61905
2695,Pompeia,61,2,1,1,2500,930,3430,56.229507
2696,Moema,48,1,1,1,2100,985,3085,64.270836
2697,Bela Vista,60,2,1,0,2200,0,2200,36.666668
2698,Higienópolis,60,2,2,2,4500,782,5282,88.03333
2699,Other,65,2,2,1,3100,500,3600,55.384617
2700,Pinheiros,70,2,1,1,4300,838,5138,73.4
2701,Brooklin,55,2,2,1,2000,560,2560,46.545456
2702,Vila Clementino,67,2,2,1,2400,740,3140,46.865673
2703,Bela Vista,75,2,2,2,3500,1232,4732,63.093334
2704,Other,41,2,1,0,1350,330,1680,40.97561
2705,Chácara Santo Antônio,35,1,1,1,2599,430,3029,86.542854
2706,Jardim Paulista,78,2,2,1,2500,870,3370,43.205128
2707,Other,80,3,2,1,4000,883,4883,61.0375
2708,Saúde,130,3,4,2,2700,1500,4200,32.307693
2709,Bela Vista,42,1,1,1,2200,700,2900,69.04762
2710,Ipiranga,62,2,1,1,2500,550,3050,49.19355
2711,Jardim Paulista,42,1,1,1,3000,702,3702,88.14286
2712,Vila Mascote,37,1,1,0,1500,200,1700,45.945946
2713,Other,40,1,1,1,1500,1300,2800,70.0
2714,Consolação,59,1,1,1,1300,960,2260,38.305084
2715,República,74,1,1,0,1450,485,1935,26.14865
2716,Other,49,1,1,1,2800,604,3404,69.46939
2717,Tatuapé,59,2,2,1,2200,424,2624,44.474575
2718,Pinheiros,68,2,1,2,4500,1007,5507,80.98529
2719,Other,64,3,1,1,1600,430,2030,31.71875
2720,Itaim Bibi,32,1,1,1,2850,1200,4050,126.5625
2721,Itaim Bibi,103,3,3,2,5200,1212,6412,62.252426
2722,Itaim Bibi,110,3,2,2,5000,1232,6232,56.654545
2723,Centro,45,1,1,0,1500,200,1700,37.77778
2724,Higienópolis,60,2,2,1,4800,749,5549,92.48333
2725,Brooklin,63,2,1,1,2800,750,3550,56.349205
2726,Itaim Bibi,103,2,3,1,4500,1023,5523,53.62136
2727,Barra Funda,70,3,2,1,2400,446,2846,40.657143
2728,Vila Nova Conceição,95,2,3,1,5800,1150,6950,73.1579
2729,Moema,48,1,1,1,1800,900,2700,56.25
2730,Other,60,2,1,1,1200,374,1574,26.233334
2731,Other,50,2,1,1,1800,550,2350,47.0
2732,Indianópolis,78,2,2,1,2800,682,3482,44.641026
2733,Other,58,2,1,1,1300,696,1996,34.41379
2734,Tatuapé,50,2,1,1,1400,550,1950,39.0
2735,Bela Vista,50,2,1,1,2200,715,2915,58.3
2736,Other,44,1,1,1,2550,664,3214,73.045456
2737,Other,45,1,1,0,1100,150,1250,27.777779
2738,Other,168,4,4,3,8000,1300,9300,55.357143
2739,Saúde,50,1,1,0,1250,50,1300,26.0
2740,Vila Mariana,115,3,3,3,3500,1600,5100,44.347828
2741,Other,49,2,1,1,1500,270,1770,36.122448
2742,Paraíso,157,3,3,2,5000,1000,6000,38.21656
2743,Indianópolis,55,2,2,1,2000,1400,3400,61.81818
2744,Vila Prudente,64,2,1,1,1908,460,2368,37.0
2745,Vila Mariana,75,3,3,2,2300,950,3250,43.333332
2746,Vila Mariana,108,3,1,2,6000,850,6850,63.425926
2747,Vila Leopoldina,120,3,3,2,3500,1700,5200,43.333332
2748,Vila Mariana,100,3,4,3,3400,1406,4806,48.06
2749,Mirandópolis,70,3,2,1,1900,807,2707,38.67143
2750,Other,115,3,4,2,5000,1000,6000,52.173912
2751,Vila Olímpia,55,2,1,1,5500,913,6413,116.6
2752,Other,48,2,1,1,1100,350,1450,30.208334
2753,Lapa,52,2,1,1,1900,396,2296,44.153847
2754,Pinheiros,44,1,1,1,2800,633,3433,78.02273
2755,Vila Olímpia,78,2,3,1,2200,1190,3390,43.46154
2756,Brooklin,53,1,2,1,4450,600,5050,95.28302
2757,Saúde,98,3,4,2,3075,1000,4075,41.581635
2758,Other,60,2,1,1,1800,904,2704,45.066666
2759,Other,44,2,1,1,1369,331,1700,38.636364
2760,Vila Olímpia,30,1,1,1,900,1400,2300,76.666664
2761,Perdizes,130,3,3,0,2600,1593,4193,32.253845
2762,Brooklin,95,3,3,1,2700,789,3489,36.726315
2763,Bela Vista,54,2,1,1,1800,400,2200,40.74074
2764,Brooklin,65,2,2,2,3985,800,4785,73.61539
2765,Cidade Monções,70,3,1,1,4300,715,5015,71.64286
2766,Moema,65,1,2,1,2578,1434,4012,61.723076
2767,Higienópolis,92,2,2,0,3800,780,4580,49.782608
2768,Other,55,2,1,1,1400,670,2070,37.636364
2769,Other,67,3,1,1,1400,850,2250,33.58209
2770,Vila Mariana,65,2,2,1,3000,745,3745,57.615383
2771,Other,70,2,2,1,2000,0,2000,28.571428
2772,Itaim Bibi,67,2,2,0,3700,1012,4712,70.32836
2773,Vila Mariana,125,3,3,2,6200,750,6950,55.6
2774,Itaim Bibi,120,3,3,1,4400,1052,5452,45.433334
2775,Other,60,2,2,1,1300,980,2280,38.0
2776,Other,168,3,2,2,4700,1556,6256,37.238094
2777,Perdizes,38,1,1,1,2000,559,2559,67.3421
2778,Other,100,2,2,1,1800,500,2300,23.0
2779,Chácara Santo Antônio,106,3,4,2,5500,1093,6593,62.198112
2780,Cerqueira César,47,1,2,1,1800,630,2430,51.70213
2781,Vila Andrade,45,1,1,1,1900,598,2498,55.511112
2782,Vila Mariana,58,2,2,1,2600,820,3420,58.96552
2783,Vila Madalena,22,1,1,0,1700,700,2400,109.09091
2784,Mirandópolis,18,1,1,0,1000,200,1200,66.666664
2785,Pinheiros,70,2,1,1,4500,800,5300,75.71429
2786,Other,68,2,2,1,6000,503,6503,95.632355
2787,Brooklin,75,2,2,2,3020,886,3906,52.08
2788,Paraíso,90,2,2,0,2350,605,2955,32.833332
2789,Perdizes,105,3,2,1,3500,988,4488,42.74286
2790,Other,57,2,2,1,1602,398,2000,35.08772
2791,Butantã,58,2,2,2,1500,837,2337,40.293102
2792,Other,70,2,2,2,5500,0,5500,78.57143
2793,Morumbi,42,1,1,1,1700,650,2350,55.95238
2794,Vila Buarque,58,1,1,0,2200,406,2606,44.931034
2795,Vila Guarani,50,2,1,1,1500,580,2080,41.6
2796,Cidade Monções,92,3,2,1,3000,726,3726,40.5
2797,Other,180,3,3,2,4700,1660,6360,35.333332
2798,Other,44,1,1,1,1490,400,1890,42.954544
2799,Vila Olímpia,80,2,1,0,2900,809,3709,46.3625
2800,Brooklin,48,2,2,1,2500,864,3364,70.083336
2801,Jardim Paulista,76,2,2,1,3500,926,4426,58.236843
2802,Vila Guarani,79,2,3,1,1900,782,2682,33.949368
2803,Campo Belo,70,2,2,1,2600,750,3350,47.857143
2804,Other,60,2,2,1,2800,700,3500,58.333332
2805,Vila Guarani,66,3,2,1,2800,700,3500,53.030304
2806,Bela Vista,60,1,1,1,3600,716,4316,71.933334
2807,Other,73,2,2,2,3800,0,3800,52.054794
2808,Moema,60,2,2,1,2600,808,3408,56.8
2809,Vila Olímpia,80,2,2,1,3200,950,4150,51.875
2810,Vila Mariana,60,1,1,1,1950,561,2511,41.85
2811,Other,85,3,1,1,2300,850,3150,37.058823
2812,Cambuci,136,3,3,2,2000,1090,3090,22.720589
2813,Pinheiros,57,1,1,1,3950,769,4719,82.789474
2814,Other,60,2,2,1,1900,885,2785,46.416668
2815,Consolação,25,1,1,1,1650,480,2130,85.2
2816,Brooklin,70,2,2,1,1800,950,2750,39.285713
2817,Ipiranga,126,3,2,1,2500,230,2730,21.666666
2818,Pinheiros,66,1,1,1,2500,786,3286,49.78788
2819,Tatuapé,97,3,3,2,2700,908,3608,37.195877
2820,Moema,110,3,3,2,4900,1350,6250,56.81818
2821,Consolação,25,1,1,1,1720,480,2200,88.0
2822,Higienópolis,198,3,2,2,5300,1490,6790,34.29293
2823,Other,60,2,1,1,2000,0,2000,33.333332
2824,Other,50,1,1,1,2200,400,2600,52.0
2825,Vila Buarque,32,1,1,0,1250,348,1598,49.9375
2826,Vila Mascote,54,2,2,2,1740,1163,2903,53.75926
2827,Cerqueira César,60,1,2,1,1500,1096,2596,43.266666
2828,Ipiranga,54,2,1,1,1650,485,2135,39.537037
2829,Ipiranga,75,3,2,1,3000,680,3680,49.066666
2830,Tatuapé,29,1,1,0,1450,138,1588,54.75862
2831,Brooklin,51,1,1,1,2900,545,3445,67.54902
2832,Vila Olímpia,62,2,2,1,4800,873,5673,91.5
2833,Moema,74,2,3,1,4650,1240,5890,79.5946
2834,Other,60,2,1,1,1300,450,1750,29.166666
2835,Butantã,36,1,1,1,2800,480,3280,91.111115
2836,Brooklin,50,1,1,1,2400,588,2988,59.76
2837,Itaim Bibi,98,2,2,1,3600,930,4530,46.22449
2838,Vila Mariana,134,3,1,2,5500,1650,7150,53.358208
2839,Morumbi,105,3,4,0,3300,1190,4490,42.761906
2840,Consolação,140,3,2,0,3300,554,3854,27.528572
2841,Vila Andrade,34,2,1,1,1350,579,1929,56.735294
2842,Moema,165,3,4,2,6200,1400,7600,46.060608
2843,Moema,75,2,3,2,4500,1200,5700,76.0
2844,Perdizes,135,3,3,3,6000,1505,7505,55.592594
2845,Other,48,2,1,1,1200,430,1630,33.958332
2846,Jardim Paulista,48,1,1,0,1600,380,1980,41.25
2847,Vila Olímpia,35,1,1,1,3000,859,3859,110.25714
2848,Bela Vista,54,2,1,1,2800,850,3650,67.59259
2849,Other,65,3,2,1,1300,485,1785,27.461538
2850,Other,55,2,1,1,2700,500,3200,58.18182
2851,Chácara Santo Antônio,70,2,2,2,4500,853,5353,76.47143
2852,Itaim Bibi,158,3,3,1,5350,1340,6690,42.341774
2853,Consolação,67,1,2,1,4600,800,5400,80.597015
2854,Vila Mariana,73,2,2,1,2100,880,2980,40.82192
2855,Chácara Santo Antônio,51,2,2,1,2800,625,3425,67.15686
2856,Other,70,2,2,1,3100,700,3800,54.285713
2857,Centro,51,1,1,1,1699,699,2398,47.019608
2858,Consolação,32,1,1,1,1650,425,2075,64.84375
2859,Perdizes,106,3,3,2,3100,1272,4372,41.24528
2860,Vila Prudente,70,2,2,1,1600,518,2118,30.257143
2861,Santa Cecília,46,1,1,1,1600,600,2200,47.826088
2862,Vila Clementino,40,1,1,1,2300,514,2814,70.35
2863,Higienópolis,122,3,2,2,5500,1690,7190,58.934425
2864,Mirandópolis,38,1,1,1,1000,943,1943,51.13158
2865,Pinheiros,90,3,2,1,4000,1028,5028,55.866665
2866,Itaim Bibi,131,3,2,1,5000,945,5945,45.38168
2867,Other,32,2,1,0,1200,190,1390,43.4375
2868,Itaim Bibi,100,3,3,1,2700,1300,4000,40.0
2869,República,48,1,1,1,2990,548,3538,73.708336
2870,Other,47,2,1,1,1150,396,1546,32.893616
2871,Pinheiros,63,1,2,1,3900,990,4890,77.61905
2872,Other,47,2,1,1,1700,0,1700,36.17021
2873,Jardins,50,1,2,0,2800,380,3180,63.6
2874,Vila Olímpia,80,3,2,1,2900,1350,4250,53.125
2875,Pinheiros,60,2,2,1,4500,800,5300,88.333336
2876,Other,112,3,3,0,3000,1100,4100,36.607143
2877,Vila Madalena,45,1,1,1,2600,601,3201,71.13333
2878,Higienópolis,40,1,1,1,2450,505,2955,73.875
2879,Saúde,37,1,1,1,2300,460,2760,74.5946
2880,Campo Belo,75,2,2,1,1600,800,2400,32.0
2881,Vila Mariana,45,2,2,1,1800,626,2426,53.91111
2882,Other,50,1,1,1,2303,565,2868,57.36
2883,Móoca,73,2,2,1,2000,540,2540,34.79452
2884,Cambuci,56,1,1,0,1300,580,1880,33.57143
2885,Itaim Bibi,118,3,3,1,4400,1525,5925,50.211864
2886,Other,68,3,1,1,1450,431,1881,27.661764
2887,Itaim Bibi,105,3,3,1,3500,1100,4600,43.809525
2888,Bela Vista,58,2,1,1,3500,552,4052,69.86207
2889,Perdizes,42,1,1,1,2000,600,2600,61.904762
2890,Brooklin,40,1,1,1,1400,830,2230,55.75
2891,Other,98,3,4,2,4000,0,4000,40.816326
2892,Jardim Paulista,40,1,1,1,1900,829,2729,68.225
2893,Santana,123,3,3,2,4300,1049,5349,43.487804
2894,Other,72,3,2,2,2500,836,3336,46.333332
2895,Other,55,2,2,1,1700,455,2155,39.18182
2896,Morumbi,100,2,2,2,3200,961,4161,41.61
2897,Jardim Paulista,76,2,2,1,4000,900,4900,64.47369
2898,Bela Vista,50,1,1,0,1300,495,1795,35.9
2899,Vila Mariana,94,3,4,2,3600,810,4410,46.914894
2900,Vila Mariana,53,1,2,1,1800,665,2465,46.509434
2901,Pinheiros,48,2,1,1,2900,730,3630,75.625
2902,República,40,1,1,0,1200,300,1500,37.5
2903,República,32,1,1,1,1100,785,1885,58.90625
2904,Campo Belo,131,4,4,3,6500,1420,7920,60.458015
2905,Vila Prudente,55,2,1,1,1900,550,2450,44.545456
2906,Pinheiros,49,2,1,1,3100,657,3757,76.67347
2907,Brooklin,83,3,3,2,3400,1000,4400,53.012047
2908,Ipiranga,95,3,2,1,2200,740,2940,30.947369
2909,Jaguaré,50,2,1,1,1200,583,1783,35.66
2910,Chácara Santo Antônio,52,2,1,1,3000,600,3600,69.23077
2911,Santa Cecília,108,2,2,0,2200,1021,3221,29.824074
2912,Saúde,160,4,2,2,3750,1700,5450,34.0625
2913,Vila Olímpia,59,2,2,1,2700,830,3530,59.83051
2914,Other,60,2,2,2,3300,700,4000,66.666664
2915,Other,60,2,1,1,1650,0,1650,27.5
2916,Vila Nova Conceição,70,1,2,1,3200,1525,4725,67.5
2917,Vila Mariana,50,1,2,1,3500,550,4050,81.0
2918,Mirandópolis,62,2,2,1,1500,1250,2750,44.35484
2919,Consolação,118,3,3,1,2700,1335,4035,34.194916
2920,Other,44,2,1,1,750,250,1000,22.727272
2921,Barra Funda,40,1,1,0,1200,470,1670,41.75
2922,Vila Leopoldina,70,1,1,1,3000,735,3735,53.357143
2923,Santo Amaro,70,2,1,0,1359,327,1686,24.085714
2924,Morumbi,50,1,1,1,2500,800,3300,66.0
2925,Pinheiros,100,3,2,1,3200,1300,4500,45.0
2926,Bela Vista,48,1,1,1,2000,580,2580,53.75
2927,Other,65,2,2,1,2250,324,2574,39.6
2928,Ipiranga,74,2,3,1,4200,460,4660,62.972973
2929,Jardim Paulista,75,2,2,1,3000,1200,4200,56.0
2930,Vila Olímpia,70,2,2,1,6800,900,7700,110.0
2931,Brás,67,3,1,1,1900,470,2370,35.373135
2932,Vila Leopoldina,88,3,1,2,4500,860,5360,60.909092
2933,Campo Belo,55,1,1,1,2300,600,2900,52.727272
2934,Jardins,37,1,1,1,1800,1350,3150,85.13513
2935,Other,65,2,2,1,2350,800,3150,48.46154
2936,Other,57,2,2,2,2750,842,3592,63.017544
2937,Other,69,3,2,2,1800,545,2345,33.985508
2938,República,32,1,1,0,1550,435,1985,62.03125
2939,Other,78,3,3,2,2800,1380,4180,53.589745
2940,Vila Mariana,83,3,2,1,2500,731,3231,38.92771
2941,Other,55,2,1,1,1850,570,2420,44.0
2942,Barra Funda,49,1,1,1,1600,260,1860,37.959183
2943,Moema,53,2,2,1,2500,520,3020,56.981133
2944,Higienópolis,80,3,3,2,4900,1070,5970,74.625
2945,Campo Belo,120,3,4,2,3700,1280,4980,41.5
2946,Other,80,2,2,1,1900,306,2206,27.575
2947,Cerqueira César,74,2,2,0,2990,338,3328,44.972973
2948,Itaim Bibi,98,2,4,1,5200,1584,6784,69.22449
2949,Chácara Santo Antônio,98,3,3,2,3000,705,3705,37.80612
2950,Perdizes,40,1,1,1,1750,582,2332,58.3
2951,Liberdade,64,2,1,1,1500,540,2040,31.875
2952,Santana,39,1,1,1,1700,530,2230,57.179485
2953,Vila Mariana,100,3,3,1,3000,1200,4200,42.0
2954,Perdizes,80,2,1,0,1700,524,2224,27.8
2955,Other,27,1,1,0,1280,0,1280,47.407406
2956,Other,82,3,3,2,1950,880,2830,34.512196
2957,Vila Mariana,65,2,2,2,3500,794,4294,66.06154
2958,Itaim Bibi,110,3,2,1,4500,1100,5600,50.909092
2959,Other,55,2,1,0,1250,0,1250,22.727272
2960,Chácara Santo Antônio,100,3,3,2,4000,1021,5021,50.21
2961,Other,52,2,1,1,1000,200,1200,23.076923
2962,Jaguaré,60,2,1,1,1300,634,1934,32.233334
2963,Vila Mariana,80,3,2,0,2600,515,3115,38.9375
2964,Santa Cecília,35,1,1,0,1300,500,1800,51.42857
2965,Paraíso,42,1,2,1,2300,550,2850,67.85714
2966,Vila Mariana,120,3,3,1,2950,723,3673,30.608334
2967,Vila Nova Conceição,150,2,3,1,8400,1165,9565,63.766666
2968,Bela Vista,55,2,1,1,2300,741,3041,55.29091
2969,Bela Vista,42,1,1,0,1360,393,1753,41.738094
2970,Other,54,2,1,0,1550,420,1970,36.48148
2971,Ipiranga,76,2,2,1,2100,1022,3122,41.07895
2972,Ipiranga,76,2,2,1,2100,1022,3122,41.07895
2973,Moema,50,1,1,1,2736,600,3336,66.72
2974,Lapa,58,2,1,1,1350,450,1800,31.034483
2975,Aclimação,87,2,1,1,1680,360,2040,23.448277
2976,Indianópolis,86,3,2,2,3300,1282,4582,53.279068
2977,Other,50,2,1,0,1200,310,1510,30.2
2978,Other,126,4,5,2,2900,1500,4400,34.920635
2979,Other,65,2,2,1,2000,805,2805,43.153847
2980,Other,56,2,1,1,2000,0,2000,35.714287
2981,Vila Mariana,38,1,1,1,3000,600,3600,94.73684
2982,Pinheiros,80,2,2,2,6690,1350,8040,100.5
2983,Other,60,2,1,1,1100,600,1700,28.333334
2984,Vila Prudente,60,2,1,1,3300,331,3631,60.516666
2985,Santana,110,3,2,2,1700,1300,3000,27.272728
2986,Vila Mariana,80,3,2,1,2800,900,3700,46.25
2987,Vila Mariana,45,2,1,1,1800,640,2440,54.22222
2988,Jardim Paulista,50,2,1,1,2600,838,3438,68.76
2989,Moema,86,2,1,2,3700,749,4449,51.73256
2990,Jardim Paulista,110,3,3,1,4500,1200,5700,51.81818
2991,Chácara Santo Antônio,70,2,1,1,3200,734,3934,56.2
2992,Other,60,2,1,1,2900,342,3242,54.033333
2993,Other,40,2,1,1,1200,340,1540,38.5
2994,Other,75,2,2,1,4200,680,4880,65.066666
2995,Other,97,2,2,2,4300,1300,5600,57.73196
2996,Vila Mariana,81,2,3,2,3100,1440,4540,56.04938
2997,Other,49,2,1,0,1400,480,1880,38.367348
2998,Tatuapé,60,2,2,1,2400,650,3050,50.833332
2999,Moema,50,1,2,1,3000,597,3597,71.94
3000,Indianópolis,47,1,2,0,2200,863,3063,65.17021
3001,Bela Vista,37,1,1,1,2300,530,2830,76.48649
3002,Santo Amaro,102,2,2,1,5000,587,5587,54.77451
3003,Ipiranga,86,3,1,1,2000,950,2950,34.302326
3004,Other,65,2,1,1,1250,600,1850,28.461538
3005,Lapa,65,2,1,1,1400,368,1768,27.2
3006,Other,64,2,2,1,1900,560,2460,38.4375
3007,Other,45,1,1,1,2700,459,3159,70.2
3008,Consolação,59,2,1,0,1800,620,2420,41.01695
3009,Other,91,2,3,2,3500,620,4120,45.274727
3010,Other,174,3,4,3,9000,1644,10644,61.172413
3011,Indianópolis,95,3,3,2,3800,1350,5150,54.210526
3012,Other,100,3,4,0,6490,1040,7530,75.3
3013,Vila Mariana,30,1,1,0,3190,0,3190,106.333336
3014,Vila Clementino,43,1,1,0,3400,342,3742,87.023254
3015,Vila Olímpia,51,2,1,1,3150,700,3850,75.4902
3016,Vila Clementino,77,3,2,1,2700,1050,3750,48.701298
3017,Higienópolis,64,2,1,1,2200,670,2870,44.84375
3018,Jardim Marajoara,182,3,2,2,6600,1600,8200,45.054947
3019,Vila Prudente,74,2,1,1,1250,508,1758,23.756756
3020,Saúde,64,2,2,1,1900,790,2690,42.03125
3021,Itaim Bibi,87,3,3,1,5500,1108,6608,75.954025
3022,Cidade Monções,55,2,2,1,2500,962,3462,62.945454
3023,Bela Vista,40,1,1,1,2500,490,2990,74.75
3024,Lapa,64,2,1,1,1450,368,1818,28.40625
3025,Vila Mariana,45,1,1,0,1600,430,2030,45.11111
3026,Other,84,3,1,3,2600,1345,3945,46.964287
3027,Other,70,3,2,1,2500,530,3030,43.285713
3028,Other,95,3,3,2,4500,600,5100,53.68421
3029,Other,98,3,4,2,3400,532,3932,40.122448
3030,Vila Olímpia,65,1,2,2,5500,970,6470,99.53846
3031,Jardim Marajoara,107,3,4,2,4500,764,5264,49.196262
3032,Jardim Paulista,115,3,3,1,7000,0,7000,60.869564
3033,Vila Madalena,88,2,2,2,6500,1383,7883,89.579544
3034,Vila Nova Conceição,128,3,4,2,8500,1400,9900,77.34375
3035,Other,60,2,1,1,2600,343,2943,49.05
3036,Ipiranga,78,3,3,1,2200,606,2806,35.974358
3037,Other,50,1,2,1,1950,600,2550,51.0
3038,Ipiranga,142,4,3,4,3800,980,4780,33.661972
3039,Other,50,1,1,0,1300,171,1471,29.42
3040,Other,39,2,1,0,1000,120,1120,28.717949
3041,Vila Olímpia,54,1,1,1,1500,1250,2750,50.925926
3042,Jardim Paulista,50,1,1,1,1900,537,2437,48.74
3043,Other,58,2,1,2,4000,960,4960,85.51724
3044,Other,60,2,1,1,1650,370,2020,33.666668
3045,Santo Amaro,96,2,2,1,2500,800,3300,34.375
3046,Other,56,2,1,1,1300,365,1665,29.732143
3047,Moema,74,2,2,1,4850,880,5730,77.432434
3048,Other,50,2,1,0,990,750,1740,34.8
3049,Saúde,55,2,1,0,2300,687,2987,54.30909
3050,Perdizes,68,2,2,2,3000,1174,4174,61.382355
3051,Tatuapé,54,2,2,1,1700,700,2400,44.444443
3052,Other,50,2,1,1,1500,380,1880,37.6
3053,Brooklin,55,2,2,1,2700,962,3662,66.58182
3054,Ipiranga,111,3,4,2,5500,1000,6500,58.55856
3055,Other,138,4,4,2,6800,805,7605,55.108696
3056,Other,52,2,1,1,1200,520,1720,33.076923
3057,Other,60,2,2,2,2300,780,3080,51.333332
3058,Morumbi,48,1,2,1,1700,665,2365,49.270832
3059,Cerqueira César,64,2,2,1,3200,607,3807,59.484375
3060,Higienópolis,100,3,1,0,3500,355,3855,38.55
3061,Jardim Paulista,173,3,3,1,6900,1500,8400,48.554913
3062,Bela Vista,26,1,1,0,2300,0,2300,88.46154
3063,Brooklin,70,2,2,1,4500,120,4620,66.0
3064,Brooklin,70,2,2,1,4500,120,4620,66.0
3065,Vila Leopoldina,172,3,4,3,6200,1700,7900,45.930233
3066,Other,50,2,1,1,1300,402,1702,34.04
3067,Vila Mariana,120,2,2,0,3850,0,3850,32.083332
3068,Other,73,2,2,2,3800,550,4350,59.589043
3069,Vila Madalena,75,2,2,1,3500,932,4432,59.093334
3070,Other,117,3,3,3,2900,1317,4217,36.042736
3071,Vila Buarque,58,2,1,0,1990,690,2680,46.206898
3072,Jardim Paulista,55,1,1,1,2500,865,3365,61.18182
3073,Jardim Paulista,135,4,2,2,4100,1610,5710,42.296295
3074,Perdizes,60,2,2,1,2000,664,2664,44.4
3075,Jardim Paulista,50,1,1,1,3545,1380,4925,98.5
3076,Other,47,2,1,1,1300,650,1950,41.48936
3077,Bela Vista,66,2,2,1,4800,600,5400,81.818184
3078,Perdizes,40,1,1,1,1650,922,2572,64.3
3079,Vila Nova Conceição,71,2,2,2,4000,1300,5300,74.64789
3080,Campo Belo,75,2,2,2,4500,1080,5580,74.4
3081,Barra Funda,100,3,2,0,2200,0,2200,22.0
3082,Perdizes,100,3,2,1,1800,1597,3397,33.97
3083,Other,110,3,3,2,3900,1040,4940,44.909092
3084,Other,92,3,2,2,2590,1082,3672,39.913044
3085,Other,67,3,2,1,1950,0,1950,29.104477
3086,Vila Olímpia,50,1,2,0,2300,537,2837,56.74
3087,Other,42,2,1,1,1395,250,1645,39.166668
3088,Other,76,3,3,2,1850,816,2666,35.07895
3089,Vila Olímpia,74,2,1,1,8400,850,9250,125.0
3090,Pinheiros,60,2,2,1,4900,1100,6000,100.0
3091,Pinheiros,135,3,4,2,7500,1520,9020,66.81481
3092,Mirandópolis,56,2,2,1,2800,520,3320,59.285713
3093,Higienópolis,64,2,2,1,2100,608,2708,42.3125
3094,Pinheiros,75,2,2,2,3400,850,4250,56.666668
3095,Santo Amaro,34,2,1,1,1600,400,2000,58.82353
3096,Other,68,2,2,2,1700,840,2540,37.35294
3097,Other,68,2,2,2,1700,840,2540,37.35294
3098,Other,50,2,1,1,1500,544,2044,40.88
3099,Vila Clementino,38,1,1,1,1500,500,2000,52.63158
3100,Moema,35,1,1,1,2400,850,3250,92.85714
3101,Other,52,2,1,1,1400,0,1400,26.923077
3102,Morumbi,64,2,2,1,2000,650,2650,41.40625
3103,Saúde,120,4,3,2,4600,1136,5736,47.8
3104,Vila Guarani,59,2,2,1,1800,699,2499,42.35593
3105,Chácara Santo Antônio,65,2,1,0,3200,650,3850,59.23077
3106,Jardim Marajoara,50,2,1,1,1600,480,2080,41.6
3107,Brás,58,2,1,1,1200,452,1652,28.48276
3108,Pinheiros,74,2,3,1,3000,1237,4237,57.256756
3109,Other,57,2,2,1,2500,630,3130,54.91228
3110,Other,40,2,1,0,1100,319,1419,35.475
3111,Lapa,103,3,3,2,2150,858,3008,29.203884
3112,Other,49,2,1,1,1500,270,1770,36.122448
3113,Other,60,2,1,1,1400,835,2235,37.25
3114,Jardim Paulista,60,1,1,1,1200,1031,2231,37.183334
3115,Other,44,1,1,1,2600,664,3264,74.181816
3116,Vila Clementino,77,2,2,1,2600,830,3430,44.545456
3117,Campo Belo,50,1,2,1,2800,725,3525,70.5
3118,Jardim Paulista,120,3,2,1,4000,1380,5380,44.833332
3119,Other,98,3,3,2,2000,1050,3050,31.12245
3120,Campo Belo,60,2,1,1,5500,860,6360,106.0
3121,Moema,42,1,2,1,1800,560,2360,56.190475
3122,Cambuci,26,1,1,0,1100,150,1250,48.076923
3123,Aclimação,55,1,1,1,1600,594,2194,39.890907
3124,Other,145,3,3,2,3700,1500,5200,35.86207
3125,Vila Leopoldina,78,3,2,1,3300,580,3880,49.74359
3126,Brooklin,38,1,1,1,3000,550,3550,93.42105
3127,Higienópolis,70,1,1,0,1900,700,2600,37.142857
3128,Consolação,32,1,1,0,1300,310,1610,50.3125
3129,Other,59,2,1,1,2200,800,3000,50.847458
3130,Ipiranga,86,3,3,1,2800,1000,3800,44.186047
3131,Perdizes,60,2,2,1,2700,620,3320,55.333332
3132,Other,60,3,1,2,1900,750,2650,44.166668
3133,Other,105,2,3,2,2950,1221,4171,39.72381
3134,Other,160,4,6,3,3500,1600,5100,31.875
3135,Moema,45,1,1,1,3400,1000,4400,97.77778
3136,Vila Clementino,45,1,2,1,2500,750,3250,72.22222
3137,Other,52,2,1,1,1250,671,1921,36.942307
3138,Other,70,3,2,1,1800,377,2177,31.1
3139,Moema,51,1,1,1,4950,480,5430,106.47059
3140,Brooklin,50,2,2,1,2500,580,3080,61.6
3141,Vila Mariana,65,2,2,1,2500,744,3244,49.907692
3142,Other,128,3,2,2,4000,1200,5200,40.625
3143,Other,113,3,2,2,4500,877,5377,47.584072
3144,Vila Buarque,40,1,1,1,2200,515,2715,67.875
3145,Jardim Paulista,35,1,1,1,2300,500,2800,80.0
3146,Pompeia,83,3,3,2,3800,1100,4900,59.036144
3147,Vila Leopoldina,130,3,4,2,6200,1160,7360,56.615383
3148,Brás,80,2,1,0,1300,200,1500,18.75
3149,Bela Vista,45,1,1,1,1660,602,2262,50.266666
3150,Other,46,1,1,0,1300,301,1601,34.804348
3151,Bela Vista,75,2,2,2,5000,700,5700,76.0
3152,Ipiranga,90,3,2,1,2350,0,2350,26.11111
3153,Liberdade,62,1,1,0,1190,375,1565,25.241936
3154,Móoca,88,3,2,1,2600,680,3280,37.272728
3155,Móoca,48,2,1,1,1750,400,2150,44.791668
3156,Campo Belo,50,1,1,1,2950,570,3520,70.4
3157,Saúde,28,1,1,0,1600,120,1720,61.42857
3158,Perdizes,40,1,1,1,2000,890,2890,72.25
3159,Santa Cecília,90,2,2,1,2600,1000,3600,40.0
3160,Vila Andrade,94,2,3,2,3500,700,4200,44.68085
3161,Vila Olímpia,72,3,2,2,3300,1246,4546,63.13889
3162,Pinheiros,140,3,3,1,5000,1300,6300,45.0
3163,Santana,39,1,1,1,1600,640,2240,57.435898
3164,Centro,75,1,1,0,1200,900,2100,28.0
3165,Aclimação,46,2,1,1,2250,400,2650,57.608696
3166,Pinheiros,135,3,3,1,4000,700,4700,34.814816
3167,Vila Olímpia,46,1,1,1,2800,750,3550,77.17391
3168,Bela Vista,60,2,1,2,2250,824,3074,51.233334
3169,Pinheiros,63,2,2,1,4700,990,5690,90.31746
3170,Ipiranga,50,1,1,1,2000,0,2000,40.0
3171,Pinheiros,90,2,2,2,6500,938,7438,82.64445
3172,Aclimação,65,2,2,2,4500,0,4500,69.23077
3173,Itaim Bibi,90,2,2,1,6500,1006,7506,83.4
3174,Other,47,1,1,1,2200,475,2675,56.914894
3175,Pinheiros,60,2,2,2,4500,830,5330,88.833336
3176,Pinheiros,30,1,1,1,3000,550,3550,118.333336
3177,Pinheiros,63,2,1,0,1699,635,2334,37.04762
3178,Vila Olímpia,98,2,1,2,5000,950,5950,60.714287
3179,Vila Clementino,57,2,2,1,3350,728,4078,71.54386
3180,Paraíso,66,2,1,1,2800,1129,3929,59.530304
3181,Mirandópolis,38,1,1,1,1000,943,1943,51.13158
3182,Móoca,64,2,2,1,2700,800,3500,54.6875
3183,Barra Funda,20,1,1,0,1050,0,1050,52.5
3184,Móoca,70,2,2,2,2500,850,3350,47.857143
3185,Pinheiros,70,2,2,2,4200,864,5064,72.34286
3186,Other,62,3,1,1,1850,520,2370,38.225807
3187,Vila Andrade,75,3,3,2,1800,900,2700,36.0
3188,Brás,70,3,2,1,2300,481,2781,39.728573
3189,Itaim Bibi,105,2,3,1,6000,1433,7433,70.790474
3190,Other,54,2,1,1,1300,270,1570,29.074074
3191,Tatuapé,35,1,1,0,1400,155,1555,44.42857
3192,Other,52,2,1,1,2300,391,2691,51.75
3193,Paraíso,45,1,1,1,2000,573,2573,57.177776
3194,Other,44,2,1,1,1000,0,1000,22.727272
3195,Pinheiros,60,2,2,1,4710,810,5520,92.0
3196,Pinheiros,42,2,1,1,2300,279,2579,61.404762
3197,Vila Olímpia,57,2,1,1,2500,1200,3700,64.91228
3198,Itaim Bibi,45,1,1,1,2500,1500,4000,88.888885
3199,Other,47,2,1,1,680,220,900,19.148935
3200,Other,57,2,3,1,2400,580,2980,52.2807
3201,Aclimação,176,4,4,3,8900,1400,10300,58.522728
3202,Perdizes,69,3,2,1,2500,867,3367,48.7971
3203,Itaim Bibi,98,2,3,1,4900,1174,6074,61.97959
3204,Vila Mascote,60,2,2,1,1800,650,2450,40.833332
3205,Other,30,1,1,0,900,150,1050,35.0
3206,Vila Leopoldina,35,1,1,0,1800,300,2100,60.0
3207,Vila Andrade,97,3,3,2,4000,1400,5400,55.670105
3208,Vila Olímpia,95,2,2,2,7900,1225,9125,96.052635
3209,Other,69,2,3,1,2200,1020,3220,46.666668
3210,Perdizes,60,2,3,2,2900,1170,4070,67.833336
3211,Bela Vista,65,2,1,1,2800,1060,3860,59.384617
3212,Other,50,2,2,1,1500,700,2200,44.0
3213,Brooklin,185,3,2,2,4685,1008,5693,30.772972
3214,Higienópolis,80,2,1,1,3500,685,4185,52.3125
3215,Vila Leopoldina,72,2,2,1,2600,800,3400,47.22222
3216,Other,60,2,2,1,3000,584,3584,59.733334
3217,Barra Funda,71,3,2,1,3300,625,3925,55.28169
3218,Moema,45,1,1,1,2100,481,2581,57.355556
3219,Other,67,3,1,1,2300,446,2746,40.985073
3220,Vila Mariana,58,2,2,1,2350,695,3045,52.5
3221,Pompeia,87,3,2,2,2600,1400,4000,45.977013
3222,Pompeia,87,3,2,2,2600,1400,4000,45.977013
3223,Other,48,2,1,1,1100,0,1100,22.916666
3224,Other,66,2,1,2,2750,715,3465,52.5
3225,Other,117,3,3,3,3500,1309,4809,41.102566
3226,Pinheiros,48,1,1,1,4063,957,5020,104.583336
3227,Jardim Marajoara,81,3,2,1,2700,700,3400,41.975307
3228,Barra Funda,40,1,1,1,2000,520,2520,63.0
3229,Vila Leopoldina,175,4,5,2,6500,1596,8096,46.262856
3230,Brás,55,2,1,1,1550,405,1955,35.545456
3231,Vila Andrade,134,2,2,2,4300,786,5086,37.955223
3232,Aclimação,167,3,2,1,3000,1150,4150,24.8503
3233,Cerqueira César,130,3,3,2,8000,980,8980,69.07692
3234,Bela Vista,80,2,1,0,1700,955,2655,33.1875
3235,Higienópolis,80,3,3,2,4700,1070,5770,72.125
3236,Other,63,2,2,2,3500,669,4169,66.17461
3237,Consolação,113,3,2,1,3600,1451,5051,44.699116
3238,Other,77,2,2,0,5650,800,6450,83.766235
3239,Itaim Bibi,55,2,1,1,2000,713,2713,49.327274
3240,Chácara Santo Antônio,93,2,2,2,5500,1650,7150,76.88172
3241,Brooklin,145,3,5,3,8999,1400,10399,71.71724
3242,Other,130,2,2,1,3300,790,4090,31.461538
3243,Other,75,3,2,1,1600,590,2190,29.2
3244,República,30,1,1,0,1800,395,2195,73.166664
3245,Brooklin,87,2,2,1,3200,644,3844,44.183907
3246,Vila Nova Conceição,60,2,1,1,5500,0,5500,91.666664
3247,Aclimação,50,1,1,1,1700,590,2290,45.8
3248,Vila Mariana,50,1,1,1,1700,982,2682,53.64
3249,Pinheiros,50,2,1,1,2500,800,3300,66.0
3250,Vila Leopoldina,87,3,2,2,3500,550,4050,46.551723
3251,Morumbi,120,3,3,2,3500,1100,4600,38.333332
3252,Other,110,3,3,2,2550,1200,3750,34.090908
3253,Paraíso,195,3,3,2,4800,1604,6404,32.841026
3254,Liberdade,70,3,2,0,1500,798,2298,32.82857
3255,Other,60,2,2,1,1700,412,2112,35.2
3256,Jaguaré,70,3,1,1,2800,442,3242,46.314285
3257,Other,105,3,2,2,4200,961,5161,49.15238
3258,Other,70,2,2,1,6000,0,6000,85.71429
3259,Chácara Santo Antônio,51,1,1,1,2990,875,3865,75.78432
3260,Campo Belo,35,1,1,1,3450,0,3450,98.57143
3261,Brooklin,86,3,2,2,3400,800,4200,48.837208
3262,Brás,50,2,1,1,1350,401,1751,35.02
3263,Móoca,70,3,1,1,1800,500,2300,32.857143
3264,Ipiranga,50,2,2,2,2200,860,3060,61.2
3265,Jardim Paulista,30,1,1,1,1200,798,1998,66.6
3266,Other,68,2,2,1,4700,800,5500,80.882355
3267,Bela Vista,96,3,2,0,2700,900,3600,37.5
3268,Vila Mariana,41,1,2,1,2000,490,2490,60.73171
3269,Vila Mariana,70,3,2,1,1850,730,2580,36.857143
3270,Pinheiros,30,1,1,0,2750,400,3150,105.0
3271,Morumbi,50,2,1,1,1750,450,2200,44.0
3272,Other,20,1,1,0,1250,0,1250,62.5
3273,Vila Andrade,100,3,2,2,2990,948,3938,39.38
3274,Other,51,1,1,1,3300,545,3845,75.39216
3275,Campo Belo,35,1,1,1,2600,610,3210,91.71429
3276,Jardim Paulista,32,1,1,1,1700,925,2625,82.03125
3277,Other,83,3,3,2,3800,1500,5300,63.855423
3278,Brooklin,70,2,1,1,4400,650,5050,72.14286
3279,Brooklin,85,1,2,2,6000,950,6950,81.76471
3280,Other,75,3,2,1,2000,925,2925,39.0
3281,Other,49,2,1,1,1250,565,1815,37.040817
3282,Moema,70,2,2,2,4800,790,5590,79.85714
3283,Campo Belo,40,1,1,1,1800,648,2448,61.2
3284,Bela Vista,48,1,1,1,1700,900,2600,54.166668
3285,Saúde,35,1,1,1,2400,460,2860,81.71429
3286,Moema,70,2,2,2,4500,850,5350,76.42857
3287,Other,82,1,2,0,1000,450,1450,17.682926
3288,Santo Amaro,100,3,2,1,2999,920,3919,39.19
3289,Cerqueira César,40,1,1,1,1900,774,2674,66.85
3290,Vila Mariana,95,2,2,2,6200,1150,7350,77.36842
3291,Other,52,2,1,1,1250,0,1250,24.038462
3292,Barra Funda,82,3,1,1,3800,645,4445,54.207317
3293,Moema,75,2,2,1,5900,780,6680,89.066666
3294,Itaim Bibi,77,1,2,2,8000,1700,9700,125.97403
3295,Itaim Bibi,56,2,2,1,6500,541,7041,125.73214
3296,Other,24,1,1,0,1700,370,2070,86.25
3297,Vila Mascote,93,3,3,2,4500,0,4500,48.387096
3298,Bela Vista,45,2,1,1,2700,431,3131,69.577774
3299,Other,105,3,1,1,3000,1185,4185,39.857143
3300,Other,35,1,1,1,900,440,1340,38.285713
3301,Bela Vista,14,1,1,0,1656,158,1814,129.57143
3302,Other,62,2,1,1,1000,350,1350,21.774193
3303,Barra Funda,57,2,2,2,2500,570,3070,53.85965
3304,Bela Vista,42,1,1,1,2400,415,2815,67.02381
3305,Centro,85,2,2,0,2500,500,3000,35.294117
3306,Mirandópolis,98,3,3,2,4500,893,5393,55.030613
3307,Other,40,1,1,0,790,0,790,19.75
3308,Pinheiros,50,2,1,1,3200,750,3950,79.0
3309,Moema,80,2,2,1,3485,911,4396,54.95
3310,Pinheiros,62,2,2,1,3500,0,3500,56.451614
3311,Mirandópolis,60,3,2,2,1800,430,2230,37.166668
3312,Pompeia,75,3,2,2,3200,1100,4300,57.333332
3313,Other,63,2,1,1,1700,925,2625,41.666668
3314,Móoca,34,1,1,0,2100,270,2370,69.70588
3315,Vila Mascote,86,3,4,2,2600,1054,3654,42.488373
3316,Higienópolis,60,1,1,1,2200,550,2750,45.833332
3317,Tatuapé,26,1,1,1,1700,480,2180,83.84615
3318,Jardins,140,3,3,2,4500,1339,5839,41.70714
3319,Brooklin,48,1,1,1,3500,800,4300,89.583336
3320,Other,35,1,1,1,1950,695,2645,75.57143
3321,Consolação,40,1,1,1,2500,0,2500,62.5
3322,Lapa,70,2,1,1,1800,500,2300,32.857143
3323,Campo Belo,49,1,1,1,3000,600,3600,73.46939
3324,Moema,95,3,4,2,4200,1130,5330,56.105263
3325,Jardim América,27,1,1,1,2200,461,2661,98.55556
3326,Pinheiros,40,1,1,1,2200,974,3174,79.35
3327,Other,23,1,1,0,2250,380,2630,114.347824
3328,Chácara Santo Antônio,95,2,2,2,6500,700,7200,75.789474
3329,Bela Vista,28,1,1,0,1400,545,1945,69.46429
3330,Other,47,1,1,1,3000,500,3500,74.46809
3331,Other,36,2,2,0,1200,190,1390,38.61111
3332,Campo Belo,48,1,1,1,3400,699,4099,85.395836
3333,Other,72,3,2,2,3200,730,3930,54.583332
3334,Móoca,65,2,2,1,2300,660,2960,45.53846
3335,Saúde,53,2,2,1,1700,380,2080,39.24528
3336,Ipiranga,67,2,1,1,2600,585,3185,47.53731
3337,Vila Olímpia,75,3,3,2,3000,1200,4200,56.0
3338,República,23,1,1,0,1150,248,1398,60.782608
3339,Bela Vista,80,2,2,1,3800,930,4730,59.125
3340,Other,51,2,1,1,1265,340,1605,31.470589
3341,Paraíso,110,3,2,1,2800,1348,4148,37.70909
3342,Other,60,2,2,1,1040,544,1584,26.4
3343,Vila Mariana,51,2,2,1,1950,750,2700,52.941177
3344,Pinheiros,45,1,2,1,2600,786,3386,75.244446
3345,Vila Olímpia,67,2,2,1,3000,867,3867,57.71642
3346,Bela Vista,40,1,1,1,1000,437,1437,35.925
3347,Vila Buarque,45,2,1,1,1500,500,2000,44.444443
3348,Pinheiros,71,2,2,1,5000,584,5584,78.64789
3349,Other,57,3,1,1,1470,400,1870,32.80702
3350,Paraíso,76,3,2,1,3200,750,3950,51.973682
3351,Vila Olímpia,110,3,3,1,3300,950,4250,38.636364
3352,Saúde,98,3,3,2,3000,1130,4130,42.142857
3353,Other,77,2,2,2,3100,0,3100,40.25974
3354,Vila Mariana,90,3,2,1,2400,910,3310,36.77778
3355,Cambuci,40,2,1,0,1700,320,2020,50.5
3356,Other,67,3,2,1,1900,600,2500,37.313435
3357,Other,74,2,3,2,5500,880,6380,86.21622
3358,Jardim Paulista,44,1,1,1,4200,880,5080,115.454544
3359,Vila Madalena,70,2,2,1,4000,830,4830,69.0
3360,Ipiranga,80,2,2,1,2000,260,2260,28.25
3361,Vila Mariana,73,2,1,2,4000,0,4000,54.79452
3362,Other,37,1,1,1,1500,140,1640,44.324326
3363,Ipiranga,59,2,2,1,2200,866,3066,51.966103
3364,Brooklin,68,2,3,1,2664,1031,3695,54.338234
3365,Other,30,1,1,0,1150,150,1300,43.333332
3366,Mirandópolis,63,2,2,2,3800,1050,4850,76.98412
3367,Other,30,1,1,0,500,0,500,16.666666
3368,Perdizes,50,1,1,1,2200,650,2850,57.0
3369,Itaim Bibi,55,2,1,1,3000,0,3000,54.545456
3370,Other,68,2,2,1,2200,500,2700,39.705883
3371,Other,76,3,1,1,1800,840,2640,34.736843
3372,Other,60,2,2,2,3600,780,4380,73.0
3373,Paraíso,120,3,4,2,6900,1500,8400,70.0
3374,Other,82,3,2,1,1400,950,2350,28.658537
3375,Bela Vista,56,1,2,1,4200,933,5133,91.66071
3376,Bela Vista,45,1,1,1,2199,602,2801,62.244446
3377,Other,40,1,1,1,640,360,1000,25.0
3378,Tatuapé,80,2,2,0,1400,230,1630,20.375
3379,Other,140,3,3,2,3800,1400,5200,37.142857
3380,Vila Clementino,55,2,1,0,2200,690,2890,52.545456
3381,Lapa,55,2,2,1,2300,410,2710,49.272728
3382,Saúde,60,2,1,1,2250,750,3000,50.0
3383,Vila Madalena,45,2,1,1,2300,336,2636,58.577778
3384,Butantã,67,2,1,1,3200,637,3837,57.268658
3385,Pinheiros,140,2,4,2,8000,1420,9420,67.28571
3386,Consolação,44,1,1,0,1900,437,2337,53.113636
3387,Vila Mariana,72,2,3,2,4600,1266,5866,81.47222
3388,Campo Belo,50,1,2,2,4200,685,4885,97.7
3389,Pinheiros,95,3,4,2,5500,1326,6826,71.85263
3390,Other,33,1,1,0,1100,70,1170,35.454544
3391,Móoca,50,2,1,1,1550,607,2157,43.14
3392,Vila Mariana,38,1,1,1,1500,650,2150,56.57895
3393,Vila Olímpia,69,2,2,1,3000,940,3940,57.101448
3394,Pompeia,70,2,1,0,1900,100,2000,28.571428
3395,Vila Mariana,72,2,1,1,2300,820,3120,43.333332
3396,Consolação,60,1,1,1,2000,595,2595,43.25
3397,Vila Olímpia,110,3,3,0,3800,1050,4850,44.090908
3398,Other,55,2,1,1,1700,550,2250,40.909092
3399,Santa Cecília,50,2,1,1,1900,502,2402,48.04
3400,Cambuci,50,2,1,1,2000,800,2800,56.0
3401,Pinheiros,40,1,1,1,3610,860,4470,111.75
3402,Other,83,3,3,2,2200,795,2995,36.08434
3403,Vila Mascote,84,3,3,2,2300,1142,3442,40.97619
3404,Jardim Paulista,101,2,2,1,6000,1277,7277,72.04951
3405,Pinheiros,60,2,1,0,2000,485,2485,41.416668
3406,Other,42,2,1,1,1350,0,1350,32.142857
3407,Vila Nova Conceição,71,2,1,1,3000,698,3698,52.084507
3408,Ipiranga,40,1,1,1,1900,502,2402,60.05
3409,Other,63,1,1,1,4150,620,4770,75.71429
3410,Other,63,1,1,1,4150,620,4770,75.71429
3411,Other,64,2,2,2,2270,970,3240,50.625
3412,Vila Clementino,51,2,1,1,2900,530,3430,67.254906
3413,Liberdade,72,3,2,2,3000,1100,4100,56.944443
3414,Other,55,2,1,1,1300,370,1670,30.363636
3415,Itaim Bibi,40,1,1,1,2400,0,2400,60.0
3416,Cerqueira César,24,1,1,1,1700,620,2320,96.666664
3417,Brooklin,45,1,1,1,3999,586,4585,101.888885
3418,Santa Cecília,97,2,2,1,2200,1016,3216,33.15464
3419,Vila Mariana,93,3,2,0,3100,450,3550,38.172043
3420,Barra Funda,33,1,1,1,1850,510,2360,71.51515
3421,Centro,26,1,1,0,1650,350,2000,76.92308
3422,Brooklin,96,3,2,2,3900,1391,5291,55.114582
3423,Other,142,3,4,3,2900,1600,4500,31.690142
3424,Other,54,2,1,1,1200,400,1600,29.62963
3425,Pinheiros,51,2,1,1,2500,658,3158,61.92157
3426,Moema,50,1,1,1,2100,860,2960,59.2
3427,Other,50,2,1,0,850,0,850,17.0
3428,Bela Vista,50,2,2,1,3400,550,3950,79.0
3429,Santa Cecília,40,1,1,1,1400,518,1918,47.95
3430,Santa Cecília,98,3,3,2,4500,1047,5547,56.60204
3431,Other,69,2,2,1,4700,600,5300,76.81159
3432,Other,49,2,1,1,1300,658,1958,39.959183
3433,Higienópolis,72,2,2,0,2500,473,2973,41.291668
3434,Consolação,43,1,1,1,1700,570,2270,52.7907
3435,Vila Mariana,100,2,2,1,2500,800,3300,33.0
3436,Other,60,2,2,1,2150,460,2610,43.5
3437,Brooklin,100,2,2,1,6750,990,7740,77.4
3438,Pompeia,53,2,1,1,2000,570,2570,48.490566
3439,Other,50,2,1,1,1200,327,1527,30.54
3440,Vila Nova Conceição,40,1,1,1,3400,900,4300,107.5
3441,Consolação,60,2,1,0,2000,462,2462,41.033333
3442,Jardins,173,3,3,1,4500,1600,6100,35.260117
3443,Other,37,1,1,1,1900,540,2440,65.945946
3444,Jaguaré,84,3,2,1,1500,616,2116,25.190475
3445,Saúde,75,2,2,1,1600,834,2434,32.453335
3446,Jardim América,80,2,2,1,3000,706,3706,46.325
3447,Other,30,1,1,0,1400,0,1400,46.666668
3448,Jardim Paulista,35,1,1,1,1800,509,2309,65.97143
3449,Other,80,3,2,2,2800,741,3541,44.2625
3450,Barra Funda,63,2,2,1,2500,637,3137,49.79365
3451,Ipiranga,100,3,1,2,2000,1300,3300,33.0
3452,Consolação,60,1,2,0,1500,430,1930,32.166668
3453,Barra Funda,58,2,2,0,2300,450,2750,47.41379
3454,Tatuapé,65,2,2,2,2200,575,2775,42.692307
3455,Pinheiros,44,1,1,1,3500,600,4100,93.181816
3456,Other,40,1,1,0,650,0,650,16.25
3457,Vila Madalena,67,2,1,2,6000,952,6952,103.76119
3458,Vila Mariana,72,1,1,0,1400,230,1630,22.63889
3459,Jardins,74,2,2,1,4200,692,4892,66.10811
3460,Butantã,74,3,2,2,2200,690,2890,39.054054
3461,Brooklin,124,3,4,3,6500,1275,7775,62.701614
3462,Cambuci,80,2,2,0,1500,310,1810,22.625
3463,Other,68,3,1,1,2300,800,3100,45.588234
3464,Paraíso,92,3,3,1,3100,1250,4350,47.282608
3465,Lapa,48,2,1,1,1950,365,2315,48.229168
3466,Vila Clementino,40,1,1,1,2300,450,2750,68.75
3467,Perdizes,65,2,2,2,3100,850,3950,60.76923
3468,Bela Vista,100,2,2,1,2100,850,2950,29.5
3469,Ipiranga,141,3,5,3,6100,1466,7566,53.659573
3470,Paraíso,100,2,1,1,4000,950,4950,49.5
3471,Butantã,45,2,1,0,950,0,950,21.11111
3472,Other,55,2,2,1,2490,565,3055,55.545456
3473,Other,43,2,1,0,1590,185,1775,41.279068
3474,Brás,55,2,1,1,1400,470,1870,34.0
3475,Other,111,3,4,2,4500,1300,5800,52.25225
3476,Jardim Marajoara,95,3,1,2,3650,847,4497,47.33684
3477,Pompeia,48,1,1,1,2484,650,3134,65.291664
3478,Vila Guarani,40,1,1,1,1500,406,1906,47.65
3479,Bela Vista,82,2,2,2,2400,484,2884,35.17073
3480,Other,49,2,1,1,1200,485,1685,34.387756
3481,Vila Mariana,60,2,2,1,2400,1100,3500,58.333332
3482,Santana,104,3,4,2,2300,1316,3616,34.76923
3483,Other,73,2,2,2,2950,850,3800,52.054794
3484,Higienópolis,75,2,3,1,3200,681,3881,51.746666
3485,Vila Clementino,99,2,3,2,4600,966,5566,56.22222
3486,Other,60,2,1,1,2000,694,2694,44.9
3487,Jardim Paulista,65,1,2,2,4900,940,5840,89.84615
3488,Cambuci,110,3,3,2,3500,1500,5000,45.454544
3489,Pinheiros,70,3,3,1,2700,1032,3732,53.314285
3490,Paraíso,57,1,1,1,1350,345,1695,29.736841
3491,Bela Vista,45,1,1,1,2200,705,2905,64.55556
3492,Other,40,1,1,1,2200,630,2830,70.75
3493,Saúde,68,3,2,1,2100,698,2798,41.14706
3494,Saúde,74,3,2,1,2200,700,2900,39.18919
3495,Barra Funda,93,3,3,2,2600,750,3350,36.021507
3496,Santana,34,1,1,1,2000,500,2500,73.52941
3497,Bela Vista,50,2,1,0,2500,536,3036,60.72
3498,Moema,55,2,2,1,2480,520,3000,54.545456
3499,Pompeia,36,1,1,1,2200,530,2730,75.833336
3500,Vila Prudente,48,2,1,1,2000,450,2450,51.041668
3501,Moema,50,1,2,1,2742,600,3342,66.84
3502,Vila Guarani,55,2,1,1,1950,754,2704,49.163635
3503,Santana,102,3,4,2,2000,1300,3300,32.35294
3504,Santo Amaro,55,1,2,1,3800,850,4650,84.545456
3505,Pompeia,41,1,1,1,2100,594,2694,65.70731
3506,Other,63,2,3,2,2900,984,3884,61.650795
3507,Perdizes,62,2,2,1,4600,750,5350,86.29032
3508,Morumbi,55,2,2,1,1500,750,2250,40.909092
3509,Butantã,72,2,2,1,2000,1000,3000,41.666668
3510,Vila Leopoldina,83,3,3,2,3300,950,4250,51.20482
3511,Tatuapé,50,2,1,1,1420,291,1711,34.22
3512,Ipiranga,10,1,1,0,950,0,950,95.0
3513,Pinheiros,25,1,1,0,2800,220,3020,120.8
3514,Pompeia,60,2,2,1,2400,896,3296,54.933334
3515,Bela Vista,35,1,1,1,2200,435,2635,75.28571
3516,Vila Mariana,31,1,1,1,2420,528,2948,95.09677
3517,Other,105,2,3,1,3500,830,4330,41.238094
3518,Other,70,3,2,2,2000,890,2890,41.285713
3519,Moema,90,3,3,2,3600,1010,4610,51.22222
3520,Jardim Paulista,79,3,3,1,3500,862,4362,55.21519
3521,Other,58,3,2,0,1800,527,2327,40.12069
3522,Morumbi,61,2,2,1,3450,10,3460,56.72131
3523,Other,168,4,4,3,7000,1250,8250,49.107143
3524,Vila Leopoldina,73,2,3,1,2550,790,3340,45.753426
3525,Other,54,2,1,1,1900,426,2326,43.074074
3526,Saúde,87,3,2,1,2300,565,2865,32.931034
3527,Other,50,1,1,1,1900,600,2500,50.0
3528,Cidade Monções,41,1,1,1,3000,620,3620,88.29269
3529,Vila Olímpia,65,2,2,1,3000,1050,4050,62.307693
3530,Aclimação,70,2,1,1,1800,600,2400,34.285713
3531,Other,128,3,3,2,3000,900,3900,30.46875
3532,Vila Olímpia,48,1,1,1,3200,900,4100,85.416664
3533,Vila Olímpia,56,2,1,1,4500,720,5220,93.21429
3534,Aclimação,37,1,1,1,2260,530,2790,75.4054
3535,Itaim Bibi,60,2,2,1,3000,938,3938,65.63333
3536,Itaim Bibi,60,2,2,1,3000,938,3938,65.63333
3537,Centro,48,1,2,1,1900,550,2450,51.041668
3538,Vila Mascote,150,3,2,3,3000,1500,4500,30.0
3539,Brooklin,52,1,2,1,3600,478,4078,78.42308
3540,Vila Andrade,50,2,1,1,2000,350,2350,47.0
3541,Vila Mariana,120,3,1,2,4600,700,5300,44.166668
3542,Higienópolis,130,3,2,2,3800,1325,5125,39.423077
3543,Campo Belo,35,1,1,1,1752,478,2230,63.714287
3544,Vila Prudente,48,2,1,1,2100,0,2100,43.75
3545,Santa Cecília,125,2,2,2,2500,1000,3500,28.0
3546,Vila Mariana,137,2,2,1,1900,560,2460,17.956203
3547,Tatuapé,54,2,2,2,3000,620,3620,67.03704
3548,Consolação,75,2,1,1,2500,749,3249,43.32
3549,Brooklin,45,1,1,1,2000,870,2870,63.77778
3550,Bela Vista,62,2,2,1,4500,760,5260,84.83871
3551,Paraíso,65,2,2,1,2000,842,2842,43.723076
3552,Itaim Bibi,50,1,2,1,5000,719,5719,114.38
3553,Pinheiros,24,1,1,1,1600,500,2100,87.5
3554,Moema,103,3,2,1,4800,968,5768,56.0
3555,Ipiranga,89,3,2,0,1700,0,1700,19.101124
3556,Perdizes,80,3,2,2,3000,1340,4340,54.25
3557,Brooklin,85,3,2,2,7300,900,8200,96.47059
3558,Vila Mariana,70,2,2,1,1600,913,2513,35.9
3559,Other,32,1,1,0,790,0,790,24.6875
3560,Pompeia,45,1,1,1,2000,523,2523,56.066666
3561,Tatuapé,55,2,2,1,1980,460,2440,44.363636
3562,Bela Vista,42,1,1,1,2500,650,3150,75.0
3563,Vila Nova Conceição,70,1,1,1,6300,1600,7900,112.85714
3564,Ipiranga,76,2,1,1,1500,343,1843,24.25
3565,Vila Madalena,134,3,2,1,3100,527,3627,27.067163
3566,Vila Buarque,32,1,1,0,1000,408,1408,44.0
3567,Other,40,1,1,1,3300,586,3886,97.15
3568,Moema,78,1,2,1,3492,1160,4652,59.641026
3569,Other,38,1,1,1,1750,525,2275,59.86842
3570,Other,50,1,1,1,1550,790,2340,46.8
3571,Other,60,2,1,1,1600,438,2038,33.966667
3572,Tatuapé,85,3,4,2,3500,619,4119,48.458824
3573,Jardim Paulista,56,1,2,2,3080,1550,4630,82.67857
3574,Other,120,2,4,2,2700,1544,4244,35.366665
3575,Aclimação,40,1,1,1,1900,558,2458,61.45
3576,Consolação,30,1,1,0,1550,550,2100,70.0
3577,Tatuapé,30,1,1,1,1600,328,1928,64.26667
3578,Other,70,3,1,0,1300,0,1300,18.571428
3579,Pinheiros,70,2,2,0,2500,644,3144,44.914288
3580,Chácara Santo Antônio,105,3,2,1,2985,780,3765,35.857143
3581,Chácara Santo Antônio,70,2,2,1,3300,735,4035,57.642857
3582,Brooklin,96,3,2,2,3800,1300,5100,53.125
3583,Other,40,1,1,0,1300,50,1350,33.75
3584,Mirandópolis,36,1,2,1,1600,450,2050,56.944443
3585,Jardins,95,2,2,1,2300,760,3060,32.210526
3586,Brooklin,90,2,2,2,4800,952,5752,63.91111
3587,Campo Belo,37,1,1,1,2000,538,2538,68.5946
3588,Centro,72,2,2,0,1850,500,2350,32.63889
3589,Higienópolis,56,2,2,1,2400,650,3050,54.464287
3590,Chácara Santo Antônio,70,2,2,1,3200,735,3935,56.214287
3591,Moema,130,3,4,1,5000,1347,6347,48.82308
3592,Perdizes,70,2,4,2,3300,1229,4529,64.7
3593,Jardim Paulista,98,3,2,1,4400,1133,5533,56.459183
3594,Santo Amaro,53,1,2,1,3700,920,4620,87.169815
3595,Moema,15,1,1,0,1590,295,1885,125.666664
3596,Vila Buarque,77,3,2,1,2100,830,2930,38.05195
3597,Santa Cecília,56,2,1,1,3000,680,3680,65.71429
3598,Aclimação,48,1,1,1,2000,426,2426,50.541668
3599,Barra Funda,132,3,4,2,6500,1000,7500,56.81818
3600,Vila Olímpia,103,2,4,1,3750,970,4720,45.82524
3601,Consolação,25,1,1,0,1800,276,2076,83.04
3602,Cerqueira César,120,2,1,1,3500,1197,4697,39.141666
3603,Other,81,2,2,1,3600,850,4450,54.93827
3604,Other,67,1,1,1,1600,850,2450,36.567165
3605,Jabaquara,65,3,2,1,2700,580,3280,50.46154
3606,Itaim Bibi,98,3,2,1,3800,1298,5098,52.02041
3607,Aclimação,37,1,1,1,2260,530,2790,75.4054
3608,Other,62,2,1,1,1300,600,1900,30.64516
3609,Other,76,2,1,0,2000,467,2467,32.460526
3610,Santo Amaro,48,2,2,1,2200,570,2770,57.708332
3611,Brás,50,2,1,1,1300,350,1650,33.0
3612,Pompeia,65,2,2,2,3400,700,4100,63.076923
3613,Itaim Bibi,87,2,3,1,6000,1080,7080,81.37931
3614,Indianópolis,82,2,2,1,2800,940,3740,45.609756
3615,Morumbi,40,1,1,1,1050,645,1695,42.375
3616,Lapa,70,2,2,2,2800,500,3300,47.142857
3617,Vila Guarani,42,1,1,1,2000,0,2000,47.61905
3618,Cambuci,81,3,2,1,2750,705,3455,42.65432
3619,Santana,60,3,1,0,1600,200,1800,30.0
3620,Santana,123,3,2,2,4500,994,5494,44.666668
3621,Other,42,2,1,1,2000,330,2330,55.47619
3622,Other,50,2,2,1,1500,100,1600,32.0
3623,Lapa,55,2,2,1,2000,410,2410,43.81818
3624,Saúde,50,2,1,1,1500,366,1866,37.32
3625,Other,64,2,2,1,2500,400,2900,45.3125
3626,Other,65,3,1,1,1500,510,2010,30.923077
3627,Itaim Bibi,131,3,3,1,5000,945,5945,45.38168
3628,Vila Mascote,50,3,2,1,2500,321,2821,56.42
3629,Jardim Paulista,38,1,1,0,1600,130,1730,45.526318
3630,Jardim América,70,2,2,1,2500,1700,4200,60.0
3631,Santa Cecília,43,1,1,1,2240,554,2794,64.976746
3632,Bela Vista,32,1,1,1,1400,831,2231,69.71875
3633,Móoca,50,2,1,1,1500,350,1850,37.0
3634,Other,48,2,1,1,1300,440,1740,36.25
3635,Morumbi,57,2,1,1,1870,720,2590,45.438595
3636,Saúde,30,1,1,1,1700,0,1700,56.666668
3637,Vila Leopoldina,130,3,4,2,6000,340,6340,48.76923
3638,Vila Clementino,42,1,1,1,1600,550,2150,51.190475
3639,Vila Olímpia,70,1,2,1,4550,1200,5750,82.14286
3640,Pinheiros,102,3,3,2,4800,1370,6170,60.490196
3641,Other,47,2,1,1,1300,425,1725,36.70213
3642,Other,51,2,1,1,1300,0,1300,25.490196
3643,Pinheiros,75,3,2,1,3500,1100,4600,61.333332
3644,Brooklin,22,1,1,0,2400,300,2700,122.72727
3645,Chácara Santo Antônio,95,2,3,2,6200,1000,7200,75.789474
3646,Vila Leopoldina,70,2,1,1,3000,901,3901,55.728573
3647,Other,61,3,1,1,2500,607,3107,50.934425
3648,Moema,76,2,3,2,6400,1250,7650,100.6579
3649,Other,70,1,1,1,3500,800,4300,61.42857
3650,Vila Olímpia,65,1,2,1,5800,1200,7000,107.69231
3651,Ipiranga,85,3,3,2,3500,563,4063,47.8
3652,Jardim Paulista,60,1,2,1,3500,650,4150,69.166664
3653,Barra Funda,101,2,2,2,3800,1060,4860,48.118813
3654,Vila Guarani,55,2,1,1,1500,785,2285,41.545456
3655,Vila Mariana,73,3,3,2,4100,500,4600,63.0137
3656,Santo Amaro,70,2,1,0,1410,326,1736,24.8
3657,Brooklin,80,2,1,1,1800,1492,3292,41.15
3658,Centro,40,1,1,0,1100,300,1400,35.0
3659,Vila Prudente,44,2,1,1,1400,305,1705,38.75
3660,Other,48,2,1,1,1300,316,1616,33.666668
3661,Vila Olímpia,93,2,3,2,7500,1250,8750,94.08602
3662,Santana,86,2,1,1,1850,686,2536,29.488373
3663,Campo Belo,50,1,1,0,3200,587,3787,75.74
3664,Bela Vista,34,1,1,1,2400,600,3000,88.23529
3665,Vila Mariana,94,3,2,1,3000,750,3750,39.893616
3666,Paraíso,157,3,2,1,4300,1325,5625,35.828026
3667,Higienópolis,27,1,1,0,1650,242,1892,70.07407
3668,Other,49,2,1,1,1690,430,2120,43.265305
3669,Centro,54,2,1,0,1300,329,1629,30.166666
3670,Vila Clementino,68,2,2,1,4200,0,4200,61.764706
3671,Pinheiros,35,1,1,1,2800,0,2800,80.0
3672,Brooklin,52,1,1,1,3200,600,3800,73.07692
3673,Brooklin,70,2,2,1,4922,600,5522,78.88571
3674,Barra Funda,85,1,1,0,1590,365,1955,23.0
3675,Other,46,2,1,1,1390,0,1390,30.217392
3676,Jardim Marajoara,93,3,2,1,2400,870,3270,35.16129
3677,Liberdade,55,2,1,0,1400,564,1964,35.70909
3678,Brooklin,58,2,2,1,3400,710,4110,70.86207
3679,Vila Mariana,75,2,2,1,5500,670,6170,82.26667
3680,Brooklin,84,1,2,2,6000,901,6901,82.15476
3681,Santo Amaro,73,1,1,0,1250,485,1735,23.767124
3682,Other,32,2,1,0,1200,190,1390,43.4375
3683,Pinheiros,75,2,2,2,2800,1100,3900,52.0
3684,Aclimação,38,1,1,1,4000,600,4600,121.052635
3685,Jaguaré,82,2,2,1,2400,620,3020,36.82927
3686,Pinheiros,47,1,1,1,3450,740,4190,89.14893
3687,Bela Vista,33,1,1,1,2900,585,3485,105.606064
3688,Aclimação,115,3,3,2,1900,904,2804,24.382608
3689,Barra Funda,71,3,2,2,3500,826,4326,60.929577
3690,Móoca,50,2,1,1,2200,350,2550,51.0
3691,Bela Vista,55,1,1,0,1100,1318,2418,43.963634
3692,Other,45,1,1,1,2200,380,2580,57.333332
3693,Vila Mariana,50,1,1,0,1900,440,2340,46.8
3694,Other,51,2,1,1,1500,377,1877,36.80392
3695,Vila Clementino,135,4,4,2,4500,1393,5893,43.65185
3696,Jaguaré,70,3,2,1,2800,550,3350,47.857143
3697,Other,34,1,1,1,2500,830,3330,97.94118
3698,Brooklin,72,2,2,2,4400,700,5100,70.833336
3699,Bela Vista,100,3,3,2,3200,1350,4550,45.5
3700,Vila Mariana,68,2,2,1,2300,605,2905,42.72059
3701,Moema,34,1,1,0,3060,600,3660,107.64706
3702,Vila Leopoldina,56,2,1,1,2600,550,3150,56.25
3703,Perdizes,72,3,2,1,2700,754,3454,47.97222
3704,Brooklin,55,2,2,1,2800,548,3348,60.872726
3705,Móoca,96,2,2,2,3800,850,4650,48.4375
3706,Moema,36,1,1,1,1800,700,2500,69.44444
3707,Vila Olímpia,76,2,2,2,4200,1100,5300,69.73684
3708,Vila Clementino,45,1,1,1,1950,425,2375,52.77778
3709,Other,50,2,1,1,1200,478,1678,33.56
3710,Vila Clementino,97,3,3,2,2200,1435,3635,37.474228
3711,Jaguaré,90,3,3,2,1600,500,2100,23.333334
3712,Other,238,4,6,4,9000,1535,10535,44.264706
3713,Moema,69,2,1,1,2000,998,2998,43.449276
3714,Morumbi,50,2,1,1,1400,1,1401,28.02
3715,Vila Clementino,112,3,3,2,2800,1300,4100,36.607143
3716,Jardim Paulista,113,2,3,2,8000,1400,9400,83.185844
3717,Moema,72,2,3,2,3700,867,4567,63.430557
3718,Santa Cecília,35,1,1,1,2300,550,2850,81.42857
3719,Tatuapé,67,2,2,2,2600,598,3198,47.731342
3720,Butantã,60,2,1,1,1800,453,2253,37.55
3721,Other,64,3,2,1,1700,350,2050,32.03125
3722,Bela Vista,90,2,1,0,1900,795,2695,29.944445
3723,Vila Olímpia,43,1,1,1,3100,600,3700,86.04651
3724,Moema,123,3,4,2,8000,1250,9250,75.203255
3725,Saúde,75,3,2,1,2100,900,3000,40.0
3726,Santa Cecília,105,3,2,2,2800,1450,4250,40.47619
3727,Santa Cecília,42,1,1,1,1900,551,2451,58.357143
3728,Vila Olímpia,60,2,2,1,3000,867,3867,64.45
3729,Other,61,3,1,1,1400,749,2149,35.229507
3730,Consolação,40,2,1,0,950,627,1577,39.425
3731,Consolação,34,1,1,1,3000,200,3200,94.117645
3732,Tatuapé,134,2,4,2,5700,800,6500,48.50746
3733,Vila Olímpia,35,1,1,1,3200,700,3900,111.42857
3734,Paraíso,80,2,2,1,2300,1093,3393,42.4125
3735,Jardim Marajoara,52,2,1,1,1700,472,2172,41.76923
3736,Jardim Paulista,75,2,2,1,3000,811,3811,50.81333
3737,Brás,44,2,1,1,1620,280,1900,43.18182
3738,Other,45,1,1,1,1800,515,2315,51.444443
3739,Pinheiros,80,2,1,1,2150,760,2910,36.375
3740,Vila Mariana,56,2,1,2,3500,802,4302,76.82143
3741,Pinheiros,131,3,5,2,7200,1680,8880,67.78626
3742,Moema,40,1,1,1,1600,1050,2650,66.25
3743,Campo Belo,43,1,1,1,1500,580,2080,48.372093
3744,Other,50,2,1,1,1900,637,2537,50.74
3745,Aclimação,65,3,2,2,2300,453,2753,42.353848
3746,Lapa,138,3,5,3,6800,874,7674,55.608696
3747,Ipiranga,39,1,1,1,1600,0,1600,41.025642
3748,Vila Olímpia,65,2,2,1,3500,875,4375,67.30769
3749,Vila Leopoldina,130,3,3,2,5500,1050,6550,50.384617
3750,Santa Cecília,53,1,1,0,1400,450,1850,34.90566
3751,Vila Mariana,90,3,1,1,5000,1200,6200,68.888885
3752,Other,50,1,1,1,2900,623,3523,70.46
3753,Other,46,2,1,1,1200,0,1200,26.086956
3754,Vila Olímpia,48,1,1,1,3200,900,4100,85.416664
3755,Consolação,44,1,1,1,1850,442,2292,52.090908
3756,Saúde,56,2,2,1,2800,520,3320,59.285713
3757,Other,43,2,1,1,1800,390,2190,50.930233
3758,Pinheiros,58,2,2,1,2600,1200,3800,65.51724
3759,Other,37,1,1,1,2300,418,2718,73.45946
3760,Higienópolis,159,2,2,1,6500,1200,7700,48.427673
3761,Moema,102,3,4,2,4200,1700,5900,57.843136
3762,Itaim Bibi,100,2,4,1,4200,1583,5783,57.83
3763,Chácara Santo Antônio,143,3,4,2,7000,1060,8060,56.363636
3764,Vila Olímpia,55,2,1,1,3300,566,3866,70.29091
3765,Pinheiros,26,1,1,0,2600,577,3177,122.19231
3766,Barra Funda,65,2,1,1,1300,970,2270,34.923077
3767,Jaguaré,60,3,1,1,1400,500,1900,31.666666
3768,Moema,102,3,2,2,6000,1233,7233,70.911766
3769,Vila Olímpia,45,1,1,1,2500,970,3470,77.111115
3770,Other,69,2,1,1,1600,672,2272,32.927536
3771,Consolação,42,1,1,1,3050,800,3850,91.666664
3772,Pinheiros,62,2,2,2,3350,1070,4420,71.29032
3773,Pinheiros,74,2,2,2,5400,1098,6498,87.810814
3774,Other,79,3,2,1,1900,710,2610,33.037975
3775,Santana,80,4,3,2,2500,680,3180,39.75
3776,Other,40,1,1,0,1200,60,1260,31.5
3777,Tatuapé,22,1,1,0,1250,150,1400,63.636364
3778,República,35,1,1,0,1200,600,1800,51.42857
3779,República,30,1,1,1,2150,450,2600,86.666664
3780,Vila Nova Conceição,95,2,3,1,5000,1190,6190,65.1579
3781,Perdizes,45,1,1,1,2250,554,2804,62.31111
3782,Saúde,82,3,3,2,4000,580,4580,55.853657
3783,Aclimação,34,1,1,1,1500,837,2337,68.73529
3784,Pinheiros,36,1,1,1,3000,356,3356,93.22222
3785,Móoca,40,1,1,1,1500,234,1734,43.35
3786,Pompeia,80,2,2,2,5000,1340,6340,79.25
3787,Santo Amaro,65,2,2,1,2875,615,3490,53.692307
3788,Other,56,2,1,1,1800,570,2370,42.32143
3789,Vila Nova Conceição,48,1,1,1,4637,1193,5830,121.458336
3790,Pinheiros,88,1,1,2,4400,917,5317,60.420456
3791,Moema,50,1,1,1,1800,860,2660,53.2
3792,Other,34,1,1,1,2000,330,2330,68.52941
3793,Tatuapé,60,2,1,0,1250,150,1400,23.333334
3794,Vila Mascote,65,2,2,1,1950,620,2570,39.53846
3795,Paraíso,45,1,2,1,2700,823,3523,78.28889
3796,Itaim Bibi,73,1,1,1,6500,1400,7900,108.21918
3797,Jardim Paulista,48,2,2,2,3400,680,4080,85.0
3798,Campo Belo,65,2,1,2,2500,1100,3600,55.384617
3799,Mirandópolis,90,3,2,2,2900,990,3890,43.22222
3800,Centro,35,1,1,0,1500,438,1938,55.37143
3801,Jardim Paulista,30,1,1,1,1210,1150,2360,78.666664
3802,Tatuapé,94,3,2,1,1800,630,2430,25.851065
3803,Vila Mariana,51,2,1,1,3000,430,3430,67.254906
3804,Vila Andrade,70,3,2,2,1800,865,2665,38.07143
3805,Pinheiros,120,3,3,1,2900,1434,4334,36.116665
3806,Itaim Bibi,60,1,2,1,4500,1200,5700,95.0
3807,Bela Vista,82,2,2,0,2600,870,3470,42.317074
3808,Vila Buarque,30,1,1,0,2000,331,2331,77.7
3809,Vila Mariana,31,1,1,1,2420,528,2948,95.09677
3810,Vila Andrade,51,2,1,1,1700,400,2100,41.17647
3811,Other,50,2,1,1,1500,0,1500,30.0
3812,Bela Vista,45,1,1,1,1790,602,2392,53.155556
3813,Ipiranga,34,1,1,1,2400,340,2740,80.588234
3814,Morumbi,70,3,2,1,1750,823,2573,36.75714
3815,Other,140,4,3,3,3800,1550,5350,38.214287
3816,Perdizes,25,1,1,1,2100,330,2430,97.2
3817,Other,84,2,2,2,3500,790,4290,51.07143
3818,Santa Cecília,62,1,1,1,4000,616,4616,74.451614
3819,Vila Mascote,43,2,1,0,2100,200,2300,53.488373
3820,Brooklin,42,1,1,1,2300,865,3165,75.35714
3821,Santa Cecília,80,3,2,0,2700,400,3100,38.75
3822,Vila Andrade,48,2,1,1,2200,430,2630,54.791668
3823,Vila Buarque,53,1,1,0,1400,375,1775,33.490566
3824,Other,50,2,1,1,2020,439,2459,49.18
3825,Vila Mariana,62,2,2,1,1350,1041,2391,38.564518
3826,Saúde,70,3,2,2,1500,1050,2550,36.42857
3827,Pinheiros,53,2,2,1,4200,800,5000,94.33962
3828,Higienópolis,40,1,1,0,1600,500,2100,52.5
3829,Vila Olímpia,30,1,1,1,2700,800,3500,116.666664
3830,Chácara Santo Antônio,70,2,2,1,3100,734,3834,54.771427
3831,Vila Olímpia,72,3,2,1,4195,1008,5203,72.263885
3832,Vila Olímpia,150,2,2,2,8400,1165,9565,63.766666
3833,Vila Mariana,65,3,2,1,2100,680,2780,42.76923
3834,Moema,45,1,2,1,2000,540,2540,56.444443
3835,Santo Amaro,45,1,1,1,2400,383,2783,61.844444
3836,Vila Olímpia,36,1,1,1,3300,0,3300,91.666664
3837,Jabaquara,53,2,2,1,2100,720,2820,53.207546
3838,Móoca,80,2,1,0,1100,207,1307,16.3375
3839,Santo Amaro,60,1,1,1,1150,396,1546,25.766666
3840,Moema,35,1,1,1,1800,642,2442,69.77143
3841,Vila Mariana,100,4,1,0,2600,100,2700,27.0
3842,Vila Olímpia,80,3,3,1,3200,1350,4550,56.875
3843,Moema,95,3,3,1,2600,1112,3712,39.073685
3844,Other,165,4,2,3,5000,1411,6411,38.854546
3845,Other,58,2,1,1,1252,543,1795,30.948277
3846,Brooklin,88,2,2,2,4800,1167,5967,67.806816
3847,Morumbi,40,1,1,1,1400,580,1980,49.5
3848,Campo Belo,75,2,3,1,1700,1100,2800,37.333332
3849,Other,40,1,1,0,1700,0,1700,42.5
3850,Higienópolis,30,1,1,1,2000,490,2490,83.0
3851,Campo Belo,49,1,2,1,2600,665,3265,66.63265
3852,Santo Amaro,76,2,2,2,3000,350,3350,44.07895
3853,Consolação,60,2,1,2,4450,714,5164,86.066666
3854,Other,18,1,1,0,1100,40,1140,63.333332
3855,Aclimação,76,3,3,2,3700,1000,4700,61.842106
3856,Other,40,1,1,1,1400,661,2061,51.525
3857,Other,47,2,1,1,1350,0,1350,28.723404
3858,Vila Prudente,50,2,1,1,1300,395,1695,33.9
3859,Morumbi,79,2,3,1,3400,594,3994,50.55696
3860,Other,72,3,2,1,1750,650,2400,33.333332
3861,Campo Belo,132,3,1,1,4500,1600,6100,46.21212
3862,Jardim Paulista,90,2,1,1,3200,1300,4500,50.0
3863,Vila Olímpia,30,1,1,1,3060,600,3660,122.0
3864,Itaim Bibi,77,1,2,2,6950,1676,8626,112.02597
3865,Moema,73,2,1,1,2400,960,3360,46.027397
3866,Aclimação,38,1,1,0,1440,260,1700,44.736843
3867,Vila Andrade,50,2,1,1,2101,426,2527,50.54
3868,Other,49,2,1,1,1010,240,1250,25.510204
3869,Ipiranga,80,2,3,1,1700,933,2633,32.9125
3870,Barra Funda,33,1,1,1,1700,290,1990,60.303032
3871,Cerqueira César,180,3,3,2,8500,1666,10166,56.47778
3872,Moema,40,1,1,0,1700,0,1700,42.5
3873,Other,60,2,1,2,1200,690,1890,31.5
3874,Bela Vista,40,2,1,1,2700,450,3150,78.75
3875,Vila Guarani,85,3,3,2,2650,750,3400,40.0
3876,Bela Vista,75,2,2,1,2400,800,3200,42.666668
3877,Other,48,2,1,1,1500,512,2012,41.916668
3878,Campo Belo,47,1,1,1,2800,573,3373,71.76596
3879,Vila Clementino,72,2,2,1,4000,938,4938,68.583336
3880,Other,36,1,1,0,2300,450,2750,76.388885
3881,Other,22,1,1,0,1900,362,2262,102.818184
3882,Tatuapé,57,2,1,1,2300,432,2732,47.929825
3883,Vila Leopoldina,65,2,1,1,1500,532,2032,31.261538
3884,Vila Olímpia,55,1,1,1,1698,600,2298,41.78182
3885,Pinheiros,38,1,1,1,2800,568,3368,88.63158
3886,Cambuci,80,3,2,2,2100,890,2990,37.375
3887,Other,160,3,3,2,4000,1150,5150,32.1875
3888,Pompeia,50,1,1,1,2800,660,3460,69.2
3889,Itaim Bibi,90,2,2,1,4100,765,4865,54.055557
3890,Other,58,1,2,2,3800,774,4574,78.86207
3891,Pinheiros,65,2,2,1,5500,950,6450,99.23077
3892,Vila Madalena,24,1,1,0,2300,525,2825,117.708336
3893,Saúde,101,3,1,2,3500,600,4100,40.59406
3894,Itaim Bibi,44,1,1,1,2300,908,3208,72.90909
3895,Vila Mariana,100,2,2,1,2100,925,3025,30.25
3896,Consolação,42,1,1,1,1750,390,2140,50.95238
3897,Vila Madalena,25,1,1,0,2100,700,2800,112.0
3898,Itaim Bibi,70,2,2,1,3000,992,3992,57.028572
3899,Liberdade,40,1,1,0,1000,400,1400,35.0
3900,Campo Belo,83,2,3,2,4500,699,5199,62.638554
3901,Other,110,2,3,2,4800,1365,6165,56.045456
3902,Itaim Bibi,107,3,3,1,3800,1293,5093,47.59813
3903,Consolação,65,1,2,0,1500,407,1907,29.33846
3904,Saúde,58,2,1,1,2700,480,3180,54.827587
3905,Consolação,50,1,1,1,4000,700,4700,94.0
3906,Other,32,1,1,1,1250,560,1810,56.5625
3907,Other,87,3,1,2,3500,800,4300,49.42529
3908,Barra Funda,54,2,2,1,2400,580,2980,55.185184
3909,Mirandópolis,200,3,2,2,3800,0,3800,19.0
3910,Vila Olímpia,60,2,2,1,2500,950,3450,57.5
3911,Other,89,3,3,1,2800,860,3660,41.123596
3912,Saúde,70,3,2,1,2000,820,2820,40.285713
3913,Vila Mariana,37,1,1,1,1500,370,1870,50.54054
3914,Campo Belo,76,1,2,2,5250,937,6187,81.4079
3915,Higienópolis,64,2,1,1,2500,608,3108,48.5625
3916,Other,55,2,1,1,1250,422,1672,30.4
3917,Perdizes,85,1,1,1,1700,350,2050,24.117647
3918,Other,72,2,1,1,1900,460,2360,32.77778
3919,Tatuapé,52,2,1,1,1900,555,2455,47.21154
3920,Other,71,1,1,1,2620,780,3400,47.887325
3921,Vila Leopoldina,55,2,2,1,2300,656,2956,53.745453
3922,Pinheiros,50,1,1,1,3000,1044,4044,80.88
3923,Other,42,2,1,1,950,550,1500,35.714287
3924,Móoca,66,2,1,1,1700,583,2283,34.590908
3925,Jardim Marajoara,52,2,1,1,2100,0,2100,40.384617
3926,Bela Vista,60,2,2,0,2500,600,3100,51.666668
3927,Paraíso,46,1,2,1,3400,592,3992,86.78261
3928,Other,134,3,3,2,7000,1395,8395,62.649254
3929,Consolação,53,1,2,1,1980,570,2550,48.11321
3930,Tatuapé,122,3,3,2,3420,1500,4920,40.32787
3931,Jardim Paulista,137,3,3,1,6400,1187,7587,55.379562
3932,Barra Funda,33,1,1,1,2200,366,2566,77.757576
3933,Other,62,2,2,1,1980,660,2640,42.580647
3934,Vila Madalena,72,2,2,1,2350,900,3250,45.13889
3935,Aclimação,70,2,1,0,2300,620,2920,41.714287
3936,Pompeia,60,2,2,2,2500,1152,3652,60.866665
3937,Other,70,2,2,1,1500,860,2360,33.714287
3938,Cerqueira César,117,2,2,1,5000,820,5820,49.74359
3939,Other,47,2,1,1,1400,0,1400,29.787233
3940,Itaim Bibi,62,2,2,1,4800,873,5673,91.5
3941,Moema,72,3,2,1,3300,970,4270,59.305557
3942,Vila Madalena,55,1,1,2,4300,1408,5708,103.781815
3943,Other,70,2,1,2,2700,600,3300,47.142857
3944,Santa Cecília,58,2,1,1,2500,638,3138,54.103447
3945,Jabaquara,65,3,2,1,1500,542,2042,31.415384
3946,Morumbi,72,3,2,2,2100,950,3050,42.36111
3947,Saúde,70,3,2,1,1700,659,2359,33.7
3948,Other,50,2,1,1,1500,500,2000,40.0
3949,Other,45,2,1,1,950,393,1343,29.844444
3950,Vila Clementino,90,3,2,1,2900,0,2900,32.22222
3951,Ipiranga,61,2,2,1,1800,659,2459,40.311474
3952,Saúde,57,2,2,1,1600,650,2250,39.473682
3953,Tatuapé,49,2,1,1,1650,351,2001,40.836735
3954,Paraíso,188,3,3,2,5000,1631,6631,35.27128
3955,Other,35,1,1,0,1100,150,1250,35.714287
3956,Indianópolis,38,1,1,1,2300,1100,3400,89.47369
3957,Other,38,2,1,0,1300,100,1400,36.842106
3958,Other,62,3,2,2,1800,1100,2900,46.774193
3959,Other,157,3,3,3,7000,1200,8200,52.229298
3960,República,28,1,1,0,2300,0,2300,82.14286
3961,Bela Vista,45,1,1,0,2000,365,2365,52.555557
3962,Barra Funda,65,2,1,0,1500,469,1969,30.292307
3963,Consolação,34,1,1,1,2500,536,3036,89.29412
3964,Chácara Santo Antônio,104,3,4,2,3900,980,4880,46.923077
3965,Other,47,2,1,1,1950,597,2547,54.19149
3966,Other,74,2,2,2,1850,680,2530,34.18919
3967,Jaguaré,58,2,1,2,1500,402,1902,32.793102
3968,Vila Madalena,66,1,1,2,3280,1400,4680,70.90909
3969,Paraíso,43,1,1,1,1600,720,2320,53.953487
3970,Bela Vista,54,2,2,1,3400,550,3950,73.14815
3971,Campo Belo,70,2,2,2,5200,650,5850,83.57143
3972,Pompeia,76,2,2,2,3500,1120,4620,60.789474
3973,Other,84,2,2,2,3600,600,4200,50.0
3974,Santa Cecília,190,3,2,0,2600,1040,3640,19.157894
3975,Perdizes,45,1,1,1,2250,554,2804,62.31111
3976,Moema,90,3,4,2,3800,1182,4982,55.355556
3977,Other,58,2,1,1,5000,0,5000,86.206894
3978,Chácara Santo Antônio,63,2,2,1,3200,680,3880,61.587303
3979,Mirandópolis,60,2,2,1,2100,680,2780,46.333332
3980,Cerqueira César,58,1,2,1,3700,820,4520,77.93104
3981,Vila Madalena,113,3,3,2,2300,1175,3475,30.752213
3982,Chácara Santo Antônio,35,1,1,1,1500,530,2030,58.0
3983,Cidade Monções,33,1,1,1,2800,620,3420,103.63636
3984,Campo Belo,51,1,1,1,3000,669,3669,71.94118
3985,Brooklin,70,2,2,1,5000,720,5720,81.71429
3986,Aclimação,34,1,1,1,1980,608,2588,76.117645
3987,Other,84,2,2,2,3600,600,4200,50.0
3988,Vila Olímpia,60,2,2,1,4500,850,5350,89.166664
3989,Vila Leopoldina,98,3,2,1,3490,710,4200,42.857143
3990,Moema,75,2,2,2,3000,1472,4472,59.626667
3991,Other,48,2,1,1,1350,0,1350,28.125
3992,Higienópolis,80,2,1,1,4800,1211,6011,75.1375
3993,Moema,96,3,4,2,3700,1137,4837,50.385418
3994,Indianópolis,92,2,1,1,3900,960,4860,52.826088
3995,Vila Mariana,70,3,3,1,3300,583,3883,55.471428
3996,Jabaquara,74,2,2,1,1700,750,2450,33.10811
3997,Liberdade,26,1,1,0,700,500,1200,46.153847
3998,Campo Belo,47,2,2,1,3400,860,4260,90.6383
3999,Moema,70,2,1,1,2700,1100,3800,54.285713
4000,Bela Vista,42,1,1,1,1800,700,2500,59.52381
4001,Campo Belo,75,2,1,1,2500,616,3116,41.546665
4002,Other,102,3,2,0,1700,200,1900,18.62745
4003,Bela Vista,43,1,1,0,1400,590,1990,46.279068
4004,Saúde,140,3,2,2,3800,1300,5100,36.42857
4005,Centro,40,1,1,1,1800,397,2197,54.925
4006,Vila Madalena,100,3,3,2,5500,982,6482,64.82
4007,Other,55,2,1,2,1400,815,2215,40.272728
4008,Tatuapé,75,2,2,2,3300,800,4100,54.666668
4009,Jardim Paulista,142,3,3,2,5200,1300,6500,45.774647
4010,Tatuapé,52,2,1,1,1500,550,2050,39.423077
4011,Higienópolis,113,3,3,1,4500,1600,6100,53.9823
4012,Perdizes,74,2,3,2,5500,630,6130,82.83784
4013,Bela Vista,45,1,1,1,2000,0,2000,44.444443
4014,Moema,71,2,2,1,7000,980,7980,112.39436
4015,Perdizes,60,2,2,1,2300,797,3097,51.616665
4016,Pinheiros,42,1,1,1,2000,700,2700,64.28571
4017,Other,72,2,2,1,2700,692,3392,47.11111
4018,Other,68,2,2,1,2200,781,2981,43.838234
4019,Pinheiros,84,2,2,1,2400,996,3396,40.42857
4020,Perdizes,63,2,2,1,5000,1101,6101,96.84127
4021,Moema,85,2,3,1,3000,545,3545,41.705883
4022,Consolação,35,1,1,1,2800,805,3605,103.0
4023,Perdizes,65,2,2,1,3600,900,4500,69.23077
4024,Other,42,1,1,1,1400,455,1855,44.166668
4025,Moema,95,3,3,2,4000,1130,5130,54.0
4026,Morumbi,60,1,1,1,900,592,1492,24.866667
4027,Campo Belo,37,1,1,1,2400,500,2900,78.37838
4028,Brás,56,2,2,1,2300,450,2750,49.107143
4029,Other,48,2,1,1,1600,267,1867,38.895832
4030,Other,47,2,1,1,1300,230,1530,32.553192
4031,Vila Buarque,55,1,1,0,1400,554,1954,35.52727
4032,Mirandópolis,68,2,2,0,1900,670,2570,37.794117
4033,Campo Belo,108,3,3,2,5000,1400,6400,59.25926
4034,Other,75,3,2,1,1600,700,2300,30.666666
4035,Other,69,2,2,2,3100,0,3100,44.927536
4036,Bela Vista,64,2,2,1,4200,700,4900,76.5625
4037,Vila Olímpia,75,2,2,1,2200,1106,3306,44.08
4038,Vila Prudente,48,2,1,1,1500,571,2071,43.145832
4039,Saúde,34,1,1,1,1700,560,2260,66.47059
4040,Itaim Bibi,109,2,4,2,7000,1400,8400,77.06422
4041,Other,50,2,1,1,800,300,1100,22.0
4042,Jardins,61,2,1,1,2650,1089,3739,61.295082
4043,Campo Belo,60,2,2,1,2300,591,2891,48.183334
4044,Consolação,40,1,1,1,1900,597,2497,62.425
4045,Other,60,2,1,1,1100,280,1380,23.0
4046,Other,65,2,2,2,2000,650,2650,40.76923
4047,Jardim Paulista,50,2,1,1,2600,838,3438,68.76
4048,Moema,70,2,2,1,2900,1080,3980,56.857143
4049,Consolação,51,1,1,1,3000,550,3550,69.60784
4050,Moema,40,1,1,1,2200,800,3000,75.0
4051,Other,49,2,1,1,1500,170,1670,34.081635
4052,Vila Leopoldina,130,3,3,2,6000,1200,7200,55.384617
4053,Brooklin,43,1,1,1,3800,650,4450,103.48837
4054,Perdizes,45,1,2,1,1950,768,2718,60.4
4055,Barra Funda,40,1,1,1,2000,470,2470,61.75
4056,Other,112,2,4,2,5000,1265,6265,55.9375
4057,Ipiranga,78,3,2,2,2500,736,3236,41.48718
4058,Other,49,2,1,1,1350,490,1840,37.55102
4059,Other,116,3,3,1,2500,1050,3550,30.603449
4060,Jardim Marajoara,92,3,1,2,3000,870,3870,42.065216
4061,Móoca,49,2,1,1,1890,400,2290,46.734695
4062,Pinheiros,54,2,2,1,3200,881,4081,75.57407
4063,Other,58,2,1,1,1300,420,1720,29.655172
4064,Other,60,1,1,0,1000,0,1000,16.666666
4065,Vila Clementino,98,3,4,2,5500,966,6466,65.97959
4066,Perdizes,40,1,1,0,1500,203,1703,42.575
4067,Other,76,2,2,2,3000,736,3736,49.157894
4068,Other,55,2,1,1,1700,540,2240,40.727272
4069,Brooklin,62,1,2,1,3000,744,3744,60.387096
4070,Brooklin,83,3,3,2,3500,1000,4500,54.21687
4071,Vila Leopoldina,48,2,1,1,1800,440,2240,46.666668
4072,Other,27,1,1,0,1100,100,1200,44.444443
4073,Vila Buarque,30,1,1,0,1200,380,1580,52.666668
4074,Santana,50,2,1,1,1600,575,2175,43.5
4075,Other,57,2,1,1,1550,638,2188,38.385963
4076,Vila Madalena,75,2,2,1,4500,933,5433,72.44
4077,Aclimação,37,1,1,1,2260,530,2790,75.4054
4078,Vila Andrade,110,3,2,2,5000,895,5895,53.590908
4079,República,70,3,2,0,2000,700,2700,38.57143
4080,Vila Prudente,50,2,1,0,1150,160,1310,26.2
4081,Morumbi,65,3,2,1,1960,485,2445,37.615383
4082,Brooklin,78,2,2,2,6900,1200,8100,103.84615
4083,Other,92,3,2,3,2500,950,3450,37.5
4084,Pinheiros,72,2,3,1,5150,584,5734,79.638885
4085,Other,62,2,2,1,1700,788,2488,40.129032
4086,Other,50,2,1,1,2300,0,2300,46.0
4087,Móoca,60,2,1,1,1400,617,2017,33.616665
4088,Chácara Santo Antônio,71,2,2,1,3000,742,3742,52.704224
4089,Pinheiros,75,2,2,2,4400,790,5190,69.2
4090,Perdizes,104,3,3,2,7300,989,8289,79.70192
4091,Other,55,2,1,1,2000,0,2000,36.363636
4092,Vila Nova Conceição,71,2,2,1,6000,1250,7250,102.11268
4093,Vila Mariana,20,1,1,0,1710,300,2010,100.5
4094,Paraíso,80,2,2,1,2500,980,3480,43.5
4095,Itaim Bibi,90,2,2,1,4200,1020,5220,58.0
4096,Other,50,2,1,1,1500,544,2044,40.88
4097,Moema,115,3,3,2,5000,1100,6100,53.04348
4098,Other,38,1,1,1,2600,578,3178,83.63158
4099,Jardim Paulista,105,1,1,1,1990,1443,3433,32.695236
4100,Barra Funda,33,1,1,0,1600,290,1890,57.272728
4101,Jardins,31,1,1,1,2400,806,3206,103.41936
4102,Other,60,2,2,1,2200,400,2600,43.333332
4103,Moema,95,3,4,2,3800,1137,4937,51.968422
4104,Liberdade,64,2,1,0,1600,480,2080,32.5
4105,Other,54,2,1,1,1200,550,1750,32.407406
4106,Other,54,2,1,1,1120,551,1671,30.944445
4107,Aclimação,39,1,1,1,2260,530,2790,71.53846
4108,Bela Vista,98,2,1,1,6430,0,6430,65.61224
4109,Vila Mascote,50,1,1,1,1500,650,2150,43.0
4110,Other,75,3,2,1,2900,0,2900,38.666668
4111,Santana,148,3,3,3,3100,1675,4775,32.26351
4112,Vila Mariana,70,2,3,1,5000,820,5820,83.14286
4113,Other,53,1,1,1,900,580,1480,27.924528
4114,Other,63,2,2,1,1142,700,1842,29.238094
4115,Vila Mariana,50,1,2,1,3700,580,4280,85.6
4116,Campo Belo,82,2,3,1,2100,1149,3249,39.621952
4117,Saúde,80,3,2,1,2300,1100,3400,42.5
4118,Other,76,2,2,1,1900,970,2870,37.763157
4119,Butantã,60,2,2,1,2000,368,2368,39.466667
4120,Ipiranga,105,2,2,1,1800,870,2670,25.428572
4121,Itaim Bibi,130,3,3,1,4500,964,5464,42.03077
4122,Other,52,1,1,0,1350,0,1350,25.961538
4123,Jabaquara,34,1,1,1,1880,366,2246,66.05882
4124,Vila Olímpia,100,3,3,2,4200,1020,5220,52.2
4125,Vila Leopoldina,58,2,2,1,2799,562,3361,57.948277
4126,Other,102,2,2,0,2000,474,2474,24.254902
4127,Chácara Santo Antônio,80,2,1,0,1890,300,2190,27.375
4128,Chácara Santo Antônio,132,4,5,2,5500,990,6490,49.166668
4129,Other,62,2,2,1,2300,518,2818,45.451614
4130,Other,55,2,2,2,2500,750,3250,59.090908
4131,Itaim Bibi,40,1,1,0,4500,0,4500,112.5
4132,República,39,1,1,1,1700,750,2450,62.820515
4133,Other,84,3,2,2,2190,660,2850,33.92857
4134,Higienópolis,42,1,1,0,1600,448,2048,48.761906
4135,Vila Olímpia,35,1,1,1,3000,860,3860,110.28571
4136,Santo Amaro,73,1,2,1,2800,800,3600,49.315067
4137,Pinheiros,80,3,2,1,2250,1124,3374,42.175
4138,Pinheiros,60,2,1,0,2299,550,2849,47.483334
4139,República,28,1,1,0,1500,338,1838,65.64286
4140,Bela Vista,55,1,1,0,1600,600,2200,40.0
4141,Chácara Santo Antônio,60,2,2,2,3200,670,3870,64.5
4142,Indianópolis,47,1,1,1,3100,540,3640,77.44681
4143,Vila Mariana,31,1,1,1,2420,528,2948,95.09677
4144,Brooklin,80,2,2,2,6000,670,6670,83.375
4145,Other,37,1,1,1,2000,515,2515,67.97298
4146,Other,179,3,5,3,7000,1300,8300,46.368713
4147,Cerqueira César,40,1,2,1,1333,603,1936,48.4
4148,Morumbi,59,2,2,2,2000,800,2800,47.457626
4149,Other,61,2,1,1,1300,400,1700,27.868853
4150,Pinheiros,64,2,2,0,2200,921,3121,48.765625
4151,Chácara Santo Antônio,65,1,2,1,2800,646,3446,53.015385
4152,Campo Belo,83,2,3,1,2100,1147,3247,39.120483
4153,Other,50,2,1,1,1500,0,1500,30.0
4154,Vila Mariana,128,3,4,3,3000,1100,4100,32.03125
4155,Other,46,1,1,1,1050,50,1100,23.913044
4156,Jaguaré,55,2,1,1,1600,405,2005,36.454544
4157,Pinheiros,103,3,2,1,3500,1270,4770,46.31068
4158,Pompeia,121,3,4,3,4500,1300,5800,47.933884
4159,Other,55,2,1,1,1200,490,1690,30.727272
4160,Itaim Bibi,154,2,3,1,4300,1000,5300,34.415585
4161,Other,100,3,3,2,3200,890,4090,40.9
4162,Consolação,56,2,1,1,3900,950,4850,86.60714
4163,Móoca,150,3,2,2,1700,1450,3150,21.0
4164,Campo Belo,63,2,1,1,4900,1100,6000,95.2381
4165,Jardim América,50,1,1,1,3500,1700,5200,104.0
4166,Saúde,57,2,2,2,2750,625,3375,59.210526
4167,Paraíso,39,1,1,1,1400,843,2243,57.51282
4168,Vila Mariana,100,3,1,0,2000,0,2000,20.0
4169,Ipiranga,85,2,1,2,3800,791,4591,54.011765
4170,Campo Belo,34,1,1,1,3000,0,3000,88.23529
4171,Campo Belo,53,1,1,1,3950,450,4400,83.01887
4172,Perdizes,68,2,3,2,5390,1229,6619,97.338234
4173,Other,162,3,4,3,7000,1500,8500,52.469135
4174,Other,68,2,2,2,3500,720,4220,62.058823
4175,Other,52,2,1,1,1400,420,1820,35.0
4176,Other,70,2,3,2,2500,968,3468,49.54286
4177,Other,137,3,3,1,6800,1428,8228,60.058395
4178,Other,23,1,1,0,1600,338,1938,84.26087
4179,Pompeia,50,2,2,1,2550,580,3130,62.6
4180,Vila Mariana,168,3,3,2,3500,1600,5100,30.357143
4181,Vila Mariana,84,3,1,1,2700,580,3280,39.04762
4182,Moema,100,3,1,2,4500,1100,5600,56.0
4183,Brooklin,91,3,2,2,7300,950,8250,90.65934
4184,Tatuapé,69,2,2,1,2200,450,2650,38.405796
4185,Chácara Santo Antônio,138,3,5,2,6900,1404,8304,60.173912
4186,Pinheiros,125,3,2,1,7500,1550,9050,72.4
4187,Other,63,1,2,1,2950,350,3300,52.38095
4188,Campo Belo,27,1,1,1,1149,715,1864,69.03704
4189,Vila Buarque,28,1,1,0,1300,0,1300,46.42857
4190,Brooklin,56,1,1,1,3610,950,4560,81.42857
4191,Other,69,2,2,2,2700,975,3675,53.260868
4192,Other,120,2,4,2,8000,940,8940,74.5
4193,Other,72,2,2,2,2700,990,3690,51.25
4194,Jardim América,101,3,2,2,4500,1310,5810,57.524754
4195,Santo Amaro,65,2,1,1,3400,0,3400,52.307693
4196,Other,49,2,1,1,1500,270,1770,36.122448
4197,Barra Funda,126,4,3,2,5859,1200,7059,56.02381
4198,Tatuapé,62,3,1,1,1900,461,2361,38.080647
4199,Other,60,2,1,1,1500,200,1700,28.333334
4200,Santo Amaro,31,1,1,1,1600,621,2221,71.645164
4201,Santa Cecília,80,2,1,1,2500,1160,3660,45.75
4202,Other,35,1,1,1,900,440,1340,38.285713
4203,Bela Vista,25,1,1,0,1700,275,1975,79.0
4204,Other,50,2,1,1,1100,330,1430,28.6
4205,Higienópolis,40,1,1,0,1600,500,2100,52.5
4206,Brooklin,58,1,2,1,3800,642,4442,76.586205
4207,Vila Mariana,85,2,2,1,3600,515,4115,48.411766
4208,Other,53,2,1,1,1600,343,1943,36.660378
4209,Vila Mariana,50,2,1,1,3500,300,3800,76.0
4210,Barra Funda,53,2,2,1,2900,550,3450,65.09434
4211,Cerqueira César,95,2,2,0,2600,890,3490,36.736843
4212,Chácara Santo Antônio,48,2,1,1,2400,580,2980,62.083332
4213,Moema,40,1,1,1,1800,700,2500,62.5
4214,Moema,50,1,2,1,2100,570,2670,53.4
4215,Ipiranga,35,1,1,1,2490,341,2831,80.88571
4216,Vila Guarani,53,1,1,1,2500,619,3119,58.849056
4217,Tatuapé,46,2,1,1,1600,475,2075,45.108696
4218,Vila Madalena,83,2,3,2,4500,1350,5850,70.481926
4219,Consolação,32,1,1,1,2950,400,3350,104.6875
4220,Vila Guarani,62,2,2,1,1600,850,2450,39.51613
4221,Jaguaré,33,2,1,0,1400,0,1400,42.424244
4222,Other,30,1,1,1,1000,0,1000,33.333332
4223,Indianópolis,67,2,3,1,3700,850,4550,67.910446
4224,Vila Mascote,70,2,2,1,3100,720,3820,54.57143
4225,Bela Vista,44,1,1,1,1675,750,2425,55.113636
4226,Vila Mariana,86,3,1,2,4200,920,5120,59.534885
4227,Other,68,3,2,1,2100,698,2798,41.14706
4228,Vila Prudente,30,1,1,1,1700,445,2145,71.5
4229,Saúde,60,2,2,1,1700,585,2285,38.083332
4230,Higienópolis,78,3,2,1,2900,718,3618,46.384617
4231,Pinheiros,68,2,2,1,4800,1000,5800,85.29412
4232,Other,93,3,3,2,3700,550,4250,45.698925
4233,Ipiranga,45,1,1,0,1200,0,1200,26.666666
4234,Other,44,2,1,1,2000,637,2637,59.93182
4235,Brooklin,37,1,1,1,3000,700,3700,100.0
4236,Perdizes,60,1,1,0,1300,392,1692,28.2
4237,Vila Olímpia,43,1,1,1,2410,705,3115,72.441864
4238,Moema,71,2,2,1,6700,900,7600,107.04225
4239,Other,68,2,2,2,3500,720,4220,62.058823
4240,Moema,105,3,3,2,6000,872,6872,65.44762
4241,Brooklin,138,3,5,3,7000,1404,8404,60.898552
4242,Campo Belo,75,2,3,2,3500,1080,4580,61.066666
4243,Other,65,2,1,1,1320,600,1920,29.538462
4244,Other,23,1,1,0,1401,0,1401,60.913044
4245,Other,105,3,2,2,2700,0,2700,25.714285
4246,Moema,36,1,1,1,1800,539,2339,64.97222
4247,Other,56,2,1,1,2600,351,2951,52.69643
4248,Vila Olímpia,124,3,2,2,4350,0,4350,35.080647
4249,Móoca,80,2,1,1,1300,300,1600,20.0
4250,Other,165,4,4,3,5700,1400,7100,43.030304
4251,Saúde,70,2,2,1,1600,803,2403,34.32857
4252,Moema,102,3,3,2,6000,1188,7188,70.47059
4253,Moema,36,1,1,1,2300,685,2985,82.916664
4254,Pinheiros,110,3,1,0,4000,120,4120,37.454544
4255,Vila Olímpia,111,3,3,2,9000,1336,10336,93.11712
4256,Vila Mariana,130,3,3,1,3900,1089,4989,38.376923
4257,Other,55,2,1,1,2009,907,2916,53.01818
4258,Jardim Marajoara,65,2,2,2,1500,635,2135,32.846153
4259,Other,94,3,3,4,3000,915,3915,41.648937
4260,Other,90,3,2,1,1400,705,2105,23.38889
4261,Morumbi,88,2,2,2,2200,1150,3350,38.06818
4262,Vila Mariana,48,1,1,0,1800,632,2432,50.666668
4263,Other,165,4,4,2,5200,0,5200,31.515152
4264,Pompeia,46,2,1,1,1600,652,2252,48.95652
4265,Other,33,1,1,1,1490,450,1940,58.78788
4266,Itaim Bibi,35,1,1,0,1500,1100,2600,74.28571
4267,Other,55,2,1,1,2150,366,2516,45.745453
4268,Tatuapé,55,2,1,1,2000,480,2480,45.090908
4269,Bela Vista,54,2,2,1,2400,832,3232,59.851852
4270,Campo Belo,47,1,1,1,2800,823,3623,77.085106
4271,Other,62,2,2,1,1250,570,1820,29.35484
4272,Vila Mariana,54,2,1,1,2300,631,2931,54.27778
4273,Aclimação,45,2,1,0,1500,465,1965,43.666668
4274,Pompeia,84,3,3,1,2600,1266,3866,46.02381
4275,Jardim Paulista,75,2,2,1,3500,1200,4700,62.666668
4276,Liberdade,52,2,1,1,1900,320,2220,42.692307
4277,Bela Vista,37,1,1,1,2950,411,3361,90.83784
4278,Other,22,1,1,1,900,500,1400,63.636364
4279,Moema,145,3,5,2,8000,1513,9513,65.606895
4280,Lapa,80,2,1,1,1900,0,1900,23.75
4281,Lapa,83,3,3,2,3300,950,4250,51.20482
4282,Pinheiros,71,2,2,2,4200,864,5064,71.323944
4283,Jardim Paulista,44,1,1,1,1800,970,2770,62.954544
4284,Vila Clementino,55,2,1,0,2000,820,2820,51.272728
4285,Other,60,1,1,0,1300,200,1500,25.0
4286,Chácara Santo Antônio,50,2,1,1,2000,670,2670,53.4
4287,Campo Belo,43,1,1,1,2900,550,3450,80.23256
4288,Other,65,2,1,1,1200,352,1552,23.876923
4289,Saúde,96,3,3,2,2300,1056,3356,34.958332
4290,Other,62,1,2,1,2300,380,2680,43.225807
4291,Cambuci,34,2,1,1,2000,185,2185,64.26471
4292,Other,42,2,1,1,1000,185,1185,28.214285
4293,Itaim Bibi,100,3,2,1,4500,1100,5600,56.0
4294,Santa Cecília,40,1,1,1,1200,444,1644,41.1
4295,Brooklin,51,1,1,1,3300,592,3892,76.31373
4296,Other,120,3,3,2,3800,1008,4808,40.066666
4297,Jaguaré,57,2,1,1,1400,600,2000,35.08772
4298,Other,61,2,1,1,1840,0,1840,30.163935
4299,Other,73,2,2,2,3800,550,4350,59.589043
4300,Vila Olímpia,44,1,1,1,2600,627,3227,73.34091
4301,Other,58,2,1,1,1000,500,1500,25.862068
4302,Other,70,2,2,1,2400,1075,3475,49.642857
4303,Lapa,51,2,1,1,1900,466,2366,46.39216
4304,Itaim Bibi,80,2,3,1,3500,1150,4650,58.125
4305,Other,70,3,1,1,1500,630,2130,30.428572
4306,Aclimação,33,1,1,1,1420,758,2178,66.0
4307,Pinheiros,66,2,2,1,4858,1351,6209,94.07576
4308,Barra Funda,40,1,1,1,2200,470,2670,66.75
4309,Other,53,2,2,2,3300,945,4245,80.09434
4310,Other,80,3,1,1,2500,973,3473,43.4125
4311,Other,183,3,3,2,6600,1579,8179,44.69399
4312,Other,70,2,1,0,1200,393,1593,22.757143
4313,Vila Olímpia,60,1,1,1,4800,1648,6448,107.46667
4314,Other,55,2,1,1,1550,650,2200,40.0
4315,Jardim Paulista,40,1,1,1,3800,0,3800,95.0
4316,Perdizes,62,2,2,1,2700,800,3500,56.451614
4317,Other,32,2,1,0,1200,187,1387,43.34375
4318,Itaim Bibi,105,3,2,2,5400,1212,6612,62.971428
4319,Saúde,35,1,1,0,1500,310,1810,51.714287
4320,República,45,1,1,0,1000,465,1465,32.555557
4321,Vila Mariana,37,1,1,1,3800,544,4344,117.4054
4322,Moema,80,2,3,2,3300,1160,4460,55.75
4323,Moema,125,3,3,1,3500,1490,4990,39.92
4324,Butantã,105,3,2,2,2300,1024,3324,31.657143
4325,Moema,46,1,1,1,2800,1400,4200,91.304344
4326,Other,45,1,1,0,1000,0,1000,22.222221
4327,Itaim Bibi,52,1,2,1,4600,1050,5650,108.65385
4328,Other,70,3,2,2,1990,741,2731,39.014286
4329,Pinheiros,70,2,1,1,5300,659,5959,85.12857
4330,Other,50,1,1,1,3200,500,3700,74.0
4331,Jabaquara,65,2,1,1,1180,375,1555,23.923077
4332,Butantã,31,1,1,0,1500,175,1675,54.032257
4333,Other,55,2,1,1,1250,506,1756,31.927273
4334,Indianópolis,40,1,1,1,1800,787,2587,64.675
4335,Pinheiros,70,2,1,0,2200,300,2500,35.714287
4336,Other,75,2,1,0,1690,120,1810,24.133333
4337,Higienópolis,92,2,2,1,3000,705,3705,40.27174
4338,Jardim Paulista,74,2,2,1,4500,610,5110,69.054054
4339,Other,62,3,2,1,2200,580,2780,44.83871
4340,Santo Amaro,79,3,2,2,2490,870,3360,42.531647
4341,Santana,55,2,1,0,1400,502,1902,34.581818
4342,Moema,72,2,2,1,7500,900,8400,116.666664
4343,Other,45,1,1,1,2200,380,2580,57.333332
4344,Other,70,2,2,1,3300,771,4071,58.157143
4345,Tatuapé,64,3,1,1,1500,670,2170,33.90625
4346,Pompeia,146,3,5,3,5500,1340,6840,46.849316
4347,Other,72,3,2,2,2000,889,2889,40.125
4348,Brooklin,60,1,2,0,1800,384,2184,36.4
4349,Vila Andrade,48,2,1,1,2600,0,2600,54.166668
4350,Brooklin,45,1,1,1,2720,585,3305,73.44444
4351,Vila Guarani,128,3,2,2,4600,1180,5780,45.15625
4352,Perdizes,57,2,2,1,3600,900,4500,78.947365
4353,Other,42,2,1,1,1300,637,1937,46.11905
4354,Brooklin,148,3,2,2,6200,0,6200,41.89189
4355,Other,72,3,2,1,1900,670,2570,35.694443
4356,Cambuci,82,2,2,1,2750,850,3600,43.90244
4357,Other,48,2,1,1,2100,0,2100,43.75
4358,Other,60,2,2,1,3200,900,4100,68.333336
4359,Móoca,98,2,2,1,2300,700,3000,30.612246
4360,Vila Nova Conceição,72,1,2,2,4300,970,5270,73.19444
4361,Vila Mariana,80,2,1,1,2200,588,2788,34.85
4362,Jabaquara,49,1,1,1,1300,720,2020,41.22449
4363,Bela Vista,75,2,2,1,4300,1231,5531,73.746666
4364,Butantã,65,2,2,1,1900,1067,2967,45.646152
4365,Moema,76,2,2,1,2900,1040,3940,51.842106
4366,Bela Vista,42,1,1,1,1400,350,1750,41.666668
4367,Vila Nova Conceição,62,2,2,1,4800,873,5673,91.5
4368,Campo Belo,45,1,1,1,2600,650,3250,72.22222
4369,Perdizes,105,3,3,1,6000,1000,7000,66.666664
4370,Other,58,2,1,2,4400,798,5198,89.62069
4371,Brooklin,65,2,1,1,4550,880,5430,83.53846
4372,Paraíso,100,3,3,1,4500,1146,5646,56.46
4373,Moema,135,3,4,1,5200,1390,6590,48.814816
4374,Mirandópolis,55,2,1,0,2000,340,2340,42.545456
4375,Other,40,1,1,1,2350,458,2808,70.2
4376,Pinheiros,42,1,1,1,2200,800,3000,71.42857
4377,Other,72,3,2,1,1350,400,1750,24.305555
4378,Perdizes,81,3,3,1,3500,1000,4500,55.555557
4379,Pinheiros,65,2,2,0,2500,1011,3511,54.015385
4380,Barra Funda,75,3,2,2,3500,650,4150,55.333332
4381,Itaim Bibi,150,2,3,1,3800,1400,5200,34.666668
4382,Vila Olímpia,94,3,2,1,2900,942,3842,40.87234
4383,Bela Vista,51,1,1,1,3300,400,3700,72.54902
4384,Other,80,2,1,3,2750,1342,4092,51.15
4385,Santo Amaro,85,3,2,1,3500,600,4100,48.235294
4386,Other,141,3,4,3,3980,900,4880,34.60993
4387,Santa Cecília,149,2,1,0,2900,794,3694,24.791946
4388,Other,45,1,1,0,1050,55,1105,24.555555
4389,Other,40,2,1,1,2300,405,2705,67.625
4390,Vila Olímpia,55,2,1,1,3700,640,4340,78.90909
4391,Tatuapé,52,2,1,1,2400,0,2400,46.153847
4392,Perdizes,82,3,3,0,2700,1300,4000,48.780487
4393,Jaguaré,70,3,1,2,2300,706,3006,42.942856
4394,Vila Olímpia,72,3,2,1,4170,1010,5180,71.94444
4395,Paraíso,80,2,2,1,2500,980,3480,43.5
4396,Aclimação,30,1,1,0,1100,330,1430,47.666668
4397,Bela Vista,42,1,1,1,2500,416,2916,69.42857
4398,Paraíso,147,3,2,1,3500,1445,4945,33.639454
4399,Cidade Monções,70,2,1,2,4200,840,5040,72.0
4400,Vila Andrade,48,2,1,1,1790,410,2200,45.833332
4401,Consolação,50,2,2,1,2416,580,2996,59.92
4402,Bela Vista,81,2,1,0,2800,768,3568,44.04938
4403,Other,67,2,1,1,2100,441,2541,37.925373
4404,Aclimação,95,3,2,1,1900,801,2701,28.43158
4405,Other,47,2,1,1,1500,0,1500,31.914894
4406,Barra Funda,112,3,4,2,5600,1100,6700,59.82143
4407,Morumbi,97,3,3,2,2528,1600,4128,42.5567
4408,Bela Vista,40,1,1,0,1200,440,1640,41.0
4409,Aclimação,70,1,2,1,2200,763,2963,42.32857
4410,Jardim Paulista,38,1,1,1,1500,987,2487,65.447365
4411,Campo Belo,100,3,3,1,2400,922,3322,33.22
4412,Cerqueira César,98,2,3,1,5300,676,5976,60.97959
4413,Tatuapé,88,3,1,1,1400,1400,2800,31.818182
4414,Vila Leopoldina,143,3,5,2,6000,1340,7340,51.32867
4415,Itaim Bibi,120,2,2,1,3300,620,3920,32.666668
4416,Other,54,2,1,1,930,470,1400,25.925926
4417,Other,70,2,2,1,3200,848,4048,57.82857
4418,Other,65,2,1,1,900,700,1600,24.615385
4419,Jardim Paulista,45,1,1,1,2200,837,3037,67.48889
4420,Vila Madalena,72,2,2,1,3350,800,4150,57.63889
4421,Vila Mariana,82,2,2,1,2000,820,2820,34.390244
4422,Aclimação,50,1,1,0,1200,260,1460,29.2
4423,Chácara Santo Antônio,130,3,4,2,6000,1132,7132,54.861538
4424,Consolação,39,1,1,1,2400,392,2792,71.589745
4425,Pinheiros,95,3,3,2,4800,1500,6300,66.31579
4426,Other,73,3,2,1,1980,550,2530,34.657536
4427,Jardim Paulista,35,1,1,1,1600,573,2173,62.085712
4428,Other,80,3,2,2,2700,841,3541,44.2625
4429,Vila Nova Conceição,40,1,1,1,2100,850,2950,73.75
4430,Consolação,50,2,2,1,2416,580,2996,59.92
4431,Bela Vista,81,2,1,0,2800,768,3568,44.04938
4432,Other,35,1,1,1,2000,706,2706,77.314285
4433,Pinheiros,37,1,1,1,2800,1200,4000,108.10811
4434,Other,50,2,1,1,1000,500,1500,30.0
4435,Tatuapé,85,2,2,2,3400,880,4280,50.35294
4436,Pinheiros,72,2,2,1,2950,954,3904,54.22222
4437,Tatuapé,40,1,1,0,1380,100,1480,37.0
4438,Paraíso,87,2,2,1,3300,737,4037,46.402298
4439,Moema,74,2,2,1,4350,1250,5600,75.675674
4440,Jabaquara,60,2,1,1,1400,450,1850,30.833334
4441,Other,38,1,1,1,2500,577,3077,80.97369
4442,Itaim Bibi,83,2,1,1,3500,1100,4600,55.421688
4443,Vila Mariana,110,3,2,1,4070,828,4898,44.52727
4444,Pinheiros,72,3,2,1,2900,896,3796,52.72222
4445,Other,62,2,1,1,1950,969,2919,47.080647
4446,Pompeia,70,3,1,1,2200,740,2940,42.0
4447,Other,56,2,1,1,1200,100,1300,23.214285
4448,Bela Vista,55,1,1,0,3000,374,3374,61.345455
4449,Vila Prudente,61,3,2,1,1700,537,2237,36.67213
4450,Other,32,1,1,0,1500,298,1798,56.1875
4451,Perdizes,104,3,1,2,7300,980,8280,79.61539
4452,Campo Belo,38,1,1,1,2000,700,2700,71.052635
4453,Other,76,2,1,0,1391,340,1731,22.776316
4454,Jardim Paulista,70,2,1,1,2600,860,3460,49.42857
4455,Paraíso,160,2,4,1,4800,1300,6100,38.125
4456,Moema,40,1,1,1,1800,789,2589,64.725
4457,Other,30,1,1,1,2400,480,2880,96.0
4458,Tatuapé,43,1,1,1,2300,360,2660,61.860466
4459,Bela Vista,70,2,1,1,1500,700,2200,31.428572
4460,Jabaquara,89,3,2,2,2800,650,3450,38.764046
4461,Other,50,2,1,1,1500,450,1950,39.0
4462,Brooklin,62,2,2,1,2800,750,3550,57.258064
4463,Centro,30,1,1,0,1500,338,1838,61.266666
4464,Pinheiros,46,1,1,1,2000,1300,3300,71.73913
4465,Jardim Paulista,120,2,3,2,7500,1450,8950,74.583336
4466,Other,69,3,2,1,1150,1088,2238,32.434784
4467,Other,56,2,1,1,1000,0,1000,17.857143
4468,Other,34,2,1,0,2100,0,2100,61.764706
4469,Santana,70,3,2,2,1950,700,2650,37.857143
4470,Bela Vista,36,1,1,1,2130,590,2720,75.55556
4471,Perdizes,81,3,3,1,3500,984,4484,55.358025
4472,Other,56,2,1,2,1700,670,2370,42.32143
4473,Campo Belo,49,1,1,1,2950,575,3525,71.938774
4474,Ipiranga,60,2,2,1,2100,454,2554,42.566666
4475,Itaim Bibi,65,2,1,1,2300,900,3200,49.23077
4476,Pinheiros,30,1,1,0,3200,0,3200,106.666664
4477,Vila Olímpia,94,3,3,2,7500,1196,8696,92.510635
4478,Bela Vista,25,1,1,0,1200,295,1495,59.8
4479,Chácara Santo Antônio,34,1,1,0,1100,140,1240,36.47059
4480,Indianópolis,50,1,1,1,2100,860,2960,59.2
4481,Jardim Paulista,70,1,1,1,3900,1082,4982,71.171425
4482,Other,49,2,1,1,1200,648,1848,37.714287
4483,Consolação,46,1,1,1,2150,555,2705,58.804348
4484,Other,70,3,2,1,2600,444,3044,43.485714
4485,Cidade Monções,51,1,1,1,4200,750,4950,97.05882
4486,Other,45,1,1,0,950,0,950,21.11111
4487,Chácara Santo Antônio,45,1,1,1,2200,500,2700,60.0
4488,Consolação,24,1,1,1,2000,250,2250,93.75
4489,Vila Madalena,58,2,2,1,4400,700,5100,87.93104
4490,Other,70,2,1,1,2400,600,3000,42.857143
4491,Lapa,87,3,2,2,4500,630,5130,58.96552
4492,Vila Olímpia,95,3,2,1,1990,1370,3360,35.36842
4493,Vila Mariana,73,2,2,2,4000,0,4000,54.79452
4494,Ipiranga,96,3,2,1,1600,1200,2800,29.166666
4495,Other,62,2,2,1,3000,630,3630,58.548386
4496,Tatuapé,20,1,1,0,909,100,1009,50.45
4497,Paraíso,36,1,1,1,3200,0,3200,88.888885
4498,Moema,100,3,4,1,4500,1300,5800,58.0
4499,Perdizes,67,2,2,1,1900,930,2830,42.238808
4500,Santa Cecília,58,2,1,1,1800,1643,3443,59.36207
4501,Moema,50,1,1,1,1650,1040,2690,53.8
4502,Vila Olímpia,62,2,2,1,3990,868,4858,78.354836
4503,Chácara Santo Antônio,70,1,1,1,3500,780,4280,61.142857
4504,Other,80,2,2,1,2300,847,3147,39.3375
4505,Jabaquara,55,2,1,1,1300,433,1733,31.50909
4506,Vila Olímpia,60,2,2,2,2700,1048,3748,62.466667
4507,Other,41,2,1,0,1450,0,1450,35.365852
4508,Brooklin,86,2,2,1,3200,680,3880,45.11628
4509,Other,50,2,1,1,1100,287,1387,27.74
4510,Higienópolis,60,2,2,1,4500,749,5249,87.48333
4511,Vila Leopoldina,50,1,1,1,2300,650,2950,59.0
4512,Vila Clementino,42,1,1,1,2100,700,2800,66.666664
4513,Cambuci,63,2,2,1,1900,806,2706,42.95238
4514,Other,50,2,1,1,880,190,1070,21.4
4515,Vila Guarani,65,2,1,1,1950,359,2309,35.523075
4516,Aclimação,98,3,2,1,3850,1310,5160,52.65306
4517,Vila Olímpia,50,1,2,1,2100,753,2853,57.06
4518,Saúde,68,2,2,2,2800,987,3787,55.691177
4519,Pinheiros,73,2,1,1,2000,950,2950,40.410957
4520,Itaim Bibi,60,2,2,1,3300,938,4238,70.63333
4521,Other,60,2,2,2,3200,580,3780,63.0
4522,Other,55,2,2,1,1200,464,1664,30.254545
4523,Tatuapé,27,1,1,0,1700,220,1920,71.111115
4524,Other,72,3,2,1,2200,489,2689,37.34722
4525,Mirandópolis,55,1,2,1,3500,504,4004,72.8
4526,Other,38,1,1,1,2000,512,2512,66.10526
4527,Chácara Santo Antônio,96,3,3,1,2500,1180,3680,38.333332
4528,Other,63,2,2,1,1500,650,2150,34.126984
4529,Other,50,2,1,0,1340,350,1690,33.8
4530,Vila Clementino,65,2,2,1,1700,1218,2918,44.892307
4531,Barra Funda,65,3,1,2,2000,499,2499,38.446156
4532,Other,50,2,1,1,1650,0,1650,33.0
4533,Other,94,2,2,2,4500,847,5347,56.88298
4534,Other,50,1,1,1,1450,1550,3000,60.0
4535,Perdizes,34,1,1,1,2600,698,3298,97.0
4536,Brooklin,85,2,3,2,8500,1110,9610,113.05882
4537,Pinheiros,130,3,1,1,2499,0,2499,19.223078
4538,Itaim Bibi,90,2,2,1,5300,996,6296,69.95556
4539,Itaim Bibi,50,1,1,1,3500,1290,4790,95.8
4540,Pompeia,60,2,1,1,2800,878,3678,61.3
4541,Indianópolis,24,1,1,1,1800,400,2200,91.666664
4542,Perdizes,125,3,5,2,3000,1500,4500,36.0
4543,Tatuapé,148,3,5,2,7500,1210,8710,58.851353
4544,Vila Leopoldina,56,2,2,1,2300,620,2920,52.142857
4545,Vila Mascote,60,2,1,1,1500,875,2375,39.583332
4546,Saúde,80,3,3,2,2300,1200,3500,43.75
4547,Lapa,54,2,2,1,2200,734,2934,54.333332
4548,Vila Mascote,90,3,4,2,2700,1100,3800,42.22222
4549,Other,68,2,1,1,1100,430,1530,22.5
4550,Cerqueira César,90,2,2,2,5428,1580,7008,77.86667
4551,Other,107,3,3,2,2300,1150,3450,32.242992
4552,Mirandópolis,60,2,2,2,3800,1092,4892,81.53333
4553,Brás,59,2,1,1,2400,407,2807,47.57627
4554,Other,40,1,1,1,1100,530,1630,40.75
4555,Other,58,2,2,1,1850,645,2495,43.017242
4556,Morumbi,35,1,2,1,1350,700,2050,58.57143
4557,Vila Madalena,92,2,3,2,6500,1400,7900,85.86957
4558,Perdizes,130,3,2,2,3800,1005,4805,36.96154
4559,Bela Vista,85,2,2,0,2400,650,3050,35.882355
4560,Other,35,1,1,0,530,0,530,15.142858
4561,Pinheiros,45,1,1,0,2100,381,2481,55.133335
4562,Tatuapé,80,3,3,2,2200,720,2920,36.5
4563,Other,74,3,2,2,2200,855,3055,41.283783
4564,Other,30,1,1,0,1400,90,1490,49.666668
4565,Pinheiros,47,1,1,1,2780,650,3430,72.97872
4566,Aclimação,37,1,1,0,1100,323,1423,38.45946
4567,Itaim Bibi,50,1,2,1,2800,856,3656,73.12
4568,Other,74,2,3,2,5900,880,6780,91.62162
4569,Vila Olímpia,70,2,2,1,2500,933,3433,49.04286
4570,Other,40,2,1,0,1250,0,1250,31.25
4571,Other,56,2,1,1,900,646,1546,27.607143
4572,Other,60,1,1,1,1200,880,2080,34.666668
4573,Other,73,2,2,2,3000,850,3850,52.739727
4574,Pompeia,105,2,2,1,2500,1100,3600,34.285713
4575,Other,57,1,2,2,1700,1350,3050,53.508774
4576,Itaim Bibi,38,1,1,1,1990,770,2760,72.63158
4577,Consolação,40,1,1,1,1400,625,2025,50.625
4578,Campo Belo,57,2,3,1,2600,952,3552,62.31579
4579,Vila Olímpia,67,2,3,1,3700,800,4500,67.16418
4580,Pinheiros,90,2,2,0,3200,1200,4400,48.88889
4581,Other,82,3,2,2,3000,580,3580,43.658535
4582,Other,49,2,1,1,900,100,1000,20.408163
4583,Vila Nova Conceição,80,2,1,0,2850,759,3609,45.1125
4584,Campo Belo,83,2,3,2,4500,700,5200,62.650604
4585,Other,40,1,1,1,1550,502,2052,51.3
4586,Tatuapé,91,3,2,2,4700,850,5550,60.98901
4587,Campo Belo,60,2,2,1,2000,952,2952,49.2
4588,Ipiranga,56,2,1,1,1600,741,2341,41.80357
4589,Ipiranga,37,1,1,0,1650,0,1650,44.594593
4590,Vila Mariana,130,3,3,1,3000,1343,4343,33.407692
4591,Perdizes,106,3,2,1,3500,989,4489,42.349056
4592,Other,50,2,1,1,1600,400,2000,40.0
4593,Pinheiros,48,1,2,1,2700,807,3507,73.0625
4594,Other,50,2,2,1,2700,582,3282,65.64
4595,Other,26,1,1,1,2700,0,2700,103.84615
4596,Higienópolis,80,3,3,2,4900,1070,5970,74.625
4597,Moema,80,2,2,2,7000,613,7613,95.1625
4598,Other,73,3,2,0,2000,788,2788,38.19178
4599,Itaim Bibi,36,1,1,1,1500,1694,3194,88.72222
4600,Pinheiros,90,3,2,0,2800,600,3400,37.77778
4601,Vila Mariana,85,3,2,2,2800,1050,3850,45.294117
4602,Other,53,2,1,1,1600,350,1950,36.792454
4603,Other,54,2,1,1,1100,180,1280,23.703703
4604,Other,60,2,1,1,1400,465,1865,31.083334
4605,República,41,1,1,1,2000,479,2479,60.463413
4606,Other,62,2,2,1,1900,517,2417,38.98387
4607,Moema,70,2,3,2,3300,1266,4566,65.22857
4608,Other,88,3,2,1,4500,583,5083,57.761364
4609,Paraíso,108,2,3,1,4000,982,4982,46.12963
4610,Other,80,3,1,1,1400,646,2046,25.575
4611,Other,50,2,1,1,1100,435,1535,30.7
4612,Other,69,3,2,1,3500,450,3950,57.246376
4613,Other,70,2,2,1,2500,370,2870,41.0
4614,Vila Andrade,70,3,2,3,1900,930,2830,40.42857
4615,Perdizes,52,2,2,2,3600,800,4400,84.61539
4616,Móoca,55,2,1,1,1600,617,2217,40.30909
4617,Aclimação,118,2,3,2,3100,1360,4460,37.79661
4618,Other,49,2,1,1,1600,0,1600,32.65306
4619,Móoca,80,2,1,1,1650,920,2570,32.125
4620,Ipiranga,54,2,1,1,1800,479,2279,42.203705
4621,Other,80,3,2,2,2800,862,3662,45.775
4622,Campo Belo,90,2,2,1,1500,1500,3000,33.333332
4623,Itaim Bibi,136,3,4,2,6000,1500,7500,55.14706
4624,Vila Mariana,123,3,5,3,5600,1198,6798,55.26829
4625,Brooklin,66,1,2,1,7500,652,8152,123.51515
4626,Other,143,4,4,2,3900,1000,4900,34.265736
4627,Paraíso,66,2,2,1,4000,700,4700,71.21212
4628,Vila Andrade,75,3,2,2,2300,676,2976,39.68
4629,Other,50,2,1,1,1000,510,1510,30.2
4630,Pompeia,65,2,1,0,1900,200,2100,32.307693
4631,Saúde,70,3,2,1,1450,900,2350,33.57143
4632,Butantã,95,2,2,2,4100,810,4910,51.68421
4633,Other,53,1,1,1,3000,1330,4330,81.69811
4634,Other,165,4,4,3,4500,1100,5600,33.939392
4635,Brooklin,147,3,3,3,8000,1573,9573,65.12245
4636,Itaim Bibi,53,1,2,1,2500,822,3322,62.679245
4637,Cambuci,86,2,3,2,2900,885,3785,44.011627
4638,Brooklin,35,1,1,1,2600,325,2925,83.57143
4639,Other,54,2,2,1,2100,500,2600,48.148148
4640,Bela Vista,42,1,1,1,2000,431,2431,57.88095
4641,Other,35,1,1,0,1000,200,1200,34.285713
4642,Consolação,62,2,2,1,3500,645,4145,66.854836
4643,Itaim Bibi,100,3,3,1,4000,1250,5250,52.5
4644,Vila Madalena,18,1,1,0,1300,0,1300,72.22222
4645,Santa Cecília,72,2,2,1,2900,982,3882,53.916668
4646,Liberdade,62,1,1,0,1190,375,1565,25.241936
4647,Pinheiros,80,2,2,1,3650,1283,4933,61.6625
4648,Vila Olímpia,55,2,1,1,2300,863,3163,57.50909
4649,Other,42,2,1,0,1400,180,1580,37.61905
4650,Itaim Bibi,50,1,1,1,5000,1289,6289,125.78
4651,Moema,125,3,5,2,8500,1250,9750,78.0
4652,Consolação,35,1,1,1,1300,576,1876,53.6
4653,Mirandópolis,62,2,1,1,2000,580,2580,41.612904
4654,Chácara Santo Antônio,80,3,2,1,3300,835,4135,51.6875
4655,Bela Vista,50,2,1,0,1500,300,1800,36.0
4656,Brooklin,49,1,1,1,3000,645,3645,74.38776
4657,Jabaquara,38,1,1,1,1700,349,2049,53.92105
4658,Jardim Paulista,41,1,1,0,1350,422,1772,43.219513
4659,Morumbi,70,2,2,2,3600,1090,4690,67.0
4660,Brooklin,120,2,2,2,6000,1050,7050,58.75
4661,Bela Vista,75,3,3,1,3500,910,4410,58.8
4662,Brooklin,65,2,2,2,4100,685,4785,73.61539
4663,Cambuci,80,2,2,0,1800,668,2468,30.85
4664,Pinheiros,44,1,1,1,3800,600,4400,100.0
4665,Campo Belo,80,1,2,2,5500,1036,6536,81.7
4666,Other,55,2,1,0,1000,160,1160,21.09091
4667,Itaim Bibi,63,1,1,1,3200,1250,4450,70.63492
4668,Brooklin,40,1,1,1,2000,670,2670,66.75
4669,Pinheiros,90,2,2,1,2900,780,3680,40.88889
4670,Ipiranga,111,3,4,2,5500,1100,6600,59.45946
4671,Brooklin,64,2,2,1,3200,730,3930,61.40625
4672,Paraíso,66,2,2,1,4500,865,5365,81.28788
4673,Other,44,1,1,1,2600,624,3224,73.27273
4674,Itaim Bibi,97,3,3,2,4200,1419,5619,57.927834
4675,Brooklin,45,1,1,1,3999,586,4585,101.888885
4676,Saúde,130,4,2,3,5700,750,6450,49.615383
4677,Moema,50,1,1,1,2300,780,3080,61.6
4678,Jabaquara,85,3,2,1,1400,800,2200,25.882353
4679,Other,70,2,2,2,1950,660,2610,37.285713
4680,Pinheiros,110,3,3,2,4500,1350,5850,53.18182
4681,Brooklin,36,1,1,1,2500,420,2920,81.111115
4682,Vila Mariana,105,3,3,2,4500,1500,6000,57.142857
4683,Vila Andrade,41,2,1,0,1580,290,1870,45.609756
4684,Paraíso,71,2,2,0,1700,713,2413,33.985916
4685,Other,61,3,1,2,1700,624,2324,38.098362
4686,Vila Mariana,90,2,2,1,2250,950,3200,35.555557
4687,Consolação,56,2,1,1,2900,918,3818,68.17857
4688,Aclimação,34,1,1,1,2100,490,2590,76.17647
4689,Other,52,2,1,1,1300,0,1300,25.0
4690,Morumbi,72,2,2,2,2000,1500,3500,48.61111
4691,Chácara Santo Antônio,95,2,3,2,5900,700,6600,69.47369
4692,Vila Mariana,82,2,2,0,1400,350,1750,21.341463
4693,Vila Clementino,38,1,1,1,2200,680,2880,75.789474
4694,Morumbi,80,3,1,1,1500,485,1985,24.8125
4695,Other,75,2,1,1,2200,1270,3470,46.266666
4696,Santana,70,2,1,1,1400,390,1790,25.571428
4697,Chácara Santo Antônio,48,2,1,1,2450,580,3030,63.125
4698,Pinheiros,60,2,1,1,3500,880,4380,73.0
4699,Aclimação,67,2,2,1,2900,990,3890,58.0597
4700,Vila Mariana,90,2,1,0,2200,250,2450,27.222221
4701,Other,50,2,1,1,1300,100,1400,28.0
4702,Vila Clementino,43,1,1,0,2360,457,2817,65.51163
4703,Móoca,52,2,1,1,2500,450,2950,56.73077
4704,Cidade Monções,49,1,2,1,2000,1200,3200,65.30612
4705,Vila Mariana,79,2,2,1,1950,1030,2980,37.72152
4706,Bela Vista,46,1,1,1,3100,381,3481,75.67391
4707,Moema,70,2,2,1,3000,850,3850,55.0
4708,Other,74,2,1,1,1500,10,1510,20.405405
4709,Vila Buarque,50,2,1,0,1550,524,2074,41.48
4710,Jardim Paulista,50,1,2,0,1800,130,1930,38.6
4711,Brás,49,2,1,1,1800,460,2260,46.122448
4712,Vila Mariana,23,1,1,0,1650,0,1650,71.73913
4713,Itaim Bibi,42,1,1,1,2100,1200,3300,78.57143
4714,Pinheiros,45,1,1,1,2100,682,2782,61.822224
4715,Other,83,2,3,2,4500,699,5199,62.638554
4716,Vila Madalena,100,3,3,2,2500,1050,3550,35.5
4717,Vila Clementino,107,3,2,0,2500,1343,3843,35.91589
4718,Vila Clementino,65,2,2,1,4200,830,5030,77.38461
4719,Cambuci,36,1,1,1,1700,388,2088,58.0
4720,Paraíso,54,2,1,1,3000,0,3000,55.555557
4721,Vila Mariana,41,1,1,1,2000,487,2487,60.658535
4722,Other,70,2,2,1,1800,492,2292,32.74286
4723,Other,48,2,1,1,1645,458,2103,43.8125
4724,Other,50,2,1,1,1500,350,1850,37.0
4725,Mirandópolis,27,1,1,0,1650,280,1930,71.48148
4726,Paraíso,110,3,3,1,2500,1280,3780,34.363636
4727,Saúde,43,1,1,1,2000,425,2425,56.395348
4728,Vila Olímpia,33,1,1,1,1600,1300,2900,87.878784
4729,Santana,40,1,1,1,2200,486,2686,67.15
4730,Other,59,2,2,1,2500,550,3050,51.694916
4731,Vila Mascote,65,3,2,1,3000,615,3615,55.615383
4732,Vila Mariana,45,1,1,1,3270,830,4100,91.111115
4733,Aclimação,81,2,1,1,3000,208,3208,39.60494
4734,Brooklin,45,1,1,1,3300,537,3837,85.26667
4735,Liberdade,38,1,1,0,1850,350,2200,57.894737
4736,Other,95,3,3,2,3400,1000,4400,46.31579
4737,Vila Guarani,55,2,1,1,1550,669,2219,40.345455
4738,Other,41,2,1,1,1500,300,1800,43.90244
4739,Pompeia,72,3,2,1,2800,872,3672,51.0
4740,Other,74,3,2,1,2500,0,2500,33.783783
4741,Other,45,1,1,0,1300,243,1543,34.288887
4742,Other,55,2,1,1,1300,550,1850,33.636364
4743,Campo Belo,50,1,1,1,3000,578,3578,71.56
4744,Other,75,2,2,2,1600,840,2440,32.533333
4745,Jardim Marajoara,55,2,1,1,1900,580,2480,45.090908
4746,Perdizes,90,2,2,1,2400,321,2721,30.233334
4747,Other,50,2,1,1,1600,350,1950,39.0
4748,Bela Vista,47,2,1,1,2800,0,2800,59.574467
4749,Vila Mascote,116,3,4,2,3470,1350,4820,41.551723
4750,Brooklin,70,1,2,1,6800,778,7578,108.25714
4751,Vila Olímpia,65,2,2,0,3500,755,4255,65.46154
4752,Vila Buarque,59,2,2,1,3000,490,3490,59.152542
4753,Other,74,3,2,1,2177,760,2937,39.68919
4754,Campo Belo,36,1,1,1,2300,490,2790,77.5
4755,Liberdade,26,1,1,0,1800,335,2135,82.11539
4756,Consolação,41,1,1,0,1800,398,2198,53.609756
4757,Cambuci,72,2,2,1,2750,799,3549,49.291668
4758,Santana,75,3,2,1,2330,718,3048,40.64
4759,Jabaquara,46,2,1,1,1300,470,1770,38.47826
4760,Vila Madalena,61,2,2,1,5100,850,5950,97.540985
4761,Other,51,2,1,1,1300,571,1871,36.686275
4762,Other,50,2,1,0,1600,350,1950,39.0
4763,Brooklin,100,2,2,1,3500,1615,5115,51.15
4764,Aclimação,85,3,2,1,3000,813,3813,44.85882
4765,Jardim Marajoara,63,3,1,1,1800,450,2250,35.714287
4766,Higienópolis,130,3,2,1,6000,1300,7300,56.153847
4767,Pompeia,58,2,2,1,3150,735,3885,66.98276
4768,Saúde,70,2,2,1,2000,747,2747,39.24286
4769,Brooklin,70,2,1,1,4000,706,4706,67.22857
4770,Other,40,2,1,0,1450,0,1450,36.25
4771,Brooklin,60,2,2,2,5300,806,6106,101.76667
4772,Other,18,1,1,0,1500,0,1500,83.333336
4773,Other,61,2,2,1,2500,952,3452,56.590164
4774,Moema,46,1,2,1,1900,529,2429,52.804348
4775,Moema,98,3,3,1,3800,1191,4991,50.92857
4776,Other,70,3,2,1,2200,750,2950,42.142857
4777,Other,63,2,2,1,4800,805,5605,88.968254
4778,Other,62,2,1,1,1850,590,2440,39.35484
4779,Other,94,3,3,2,3499,736,4235,45.053192
4780,Brooklin,49,1,2,1,3200,546,3746,76.44898
4781,Higienópolis,48,1,1,1,1580,760,2340,48.75
4782,Vila Nova Conceição,40,1,1,1,3200,0,3200,80.0
4783,Pinheiros,110,3,1,0,2000,395,2395,21.772728
4784,Moema,72,2,2,2,5500,790,6290,87.361115
4785,Brooklin,68,1,2,1,3982,1100,5082,74.73529
4786,Pinheiros,62,2,2,0,3800,0,3800,61.29032
4787,Bela Vista,98,3,2,1,3300,995,4295,43.82653
4788,Consolação,50,2,1,1,3700,650,4350,87.0
4789,Centro,90,2,1,0,1800,0,1800,20.0
4790,Móoca,60,2,2,2,2100,641,2741,45.683334
4791,Butantã,82,3,2,1,2550,539,3089,37.67073
4792,Moema,55,2,2,2,3150,950,4100,74.545456
4793,Moema,66,2,2,1,2100,936,3036,46.0
4794,Other,90,3,1,2,3200,789,3989,44.322224
4795,Consolação,37,1,1,1,2200,533,2733,73.86487
4796,Other,61,3,2,1,1300,600,1900,31.147541
4797,Santana,123,3,2,2,4300,0,4300,34.95935
4798,Pinheiros,60,2,1,0,2500,530,3030,50.5
4799,Other,72,2,2,2,4200,750,4950,68.75
4800,Barra Funda,42,1,1,1,2600,750,3350,79.7619
4801,Bela Vista,51,2,1,0,2300,583,2883,56.52941
4802,Other,58,2,2,2,1950,485,2435,41.982758
4803,Pinheiros,30,1,1,0,2500,600,3100,103.333336
4804,Other,90,3,2,1,1048,564,1612,17.911112
4805,Vila Mascote,85,2,3,2,4500,693,5193,61.094116
4806,Other,96,3,3,2,4300,650,4950,51.5625
4807,Itaim Bibi,103,2,3,1,4700,1003,5703,55.36893
4808,Vila Buarque,62,1,1,0,1300,427,1727,27.85484
4809,Móoca,64,2,2,1,2700,800,3500,54.6875
4810,Tatuapé,49,1,1,0,1000,390,1390,28.367348
4811,Bela Vista,31,1,1,0,1500,494,1994,64.32258
4812,Santa Cecília,35,1,1,0,800,350,1150,32.857143
4813,Centro,26,1,1,0,1300,335,1635,62.884617
4814,Vila Mariana,80,2,3,1,2500,902,3402,42.525
4815,Jardim Paulista,87,2,2,2,7500,1670,9170,105.4023
4816,Cambuci,64,2,2,1,2860,560,3420,53.4375
4817,Other,40,1,1,1,2500,450,2950,73.75
4818,Perdizes,65,2,2,2,3100,800,3900,60.0
4819,Tatuapé,63,3,2,1,2200,380,2580,40.95238
4820,Vila Mariana,75,2,2,1,2300,950,3250,43.333332
4821,Perdizes,48,1,1,1,1800,640,2440,50.833332
4822,Pinheiros,49,2,1,1,2900,657,3557,72.591835
4823,Other,55,2,1,1,1500,495,1995,36.272728
4824,Barra Funda,54,2,2,1,2250,572,2822,52.25926
4825,Consolação,45,1,1,1,2500,800,3300,73.333336
4826,Other,85,2,2,1,2450,700,3150,37.058823
4827,Santa Cecília,50,1,1,1,2500,827,3327,66.54
4828,Other,50,2,1,1,2600,0,2600,52.0
4829,Other,48,2,1,1,1760,440,2200,45.833332
4830,Bela Vista,40,1,1,1,2800,0,2800,70.0
4831,Brás,48,2,1,1,1200,460,1660,34.583332
4832,Santo Amaro,65,2,1,1,3200,0,3200,49.23077
4833,Vila Mariana,68,2,2,1,4000,565,4565,67.132355
4834,Pompeia,65,2,3,1,2250,840,3090,47.53846
4835,Other,44,2,1,0,1000,200,1200,27.272728
4836,Vila Nova Conceição,96,3,3,1,6000,1320,7320,76.25
4837,Butantã,88,3,2,2,2280,750,3030,34.43182
4838,Vila Clementino,81,3,1,1,2500,1450,3950,48.76543
4839,Other,76,2,2,1,2700,640,3340,43.94737
4840,Vila Clementino,60,2,2,1,1500,1046,2546,42.433334
4841,Itaim Bibi,57,1,1,1,3000,980,3980,69.82456
4842,Pinheiros,78,2,2,1,3100,1233,4333,55.55128
4843,Moema,93,2,2,2,4500,1083,5583,60.032257
4844,Santa Cecília,129,3,3,0,3100,644,3744,29.023256
4845,Other,100,3,2,1,1500,786,2286,22.86
4846,Other,44,1,1,1,2600,624,3224,73.27273
4847,Jardim Marajoara,63,3,2,1,1400,680,2080,33.015873
4848,Vila Olímpia,72,3,2,1,4200,1000,5200,72.22222
4849,Pompeia,72,2,3,2,2799,844,3643,50.59722
4850,Tatuapé,45,1,1,1,2100,517,2617,58.155556
4851,Cerqueira César,73,2,2,1,5950,815,6765,92.671234
4852,Other,60,2,1,1,1500,700,2200,36.666668
4853,Vila Olímpia,61,2,1,1,3900,119,4019,65.88525
4854,Other,45,2,1,1,1100,500,1600,35.555557
4855,Other,117,2,2,0,1700,300,2000,17.094017
4856,Other,78,3,2,1,2600,925,3525,45.192307
4857,Higienópolis,41,1,1,1,2500,732,3232,78.82927
4858,Perdizes,127,3,2,2,3700,1522,5222,41.11811
4859,Other,65,2,2,1,1900,960,2860,44.0
4860,República,35,1,1,0,1500,294,1794,51.25714
4861,Other,50,2,1,1,1400,360,1760,35.2
4862,Pinheiros,50,1,1,1,2200,840,3040,60.8
4863,Consolação,46,1,1,1,3000,550,3550,77.17391
4864,Vila Buarque,29,1,1,0,1100,360,1460,50.344826
4865,Pinheiros,62,2,2,1,4000,830,4830,77.90323
4866,Vila Mariana,36,1,1,1,2650,0,2650,73.611115
4867,Itaim Bibi,71,1,2,1,7750,1200,8950,126.056335
4868,Perdizes,43,2,1,1,1800,871,2671,62.11628
4869,Other,55,2,1,1,1100,508,1608,29.236364
4870,Other,42,2,1,0,900,260,1160,27.619047
4871,Other,44,2,1,0,1000,0,1000,22.727272
4872,Vila Nova Conceição,50,1,1,1,2000,680,2680,53.6
4873,Moema,70,2,2,1,4000,750,4750,67.85714
4874,Móoca,25,1,1,0,900,60,960,38.4
4875,Moema,125,3,4,2,8500,1250,9750,78.0
4876,Other,50,2,1,1,1150,480,1630,32.6
4877,Other,35,1,1,1,1900,610,2510,71.71429
4878,Other,160,4,4,2,3950,1530,5480,34.25
4879,Paraíso,90,3,1,1,3500,1218,4718,52.422222
4880,Liberdade,25,1,1,0,2000,380,2380,95.2
4881,Vila Olímpia,44,1,1,2,3800,850,4650,105.681816
4882,Vila Mariana,89,2,2,1,2000,890,2890,32.47191
4883,Vila Mascote,65,2,2,1,3000,850,3850,59.23077
4884,Pinheiros,52,2,2,1,4200,820,5020,96.53846
4885,Perdizes,126,3,3,2,3200,1606,4806,38.142857
4886,Other,65,2,1,1,2200,740,2940,45.23077
4887,Pompeia,75,2,1,1,1800,672,2472,32.96
4888,Perdizes,81,2,2,1,2300,590,2890,35.679012
4889,Morumbi,94,3,2,1,3020,1200,4220,44.893616
4890,Moema,51,2,2,1,2500,520,3020,59.215687
4891,Aclimação,41,1,1,1,2500,700,3200,78.04878
4892,Paraíso,68,2,2,1,1600,1422,3022,44.441177
4893,Other,60,3,1,1,1400,600,2000,33.333332
4894,Liberdade,61,2,1,1,1100,900,2000,32.786884
4895,Brooklin,113,3,4,2,6000,905,6905,61.106194
4896,Moema,55,1,1,1,2793,571,3364,61.163635
4897,Butantã,57,3,1,1,1600,536,2136,37.473682
4898,Jardim Paulista,100,3,1,1,3500,994,4494,44.94
4899,Cerqueira César,55,1,1,2,4800,850,5650,102.72727
4900,Tatuapé,56,2,2,1,1750,700,2450,43.75
4901,Campo Belo,72,2,2,2,3900,881,4781,66.40278
4902,Vila Olímpia,81,2,2,1,4500,1250,5750,70.987656
4903,Brooklin,70,2,2,1,2000,680,2680,38.285713
4904,Perdizes,64,2,2,1,2790,860,3650,57.03125
4905,Tatuapé,65,2,1,2,2200,576,2776,42.70769
4906,Other,100,2,2,1,1300,450,1750,17.5
4907,Other,65,2,1,1,1600,850,2450,37.692307
4908,Other,98,2,3,2,2300,1200,3500,35.714287
4909,Chácara Santo Antônio,50,2,1,1,2800,510,3310,66.2
4910,Other,47,2,1,1,1400,435,1835,39.042553
4911,Other,35,1,1,1,2600,500,3100,88.57143
4912,Other,50,2,1,1,1200,470,1670,33.4
4913,Vila Guarani,78,2,3,1,2000,780,2780,35.641026
4914,Other,60,2,2,1,2100,550,2650,44.166668
4915,Other,61,3,2,1,1400,350,1750,28.688524
4916,Vila Andrade,95,3,3,2,4100,805,4905,51.63158
4917,Ipiranga,40,1,1,1,2200,567,2767,69.175
4918,Brooklin,67,2,2,1,4300,923,5223,77.95522
4919,Tatuapé,48,2,1,1,1500,495,1995,41.5625
4920,Brooklin,51,1,1,1,2800,596,3396,66.588234
4921,Other,48,1,1,1,1000,632,1632,34.0
4922,Consolação,30,1,1,1,1750,680,2430,81.0
4923,Pinheiros,71,2,2,2,4200,864,5064,71.323944
4924,Jardim Paulista,75,2,2,1,3000,1200,4200,56.0
4925,Chácara Santo Antônio,93,3,3,0,3600,972,4572,49.16129
4926,Vila Olímpia,65,2,2,1,5000,880,5880,90.46154
4927,Vila Nova Conceição,57,1,1,0,5000,950,5950,104.38596
4928,Campo Belo,145,3,5,4,8499,1400,9899,68.26897
4929,Pinheiros,101,3,1,2,5500,1014,6514,64.49505
4930,Itaim Bibi,60,1,1,1,2100,1100,3200,53.333332
4931,Vila Mariana,42,1,1,1,1800,690,2490,59.285713
4932,Vila Clementino,84,3,3,2,3490,1150,4640,55.238094
4933,Other,55,2,2,1,1700,600,2300,41.81818
4934,Vila Olímpia,80,2,1,1,2900,750,3650,45.625
4935,Jaguaré,64,2,2,1,1200,448,1648,25.75
4936,Brooklin,38,1,1,1,3200,525,3725,98.02631
4937,Vila Olímpia,53,2,1,1,2500,890,3390,63.962265
4938,Vila Mascote,133,3,5,3,5900,1350,7250,54.51128
4939,Santa Cecília,36,1,1,1,1500,706,2206,61.27778
4940,Bela Vista,108,3,2,1,3500,1037,4537,42.00926
4941,Santana,60,2,1,1,1750,750,2500,41.666668
4942,Jardim Paulista,52,1,1,1,3800,540,4340,83.46154
4943,Barra Funda,95,2,1,0,1800,100,1900,20.0
4944,Other,50,2,1,1,1300,0,1300,26.0
4945,Other,65,2,2,1,3500,800,4300,66.15385
4946,Brooklin,34,1,1,1,2800,350,3150,92.64706
4947,Liberdade,28,1,1,0,1700,272,1972,70.42857
4948,Other,54,2,1,1,1600,550,2150,39.814816
4949,Moema,110,3,2,2,3995,1055,5050,45.909092
4950,Other,96,3,1,2,4200,922,5122,53.354168
4951,Pinheiros,148,4,2,2,4500,1570,6070,41.01351
4952,Other,55,1,1,1,1500,507,2007,36.49091
4953,Other,51,2,1,1,1200,450,1650,32.35294
4954,Itaim Bibi,60,1,1,1,1900,757,2657,44.283333
4955,Vila Prudente,65,3,2,1,1800,460,2260,34.76923
4956,Vila Nova Conceição,128,3,3,1,7000,1220,8220,64.21875
4957,Moema,140,3,5,2,5500,1650,7150,51.07143
4958,Móoca,50,2,1,0,1100,309,1409,28.18
4959,Chácara Santo Antônio,38,1,1,1,2000,380,2380,62.63158
4960,Vila Mariana,50,1,1,1,1800,582,2382,47.64
4961,Other,62,1,2,1,3950,750,4700,75.80645
4962,Itaim Bibi,38,1,1,1,2400,497,2897,76.23684
4963,Moema,38,1,1,1,2300,1000,3300,86.8421
4964,Other,60,2,1,1,1000,310,1310,21.833334
4965,Other,45,2,1,1,1650,353,2003,44.511112
4966,Santana,35,1,1,1,1350,1300,2650,75.71429
4967,Jardim Paulista,45,1,1,1,3000,950,3950,87.77778
4968,Other,137,3,4,3,3200,1394,4594,33.53285
4969,Brooklin,24,1,1,1,2450,1,2451,102.125
4970,Brooklin,113,3,4,2,5200,1428,6628,58.65487
4971,Pinheiros,72,2,2,1,6300,1100,7400,102.77778
4972,Vila Leopoldina,172,3,4,3,6200,1700,7900,45.930233
4973,Other,50,2,1,1,1450,350,1800,36.0
4974,Moema,45,1,1,1,2500,778,3278,72.844444
4975,Higienópolis,68,1,2,0,3200,1331,4531,66.632355
4976,Higienópolis,33,1,1,1,1500,348,1848,56.0
4977,Perdizes,40,1,1,1,1800,595,2395,59.875
4978,Jabaquara,60,2,1,0,1800,0,1800,30.0
4979,Other,70,2,2,1,1300,482,1782,25.457144
4980,Chácara Santo Antônio,104,3,3,3,4400,765,5165,49.66346
4981,Bela Vista,45,1,1,1,1600,660,2260,50.22222
4982,Perdizes,57,2,2,2,2750,850,3600,63.157894
4983,Brooklin,35,1,1,1,2900,600,3500,100.0
4984,Mirandópolis,41,1,1,1,1900,511,2411,58.80488
4985,Vila Mascote,65,2,2,1,1850,1100,2950,45.384617
4986,Moema,80,2,2,1,5000,0,5000,62.5
4987,Jardim Paulista,42,1,1,1,4500,0,4500,107.14286
4988,Other,49,2,1,1,1160,477,1637,33.408165
4989,Indianópolis,43,1,1,0,1800,730,2530,58.837208
4990,Brooklin,66,2,2,1,2000,750,2750,41.666668
4991,Perdizes,130,3,4,3,5300,1390,6690,51.46154
4992,Other,62,2,1,1,1800,518,2318,37.387096
4993,Vila Mariana,36,1,1,1,2800,780,3580,99.44444
4994,Pinheiros,45,1,2,1,2700,780,3480,77.333336
4995,Perdizes,75,2,1,1,2300,900,3200,42.666668
4996,Pinheiros,71,2,2,1,5000,800,5800,81.69014
4997,Other,55,2,1,3,1200,90,1290,23.454546
4998,Vila Mariana,47,1,1,1,2700,580,3280,69.78723
4999,Moema,61,2,2,1,4200,715,4915,80.57377
5000,Other,56,2,1,1,1215,585,1800,32.142857
5001,Other,72,3,1,1,1510,690,2200,30.555555
5002,Moema,70,2,3,2,3500,1300,4800,68.57143
5003,Moema,31,1,1,0,2700,486,3186,102.77419
5004,Liberdade,52,2,1,1,1900,310,2210,42.5
5005,Other,49,2,1,1,1650,0,1650,33.67347
5006,Bela Vista,60,2,1,1,2600,792,3392,56.533333
5007,Mirandópolis,82,2,2,1,1800,773,2573,31.378048
5008,Vila Mariana,84,2,2,1,2000,920,2920,34.761906
5009,Other,100,3,2,2,2500,1077,3577,35.77
5010,Other,148,4,5,3,4000,1700,5700,38.51351
5011,Tatuapé,35,1,1,1,1900,411,2311,66.02857
5012,Santana,70,2,2,0,1350,470,1820,26.0
5013,Campo Belo,50,1,2,1,4315,430,4745,94.9
5014,Vila Buarque,30,1,1,0,1090,408,1498,49.933334
5015,Moema,75,2,3,2,4100,1250,5350,71.333336
5016,Other,55,1,1,1,3200,470,3670,66.72727
5017,Santa Cecília,59,1,1,0,1400,560,1960,33.22034
5018,Other,80,2,3,2,4600,890,5490,68.625
5019,Other,125,3,4,3,3100,1430,4530,36.24
5020,Other,76,2,1,0,2000,467,2467,32.460526
5021,Vila Mariana,145,3,3,3,5000,1063,6063,41.813793
5022,Other,70,3,2,1,1800,580,2380,34.0
5023,Other,130,3,4,2,3900,1350,5250,40.384617
5024,Paraíso,66,2,2,1,3500,880,4380,66.36364
5025,Centro,44,1,1,1,2300,700,3000,68.181816
5026,Moema,74,2,3,1,5500,865,6365,86.01351
5027,Bela Vista,62,1,1,0,2500,413,2913,46.98387
5028,Other,31,1,1,0,1200,0,1200,38.70968
5029,Other,51,1,1,1,3200,620,3820,74.90196
5030,Vila Mariana,51,2,1,0,3000,580,3580,70.196075
5031,Other,52,2,1,1,2300,310,2610,50.192307
5032,Moema,80,2,3,1,3800,1030,4830,60.375
5033,Vila Madalena,55,1,1,2,4300,1408,5708,103.781815
5034,Campo Belo,50,1,2,1,2650,600,3250,65.0
5035,Brooklin,51,1,1,1,3700,600,4300,84.31373
5036,Barra Funda,94,3,3,2,3200,750,3950,42.02128
5037,Other,60,2,1,1,3100,907,4007,66.78333
5038,Vila Mariana,21,1,1,0,2000,350,2350,111.90476
5039,Bela Vista,74,2,1,1,2500,773,3273,44.22973
5040,Vila Leopoldina,35,2,1,0,2250,350,2600,74.28571
5041,Tatuapé,65,3,1,1,2400,610,3010,46.307693
5042,Other,60,2,1,1,2000,597,2597,43.283333
5043,Perdizes,80,2,3,2,5000,1350,6350,79.375
5044,Vila Nova Conceição,36,1,1,1,2800,1000,3800,105.55556
5045,Vila Leopoldina,104,3,4,2,6000,885,6885,66.20192
5046,Cambuci,68,2,1,1,3600,800,4400,64.70588
5047,Indianópolis,65,2,2,1,2000,880,2880,44.307693
5048,Vila Olímpia,100,3,3,2,2500,1350,3850,38.5
5049,Other,71,3,2,2,2500,618,3118,43.915493
5050,Consolação,42,1,1,1,1480,492,1972,46.95238
5051,Perdizes,78,2,2,1,3000,1100,4100,52.564102
5052,Vila Mariana,34,1,1,1,1200,554,1754,51.588234
5053,República,35,1,1,0,1300,555,1855,53.0
5054,Other,52,2,1,1,1000,375,1375,26.442308
5055,Other,34,1,1,0,1800,0,1800,52.941177
5056,Saúde,43,1,2,1,1700,476,2176,50.604652
5057,Vila Andrade,61,3,1,1,1700,660,2360,38.688526
5058,Vila Leopoldina,121,3,3,2,5700,880,6580,54.380165
5059,Paraíso,36,1,1,1,1690,1280,2970,82.5
5060,Perdizes,160,4,4,2,5400,1586,6986,43.6625
5061,Perdizes,60,2,2,1,3500,1101,4601,76.683334
5062,Brooklin,88,2,2,2,5900,1300,7200,81.818184
5063,Vila Mariana,50,1,1,1,2800,856,3656,73.12
5064,Cerqueira César,60,1,1,2,3000,833,3833,63.883335
5065,Vila Nova Conceição,95,2,2,1,5000,0,5000,52.63158
5066,Vila Leopoldina,70,2,1,1,2700,710,3410,48.714287
5067,Jardim América,127,2,3,1,5800,1640,7440,58.582676
5068,Other,45,2,1,1,1650,303,1953,43.4
5069,Jardim Paulista,100,3,3,2,3500,1154,4654,46.54
5070,Other,87,2,2,1,2000,621,2621,30.126436
5071,Other,80,3,2,1,2000,500,2500,31.25
5072,Other,57,2,1,2,2300,655,2955,51.842106
5073,Centro,49,1,2,1,2950,790,3740,76.32653
5074,Other,110,3,1,0,2200,600,2800,25.454546
5075,Other,72,2,2,1,3500,680,4180,58.055557
5076,Other,28,1,1,1,1800,568,2368,84.57143
5077,Perdizes,73,2,1,1,3500,832,4332,59.342464
5078,Vila Mariana,46,1,1,0,2000,230,2230,48.47826
5079,Pinheiros,30,1,1,0,3200,0,3200,106.666664
5080,Other,56,2,1,1,1880,0,1880,33.57143
5081,Other,47,2,1,1,1140,360,1500,31.914894
5082,Vila Nova Conceição,95,2,2,1,5000,1190,6190,65.1579
5083,Consolação,53,2,2,1,3000,560,3560,67.169815
5084,Perdizes,70,2,1,1,1600,1000,2600,37.142857
5085,Brooklin,70,2,2,1,2100,1020,3120,44.57143
5086,Other,49,2,1,0,2200,300,2500,51.02041
5087,Vila Andrade,48,1,2,1,2650,700,3350,69.791664
5088,Vila Leopoldina,50,2,2,1,2000,600,2600,52.0
5089,Moema,70,2,2,1,4800,750,5550,79.28571
5090,Brooklin,116,3,3,2,6200,1350,7550,65.086205
5091,Bela Vista,48,2,2,1,2500,520,3020,62.916668
5092,Móoca,70,2,2,2,2500,850,3350,47.857143
5093,Butantã,60,2,1,1,2100,388,2488,41.466667
5094,Jardim Paulista,100,2,3,1,4500,1150,5650,56.5
5095,Moema,37,1,1,1,2100,980,3080,83.24324
5096,Moema,76,2,2,1,2900,810,3710,48.81579
5097,Santa Cecília,90,3,2,1,2600,750,3350,37.22222
5098,Other,95,3,2,3,2900,950,3850,40.526318
5099,Aclimação,35,1,1,1,2100,455,2555,73.0
5100,Other,100,3,1,0,1700,220,1920,19.2
5101,Jardim Paulista,130,2,4,2,8000,1680,9680,74.46154
5102,Ipiranga,63,2,2,1,2500,535,3035,48.174603
5103,Campo Belo,49,2,1,1,2500,700,3200,65.30612
5104,Brooklin,29,1,1,0,2500,489,2989,103.06896
5105,Other,50,2,1,1,1620,580,2200,44.0
5106,Santa Cecília,60,2,1,1,2000,828,2828,47.133335
5107,Other,35,1,1,0,1505,439,1944,55.54286
5108,Pompeia,74,2,1,2,3400,800,4200,56.756756
5109,Chácara Santo Antônio,104,3,3,2,3900,980,4880,46.923077
5110,Moema,54,2,3,1,3800,718,4518,83.666664
5111,Vila Madalena,72,1,2,1,3850,700,4550,63.194443
5112,Saúde,33,1,1,1,1150,425,1575,47.727272
5113,Other,48,1,1,1,1800,0,1800,37.5
5114,Other,55,2,1,1,1200,480,1680,30.545454
5115,Bela Vista,58,2,1,1,2400,633,3033,52.293102
5116,Moema,70,1,1,1,3900,1474,5374,76.77143
5117,Paraíso,55,2,1,1,3500,700,4200,76.36364
5118,Vila Nova Conceição,48,1,1,1,4837,1193,6030,125.625
5119,Vila Andrade,40,1,1,0,1300,639,1939,48.475
5120,Jardim Paulista,90,2,2,1,2600,1050,3650,40.555557
5121,Itaim Bibi,90,2,2,1,4100,765,4865,54.055557
5122,Perdizes,25,1,1,1,2300,330,2630,105.2
5123,Centro,40,1,1,1,1800,397,2197,54.925
5124,Vila Olímpia,63,1,2,1,6000,1350,7350,116.666664
5125,Jardim Paulista,118,3,3,2,5000,1280,6280,53.22034
5126,Liberdade,28,1,1,0,1900,270,2170,77.5
5127,Jardim Marajoara,69,3,2,2,1850,705,2555,37.028984
5128,Barra Funda,62,2,2,1,3000,355,3355,54.112904
5129,Vila Olímpia,65,2,1,1,3500,875,4375,67.30769
5130,Vila Mariana,59,2,1,1,2000,802,2802,47.491524
5131,Other,50,1,1,1,2550,590,3140,62.8
5132,Moema,66,2,2,1,2100,936,3036,46.0
5133,Jardim América,90,2,2,1,3200,1032,4232,47.02222
5134,Other,74,2,2,1,1800,939,2739,37.01351
5135,Saúde,49,2,1,1,1300,673,1973,40.265305
5136,Barra Funda,85,2,2,1,1780,565,2345,27.588236
5137,Vila Leopoldina,57,2,2,1,2150,1080,3230,56.666668
5138,Cerqueira César,40,1,1,0,1800,704,2504,62.6
5139,Other,75,3,1,1,1800,380,2180,29.066668
5140,Other,86,2,5,2,4300,820,5120,59.534885
5141,Aclimação,39,1,1,1,2260,530,2790,71.53846
5142,Other,55,2,1,1,1200,450,1650,30.0
5143,Pinheiros,50,1,1,1,3500,750,4250,85.0
5144,Other,146,3,3,3,2800,1600,4400,30.136986
5145,Other,80,2,2,2,3500,1180,4680,58.5
5146,Vila Andrade,238,4,6,4,9000,1535,10535,44.264706
5147,Perdizes,55,1,2,1,1700,350,2050,37.272728
5148,Santana,90,2,1,1,1300,730,2030,22.555555
5149,Saúde,52,2,2,1,1500,720,2220,42.692307
5150,Bela Vista,32,1,1,1,1200,1000,2200,68.75
5151,Other,105,2,3,2,5000,750,5750,54.761906
5152,Vila Olímpia,68,2,1,1,3000,594,3594,52.85294
5153,Other,58,2,1,1,1281,548,1829,31.534483
5154,Lapa,60,2,2,2,2200,765,2965,49.416668
5155,Pinheiros,50,1,1,0,1650,685,2335,46.7
5156,Other,48,1,1,1,3200,600,3800,79.166664
5157,Bela Vista,45,1,1,1,3400,544,3944,87.64445
5158,Vila Mariana,65,2,2,1,2500,850,3350,51.53846
5159,Itaim Bibi,98,2,3,1,5450,1346,6796,69.34694
5160,Barra Funda,132,2,1,2,5000,1339,6339,48.022728
5161,Pinheiros,48,1,1,2,3300,740,4040,84.166664
5162,Bela Vista,126,3,3,1,3000,1214,4214,33.444443
5163,Other,42,1,1,1,1380,620,2000,47.61905
5164,Campo Belo,38,1,1,1,2800,505,3305,86.97369
5165,Other,100,2,3,2,3700,1100,4800,48.0
5166,Tatuapé,130,2,4,2,5700,800,6500,50.0
5167,Other,100,3,2,2,2700,700,3400,34.0
5168,Santa Cecília,34,1,1,1,1400,500,1900,55.882355
5169,Paraíso,110,3,3,1,3400,925,4325,39.31818
5170,Moema,97,3,3,2,3650,1051,4701,48.463917
5171,Vila Buarque,90,2,2,1,3500,885,4385,48.72222
5172,Santa Cecília,38,1,1,1,1650,524,2174,57.210526
5173,Chácara Santo Antônio,96,2,2,0,4400,509,4909,51.135418
5174,Bela Vista,40,1,1,0,1200,552,1752,43.8
5175,Ipiranga,58,2,1,1,2000,700,2700,46.551723
5176,Moema,52,2,2,1,2300,581,2881,55.403847
5177,Vila Nova Conceição,95,2,2,1,5000,1190,6190,65.1579
5178,Santana,100,3,3,2,2500,1300,3800,38.0
5179,Vila Mariana,34,1,1,1,1300,877,2177,64.02941
5180,Jardim Marajoara,118,4,3,2,2800,1326,4126,34.966103
5181,Campo Belo,90,2,2,1,1500,1500,3000,33.333332
5182,Other,67,2,1,0,1700,0,1700,25.373135
5183,Itaim Bibi,140,3,2,1,5000,945,5945,42.464287
5184,Higienópolis,50,2,2,1,2500,481,2981,59.62
5185,Moema,15,1,1,1,1590,295,1885,125.666664
5186,Pinheiros,35,1,1,1,3150,500,3650,104.28571
5187,Campo Belo,50,1,1,0,3300,587,3887,77.74
5188,Vila Madalena,40,1,1,1,2600,695,3295,82.375
5189,Jardins,46,1,1,1,1900,550,2450,53.260868
5190,Jardim Paulista,42,1,1,1,1230,1150,2380,56.666668
5191,Ipiranga,86,2,2,2,2600,975,3575,41.569767
5192,Santa Cecília,50,1,1,0,2000,190,2190,43.8
5193,Chácara Santo Antônio,106,2,4,2,5000,1110,6110,57.64151
5194,Morumbi,78,2,1,1,1640,787,2427,31.115385
5195,Vila Olímpia,81,1,3,0,8000,1150,9150,112.96296
5196,Vila Olímpia,82,2,2,2,6300,1200,7500,91.46342
5197,Vila Mariana,80,3,2,1,2800,990,3790,47.375
5198,Tatuapé,90,2,2,1,1100,600,1700,18.88889
5199,Pompeia,70,2,2,1,1700,858,2558,36.54286
5200,Vila Guarani,75,3,2,2,3500,599,4099,54.65333
5201,Vila Mariana,97,3,2,2,2600,1001,3601,37.12371
5202,Aclimação,37,1,1,1,2160,530,2690,72.702705
5203,Perdizes,50,1,1,1,2000,575,2575,51.5
5204,Other,66,3,2,1,1600,524,2124,32.18182
5205,Vila Olímpia,93,2,4,2,9000,1120,10120,108.81721
5206,Liberdade,40,1,1,0,1000,548,1548,38.7
5207,Bela Vista,57,1,1,0,1350,500,1850,32.45614
5208,Other,55,2,1,1,1900,640,2540,46.18182
5209,Santo Amaro,65,3,2,0,2100,920,3020,46.46154
5210,República,26,1,1,0,810,232,1042,40.076923
5211,Vila Nova Conceição,79,2,1,1,4000,834,4834,61.189873
5212,Other,70,2,2,1,2400,800,3200,45.714287
5213,Jardim Paulista,45,1,1,1,3900,760,4660,103.55556
5214,Other,51,1,1,1,1300,605,1905,37.35294
5215,Perdizes,98,3,3,1,3400,899,4299,43.867348
5216,Itaim Bibi,65,1,2,1,4000,1090,5090,78.30769
5217,Other,70,3,2,2,3000,680,3680,52.57143
5218,Aclimação,37,1,1,1,2160,530,2690,72.702705
5219,Other,56,2,1,1,2500,0,2500,44.642857
5220,Brooklin,95,3,3,2,3200,1300,4500,47.36842
5221,Other,46,2,1,1,1500,400,1900,41.304348
5222,Brooklin,98,3,3,3,4500,1000,5500,56.122448
5223,Pinheiros,80,3,3,2,3500,1136,4636,57.95
5224,Consolação,50,1,1,0,2000,381,2381,47.62
5225,Vila Mascote,60,2,2,1,1300,580,1880,31.333334
5226,Higienópolis,60,2,2,2,4000,680,4680,78.0
5227,Other,103,2,3,2,6000,780,6780,65.82524
5228,Other,48,2,1,1,1700,0,1700,35.416668
5229,Other,40,2,1,1,1270,120,1390,34.75
5230,Vila Olímpia,75,2,2,1,2200,1106,3306,44.08
5231,Bela Vista,37,1,1,0,900,290,1190,32.162163
5232,Other,62,3,2,2,2200,470,2670,43.064518
5233,Jardim Paulista,75,2,2,1,3000,811,3811,50.81333
5234,Cambuci,40,2,1,0,1300,300,1600,40.0
5235,Tatuapé,50,2,1,1,2200,290,2490,49.8
5236,Other,82,3,1,1,3500,752,4252,51.853657
5237,Perdizes,142,3,3,2,3950,1580,5530,38.94366
5238,Saúde,42,2,1,1,1990,0,1990,47.38095
5239,Vila Olímpia,40,1,1,1,3404,903,4307,107.675
5240,Brooklin,30,1,1,1,2420,502,2922,97.4
5241,Vila Guarani,55,2,1,1,1550,558,2108,38.327274
5242,Ipiranga,69,2,1,2,2690,605,3295,47.753624
5243,Vila Mariana,75,2,3,1,2400,980,3380,45.066666
5244,Pinheiros,100,3,4,2,3300,1639,4939,49.39
5245,Other,44,1,1,1,2550,624,3174,72.13636
5246,Jardins,40,1,1,1,2500,800,3300,82.5
5247,Other,115,3,1,0,2300,0,2300,20.0
5248,Mirandópolis,34,1,1,1,1450,481,1931,56.794117
5249,Liberdade,85,2,2,1,1500,1246,2746,32.30588
5250,Other,54,2,1,1,1600,480,2080,38.51852
5251,Santa Cecília,76,2,2,1,3300,850,4150,54.605263
5252,Vila Nova Conceição,43,1,1,1,2500,800,3300,76.74419
5253,Jabaquara,67,3,2,1,1800,744,2544,37.97015
5254,Other,52,2,1,1,1400,529,1929,37.096153
5255,Jardim Paulista,176,3,3,1,5000,1630,6630,37.670456
5256,Other,73,2,2,2,3700,555,4255,58.28767
5257,Itaim Bibi,39,1,1,1,4234,583,4817,123.51282
5258,Consolação,66,2,2,1,6500,550,7050,106.818184
5259,Ipiranga,34,1,1,1,2200,400,2600,76.47059
5260,Vila Mariana,49,2,2,0,2000,100,2100,42.857143
5261,Brooklin,120,3,3,1,4000,1200,5200,43.333332
5262,Paraíso,83,3,3,2,3590,1200,4790,57.710842
5263,Other,40,2,1,0,1280,206,1486,37.15
5264,Pompeia,41,1,1,1,2300,590,2890,70.48781
5265,Tatuapé,63,2,2,2,2600,592,3192,50.666668
5266,Other,58,2,1,1,2000,707,2707,46.672413
5267,Vila Mariana,41,1,1,0,3500,981,4481,109.29269
5268,Other,66,2,2,1,1900,1000,2900,43.939392
5269,Other,40,1,1,1,1100,400,1500,37.5
5270,Santana,63,2,2,2,1850,800,2650,42.06349
5271,Other,40,2,1,1,2300,400,2700,67.5
5272,Bela Vista,105,2,2,1,3000,850,3850,36.666668
5273,Vila Guarani,59,2,1,1,1700,800,2500,42.372883
5274,Other,36,2,1,0,1600,0,1600,44.444443
5275,Cambuci,50,1,1,1,1300,526,1826,36.52
5276,Liberdade,50,1,1,0,1100,390,1490,29.8
5277,Other,45,2,1,1,1100,500,1600,35.555557
5278,Jardim Paulista,50,1,2,1,2655,950,3605,72.1
5279,Ipiranga,30,1,1,0,1700,0,1700,56.666668
5280,Vila Olímpia,38,1,1,1,3970,800,4770,125.52631
5281,Vila Olímpia,55,2,1,1,5500,913,6413,116.6
5282,Paraíso,120,3,2,2,5900,1100,7000,58.333332
5283,Morumbi,60,2,2,1,1500,600,2100,35.0
5284,Other,126,2,3,2,7500,920,8420,66.82539
5285,Brás,54,2,1,1,1500,450,1950,36.11111
5286,Pinheiros,67,2,2,1,2400,781,3181,47.47761
5287,Aclimação,105,2,3,2,5500,1323,6823,64.98095
5288,Other,47,2,1,0,700,270,970,20.638298
5289,Vila Nova Conceição,50,2,1,1,2300,930,3230,64.6
5290,Moema,102,2,4,2,6200,850,7050,69.117645
5291,Vila Nova Conceição,72,2,2,2,5400,1095,6495,90.208336
5292,Other,60,2,1,1,1500,413,1913,31.883333
5293,Centro,28,1,1,0,1500,568,2068,73.85714
5294,Móoca,54,2,1,1,1500,630,2130,39.444443
5295,Ipiranga,126,3,2,1,2100,230,2330,18.492064
5296,Perdizes,89,3,2,1,2900,800,3700,41.573032
5297,Vila Mariana,69,2,2,1,2200,1200,3400,49.275364
5298,Consolação,50,1,1,0,1800,390,2190,43.8
5299,Other,111,3,2,1,3000,720,3720,33.51351
5300,Other,70,1,1,0,1900,0,1900,27.142857
5301,Indianópolis,97,3,4,2,5000,1153,6153,63.43299
5302,Saúde,69,3,2,1,2200,481,2681,38.855072
5303,Pinheiros,70,1,2,1,4950,758,5708,81.542854
5304,Other,106,2,2,2,3800,1018,4818,45.45283
5305,Cambuci,90,2,1,2,2900,961,3861,42.9
5306,Other,50,2,1,1,1200,402,1602,32.04
5307,Perdizes,80,3,3,2,2900,1200,4100,51.25
5308,Other,59,2,2,1,2300,609,2909,49.305084
5309,Centro,39,1,1,1,1600,608,2208,56.615383
5310,Moema,50,1,1,1,2200,600,2800,56.0
5311,Santana,69,3,2,1,1800,745,2545,36.884056
5312,Other,62,2,2,1,2900,628,3528,56.903225
5313,Other,105,2,2,1,2500,1140,3640,34.666668
5314,Other,55,3,1,1,1000,260,1260,22.90909
5315,Brooklin,34,1,1,1,2800,400,3200,94.117645
5316,Vila Guarani,55,2,1,1,2000,510,2510,45.636364
5317,Other,67,2,2,1,2299,730,3029,45.208954
5318,Other,69,2,2,2,3200,700,3900,56.52174
5319,Moema,138,3,4,2,7500,1388,8888,64.4058
5320,Other,57,2,1,1,1372,570,1942,34.070175
5321,Lapa,38,1,1,0,1000,207,1207,31.763159
5322,Other,50,2,1,1,1100,551,1651,33.02
5323,Jabaquara,90,2,1,1,1300,0,1300,14.444445
5324,Ipiranga,64,2,2,2,2800,800,3600,56.25
5325,Jardim América,90,2,2,1,3100,1198,4298,47.755554
5326,Other,65,2,2,1,1600,845,2445,37.615383
5327,Other,80,2,2,1,4500,1168,5668,70.85
5328,Vila Clementino,80,2,3,1,2600,817,3417,42.7125
5329,Pinheiros,87,1,2,0,2200,421,2621,30.126436
5330,Jardim Paulista,100,2,3,1,6500,1150,7650,76.5
5331,Jaguaré,50,2,1,1,1200,583,1783,35.66
5332,Vila Leopoldina,83,2,3,2,2900,1113,4013,48.349396
5333,Other,124,3,2,0,1900,300,2200,17.741936
5334,Tatuapé,45,1,1,1,1800,680,2480,55.11111
5335,Itaim Bibi,97,2,2,1,3900,1090,4990,51.4433
5336,Perdizes,36,1,1,1,1800,798,2598,72.166664
5337,Chácara Santo Antônio,37,1,1,1,1850,577,2427,65.5946
5338,Cambuci,26,1,1,0,1600,150,1750,67.30769
5339,Pompeia,90,3,3,2,4000,772,4772,53.02222
5340,Vila Olímpia,70,2,2,1,2300,895,3195,45.642857
5341,Vila Nova Conceição,65,2,2,1,2600,629,3229,49.67692
5342,Bela Vista,29,1,1,1,1400,725,2125,73.27586
5343,Other,50,2,2,2,1900,574,2474,49.48
5344,Campo Belo,42,1,1,1,2150,558,2708,64.47619
5345,Jabaquara,50,2,2,1,2500,552,3052,61.04
5346,Other,65,2,2,1,2800,691,3491,53.70769
5347,Other,70,3,3,2,2000,1000,3000,42.857143
5348,Other,38,2,1,1,1200,150,1350,35.526318
5349,Higienópolis,60,2,2,1,2000,830,2830,47.166668
5350,Other,49,1,2,1,3300,550,3850,78.57143
5351,Other,50,2,1,1,1000,680,1680,33.6
5352,Vila Mariana,82,2,3,1,2800,751,3551,43.30488
5353,Itaim Bibi,70,2,2,1,3490,1700,5190,74.14286
5354,Other,77,2,2,1,4000,550,4550,59.090908
5355,Pinheiros,43,1,1,1,3400,647,4047,94.11628
5356,Other,56,2,1,1,2190,570,2760,49.285713
5357,Other,68,2,1,1,1150,350,1500,22.058823
5358,Consolação,30,1,1,0,1200,344,1544,51.466667
5359,Other,90,2,2,2,4900,700,5600,62.22222
5360,Móoca,110,3,3,3,3500,800,4300,39.090908
5361,Pinheiros,86,3,3,1,3300,1080,4380,50.930233
5362,Vila Mariana,56,2,2,2,2500,799,3299,58.910713
5363,Bela Vista,114,3,3,2,7485,1015,8500,74.5614
5364,Vila Olímpia,60,2,2,2,4500,1350,5850,97.5
5365,Santa Cecília,77,2,2,0,2300,716,3016,39.16883
5366,República,170,2,1,0,2600,650,3250,19.117647
5367,Jardins,61,2,1,2,2740,1089,3829,62.770493
5368,Brooklin,39,1,1,1,3000,310,3310,84.871796
5369,Morumbi,74,3,2,2,2100,550,2650,35.81081
5370,Vila Clementino,100,2,2,2,2500,921,3421,34.21
5371,Pinheiros,48,1,1,1,2500,660,3160,65.833336
5372,Moema,46,1,1,1,3700,706,4406,95.78261
5373,Other,81,2,2,1,2700,720,3420,42.22222
5374,Centro,35,1,1,1,1000,466,1466,41.885715
5375,Other,31,1,1,1,2900,400,3300,106.451614
5376,Brooklin,80,2,2,2,6500,758,7258,90.725
5377,Vila Olímpia,40,1,1,1,3800,0,3800,95.0
5378,Brooklin,60,2,2,1,4900,983,5883,98.05
5379,Other,68,3,2,1,2600,0,2600,38.235294
5380,Other,90,2,1,1,2400,920,3320,36.88889
5381,Pinheiros,135,3,4,2,6300,1650,7950,58.88889
5382,Other,65,2,2,1,2500,693,3193,49.123077
5383,Morumbi,55,1,1,1,2500,403,2903,52.78182
5384,Tatuapé,117,3,3,3,3100,960,4060,34.700855
5385,Other,49,1,1,1,2400,456,2856,58.285713
5386,Other,35,1,1,0,650,0,650,18.571428
5387,Bela Vista,40,1,1,0,1300,590,1890,47.25
5388,Pinheiros,72,2,2,1,2500,880,3380,46.944443
5389,Vila Prudente,50,2,1,1,1800,436,2236,44.72
5390,Other,70,2,2,2,2600,975,3575,51.07143
5391,Paraíso,80,2,1,1,2500,980,3480,43.5
5392,Ipiranga,80,3,2,1,3100,505,3605,45.0625
5393,Vila Nova Conceição,35,1,1,1,2900,750,3650,104.28571
5394,Consolação,42,1,1,0,2700,550,3250,77.38095
5395,Campo Belo,55,1,1,1,2200,513,2713,49.327274
5396,Other,27,1,1,0,775,85,860,31.851852
5397,Other,42,2,1,0,1300,0,1300,30.952381
5398,Ipiranga,83,3,2,0,1750,769,2519,30.349398
5399,Vila Mascote,58,1,1,0,1200,400,1600,27.586206
5400,Tatuapé,50,2,2,1,2000,0,2000,40.0
5401,Other,80,3,1,1,1000,0,1000,12.5
5402,Itaim Bibi,45,1,1,0,1500,390,1890,42.0
5403,Vila Andrade,54,2,1,2,1200,840,2040,37.77778
5404,Other,56,2,1,2,2000,760,2760,49.285713
5405,Itaim Bibi,65,1,1,1,5900,930,6830,105.07692
5406,Aclimação,20,1,1,0,990,267,1257,62.85
5407,Vila Mariana,110,3,3,1,1900,1200,3100,28.181818
5408,Higienópolis,104,2,2,1,3000,705,3705,35.625
5409,Paraíso,72,2,2,1,2100,779,2879,39.98611
5410,Aclimação,34,1,1,1,1200,837,2037,59.911766
5411,Vila Buarque,70,2,2,2,3100,800,3900,55.714287
5412,Moema,46,1,1,1,1765,684,2449,53.239132
5413,Bela Vista,68,2,1,1,1500,684,2184,32.117645
5414,Other,52,1,1,0,1400,290,1690,32.5
5415,Bela Vista,60,2,1,1,2100,800,2900,48.333332
5416,Other,40,2,1,0,900,100,1000,25.0
5417,Consolação,63,2,1,1,1900,556,2456,38.984127
5418,Other,57,2,2,2,2350,511,2861,50.19298
5419,Bela Vista,32,1,1,0,1200,325,1525,47.65625
5420,Brás,70,2,2,0,1700,200,1900,27.142857
5421,Saúde,68,2,2,1,3500,547,4047,59.514706
5422,Other,49,2,1,1,700,187,887,18.102041
5423,Bela Vista,110,3,3,1,2900,807,3707,33.7
5424,Vila Clementino,51,2,1,1,3700,650,4350,85.29412
5425,Vila Mariana,21,1,1,0,2100,350,2450,116.666664
5426,Santana,104,3,3,2,3000,1241,4241,40.778847
5427,Other,75,2,1,1,1900,798,2698,35.97333
5428,Other,60,2,2,1,1700,700,2400,40.0
5429,Tatuapé,46,2,1,0,1400,320,1720,37.391304
5430,Vila Mariana,77,3,1,2,3800,761,4561,59.233765
5431,Jardim Paulista,130,3,3,2,5000,1106,6106,46.96923
5432,Brás,72,3,2,1,2300,707,3007,41.76389
5433,Saúde,40,1,1,1,1700,425,2125,53.125
5434,Brás,72,3,2,0,2300,450,2750,38.194443
5435,Pinheiros,54,2,1,0,2400,451,2851,52.796295
5436,Jardim Paulista,58,1,1,1,2700,762,3462,59.689655
5437,Other,68,2,2,1,2500,1000,3500,51.47059
5438,Other,43,2,1,1,1100,348,1448,33.67442
5439,Other,110,3,4,2,4000,850,4850,44.090908
5440,Cambuci,26,1,1,0,1350,150,1500,57.692307
5441,Bela Vista,42,1,1,1,1700,462,2162,51.47619
5442,Vila Mariana,40,1,1,0,1500,497,1997,49.925
5443,Liberdade,30,1,1,0,2200,250,2450,81.666664
5444,Moema,40,1,1,1,2550,750,3300,82.5
5445,Consolação,39,1,1,1,2200,370,2570,65.89744
5446,Other,40,2,1,0,1300,150,1450,36.25
5447,Mirandópolis,41,1,1,1,2000,511,2511,61.243904
5448,Other,75,2,2,2,3600,902,4502,60.02667
5449,Other,82,3,2,1,2600,538,3138,38.26829
5450,Pinheiros,71,2,2,2,5500,1007,6507,91.64789
5451,Chácara Santo Antônio,73,2,1,1,4500,710,5210,71.369865
5452,Brooklin,96,3,2,1,4500,1350,5850,60.9375
5453,Jardim Paulista,48,1,1,1,2045,950,2995,62.395832
5454,Cambuci,115,3,2,2,3500,1096,4596,39.965218
5455,Other,80,3,2,1,2100,0,2100,26.25
5456,Other,53,2,1,1,3200,400,3600,67.92453
5457,Móoca,64,2,2,1,2700,800,3500,54.6875
5458,Other,53,1,1,0,1600,914,2514,47.433964
5459,Other,69,2,2,1,3500,474,3974,57.594204
5460,Other,69,3,1,1,1500,600,2100,30.434782
5461,Vila Nova Conceição,105,2,2,1,6000,1450,7450,70.95238
5462,Vila Buarque,60,2,1,0,1800,563,2363,39.383335
5463,Vila Mariana,45,1,1,1,1900,662,2562,56.933334
5464,Ipiranga,71,3,2,1,1850,614,2464,34.704224
5465,Vila Clementino,65,2,2,1,4300,678,4978,76.58462
5466,Paraíso,40,1,1,1,1600,875,2475,61.875
5467,Moema,55,1,1,1,1800,1400,3200,58.18182
5468,Other,90,2,2,2,3360,979,4339,48.211113
5469,Brás,75,2,1,0,1500,0,1500,20.0
5470,Other,52,2,1,1,1450,269,1719,33.057693
5471,Morumbi,65,3,1,1,1700,485,2185,33.615383
5472,Vila Prudente,33,1,1,0,1350,75,1425,43.18182
5473,Perdizes,110,3,3,2,3600,1595,5195,47.227272
5474,Brás,50,1,1,0,690,454,1144,22.88
5475,Vila Leopoldina,88,3,3,2,3499,800,4299,48.852272
5476,Pompeia,38,1,1,1,1900,630,2530,66.57895
5477,Saúde,55,2,1,1,2300,562,2862,52.036366
5478,Consolação,61,1,2,0,2080,461,2541,41.65574
5479,Itaim Bibi,137,3,3,1,4500,1361,5861,42.78102
5480,Bela Vista,55,2,2,1,3100,844,3944,71.70909
5481,Other,66,1,2,2,3800,600,4400,66.666664
5482,Other,95,3,3,2,4100,650,4750,50.0
5483,Itaim Bibi,80,3,2,1,3250,1030,4280,53.5
5484,Consolação,94,2,2,1,2000,1050,3050,32.446808
5485,Other,63,3,2,1,1300,575,1875,29.761906
5486,Jardim Paulista,64,2,1,2,4000,850,4850,75.78125
5487,Barra Funda,70,2,2,2,2500,575,3075,43.92857
5488,Bela Vista,48,1,1,0,2200,900,3100,64.583336
5489,Pinheiros,84,1,2,2,6800,1400,8200,97.61905
5490,Barra Funda,33,1,1,1,1950,393,2343,71.0
5491,Jardim Paulista,98,3,3,0,2600,1391,3991,40.72449
5492,Aclimação,50,1,1,1,1450,492,1942,38.84
5493,Other,48,2,1,1,1499,0,1499,31.229166
5494,Tatuapé,27,1,1,1,1700,345,2045,75.74074
5495,Santa Cecília,31,1,1,0,1200,350,1550,50.0
5496,Vila Clementino,65,2,2,1,3500,980,4480,68.92308
5497,Other,87,3,3,2,3100,820,3920,45.057472
5498,Higienópolis,25,1,1,0,1650,230,1880,75.2
5499,Bela Vista,47,1,1,1,1850,817,2667,56.744682
5500,Other,64,2,2,1,4200,1000,5200,81.25
5501,Other,70,2,2,1,2500,848,3348,47.82857
5502,Moema,37,1,1,1,1600,1001,2601,70.297295
5503,Campo Belo,43,1,2,1,3100,352,3452,80.27907
5504,Vila Mariana,63,2,2,1,2500,770,3270,51.904762
5505,Vila Nova Conceição,50,1,1,1,3950,1375,5325,106.5
5506,Vila Mariana,94,3,2,1,3700,575,4275,45.47872
5507,Vila Olímpia,55,2,1,1,2500,748,3248,59.054546
5508,Vila Mariana,64,2,1,1,3500,750,4250,66.40625
5509,Other,65,3,2,1,1750,450,2200,33.846153
5510,Other,55,2,1,1,1400,320,1720,31.272728
5511,Other,55,2,1,0,1500,100,1600,29.09091
5512,Brás,96,3,2,1,1500,800,2300,23.958334
5513,Vila Olímpia,120,3,3,2,4500,1160,5660,47.166668
5514,Pinheiros,85,1,1,1,5150,1400,6550,77.05882
5515,Bela Vista,28,1,1,0,1100,374,1474,52.642857
5516,Aclimação,50,2,2,1,2500,642,3142,62.84
5517,Santana,60,2,1,1,1350,305,1655,27.583334
5518,Itaim Bibi,100,3,2,1,2700,1300,4000,40.0
5519,Vila Mariana,70,2,2,1,2800,1270,4070,58.142857
5520,Other,80,3,2,1,1200,615,1815,22.6875
5521,Bela Vista,113,3,2,0,2800,514,3314,29.327435
5522,Vila Prudente,45,2,1,1,1350,300,1650,36.666668
5523,Pinheiros,30,1,1,1,3000,550,3550,118.333336
5524,Vila Prudente,86,3,2,1,2000,650,2650,30.813953
5525,Pinheiros,60,2,2,1,4500,830,5330,88.833336
5526,Itaim Bibi,100,1,2,2,8600,1365,9965,99.65
5527,Liberdade,82,2,2,1,1850,907,2757,33.621952
5528,Brooklin,41,1,1,1,3800,630,4430,108.04878
5529,Lapa,50,2,1,1,1900,600,2500,50.0
5530,Other,49,1,1,1,3000,0,3000,61.22449
5531,Other,42,1,1,1,1600,535,2135,50.833332
5532,Butantã,60,2,1,1,1350,730,2080,34.666668
5533,Other,51,2,1,1,2500,640,3140,61.568626
5534,Vila Leopoldina,76,2,2,1,3600,700,4300,56.57895
5535,Liberdade,52,2,2,1,1500,620,2120,40.76923
5536,Vila Mariana,155,3,5,3,9000,1300,10300,66.451614
5537,Campo Belo,49,1,1,1,2850,550,3400,69.38776
5538,Other,50,2,1,1,1500,410,1910,38.2
5539,Paraíso,112,2,2,1,3900,1100,5000,44.642857
5540,Vila Mariana,75,3,2,1,3800,750,4550,60.666668
5541,Saúde,65,2,1,1,1800,750,2550,39.23077
5542,Vila Mariana,42,1,1,0,2400,390,2790,66.42857
5543,Moema,44,1,1,1,3300,505,3805,86.47727
5544,Vila Leopoldina,56,2,2,1,2600,550,3150,56.25
5545,Vila Madalena,30,1,1,0,2300,550,2850,95.0
5546,Chácara Santo Antônio,104,3,4,2,3900,980,4880,46.923077
5547,Vila Andrade,95,3,3,2,3500,1017,4517,47.547367
5548,Morumbi,67,2,2,2,2750,700,3450,51.49254
5549,Other,55,1,1,2,3800,500,4300,78.181816
5550,Vila Madalena,61,2,2,1,5100,850,5950,97.540985
5551,Campo Belo,100,3,3,2,4222,1278,5500,55.0
5552,Tatuapé,38,2,1,0,1500,400,1900,50.0
5553,Jardim Paulista,42,1,1,1,2500,1300,3800,90.47619
5554,Brás,48,2,1,1,1200,400,1600,33.333332
5555,Moema,50,1,2,1,2250,486,2736,54.72
5556,Other,55,3,1,1,1600,526,2126,38.654545
5557,Other,47,2,1,1,900,450,1350,28.723404
5558,Vila Olímpia,63,2,2,1,2400,915,3315,52.61905
5559,Chácara Santo Antônio,55,2,2,1,2150,1072,3222,58.581818
5560,Jabaquara,49,2,1,1,1290,610,1900,38.77551
5561,Vila Leopoldina,48,1,1,1,2600,454,3054,63.625
5562,Ipiranga,101,3,1,2,3500,795,4295,42.524754
5563,Campo Belo,70,2,1,1,2700,750,3450,49.285713
5564,Pinheiros,80,2,1,1,2100,760,2860,35.75
5565,Paraíso,79,2,2,2,6000,1041,7041,89.12658
5566,Bela Vista,47,2,1,1,3200,832,4032,85.78723
5567,Other,42,2,1,0,1600,160,1760,41.904762
5568,Bela Vista,45,1,1,1,3700,544,4244,94.31111
5569,Other,40,2,1,1,1500,0,1500,37.5
5570,Vila Andrade,69,2,2,1,2500,560,3060,44.347828
5571,Móoca,77,3,3,2,1600,1300,2900,37.66234
5572,Vila Mascote,60,2,1,1,1900,720,2620,43.666668
5573,Pinheiros,45,1,1,2,4100,600,4700,104.44444
5574,Morumbi,67,3,2,1,2000,450,2450,36.567165
5575,Perdizes,58,2,2,1,2100,630,2730,47.068966
5576,Santo Amaro,40,1,1,1,2500,0,2500,62.5
5577,Consolação,58,2,1,1,2600,690,3290,56.724136
5578,Vila Clementino,96,3,4,2,4000,1150,5150,53.645832
5579,Bela Vista,30,1,1,0,900,414,1314,43.8
5580,Pinheiros,60,2,2,1,2254,706,2960,49.333332
5581,Itaim Bibi,92,2,3,1,4000,1206,5206,56.586956
5582,Paraíso,90,2,2,1,3400,875,4275,47.5
5583,Other,84,3,2,2,3500,0,3500,41.666668
5584,Morumbi,48,2,1,1,1400,1200,2600,54.166668
5585,Perdizes,37,1,1,1,2300,560,2860,77.297295
5586,Aclimação,46,1,1,1,1800,501,2301,50.02174
5587,Other,59,2,2,1,3000,600,3600,61.01695
5588,Other,44,2,1,1,1650,257,1907,43.340908
5589,Saúde,73,3,2,2,2700,920,3620,49.589043
5590,Pinheiros,103,3,2,1,3500,1220,4720,45.82524
5591,Vila Olímpia,64,2,2,1,5200,800,6000,93.75
5592,Vila Nova Conceição,140,2,2,2,8000,1200,9200,65.71429
5593,Lapa,57,2,1,1,1000,510,1510,26.491228
5594,Consolação,37,1,1,1,2200,570,2770,74.86487
5595,Other,46,2,1,1,1500,317,1817,39.5
5596,Cambuci,68,2,1,1,1800,668,2468,36.294117
5597,Other,69,2,2,1,6300,376,6676,96.753624
5598,Paraíso,40,1,1,1,2200,653,2853,71.325
5599,Vila Mariana,98,3,1,2,4000,800,4800,48.97959
5600,Other,39,2,1,0,3500,350,3850,98.71795
5601,Santana,70,2,2,1,1700,570,2270,32.42857
5602,Ipiranga,82,2,2,2,1600,560,2160,26.341463
5603,Consolação,35,1,1,0,1200,295,1495,42.714287
5604,Other,74,3,2,2,2000,855,2855,38.58108
5605,Moema,31,1,1,1,3300,350,3650,117.741936
5606,Brooklin,55,2,2,1,2500,962,3462,62.945454
5607,Other,49,2,1,1,1100,350,1450,29.591837
5608,Other,75,2,2,0,2500,631,3131,41.746666
5609,Móoca,33,1,1,0,2200,272,2472,74.90909
5610,Perdizes,70,2,2,1,2200,925,3125,44.642857
5611,Vila Olímpia,81,2,2,1,6000,0,6000,74.07407
5612,Vila Olímpia,74,2,1,1,2000,808,2808,37.945946
5613,Brooklin,38,1,1,1,3500,600,4100,107.89474
5614,Consolação,40,1,1,1,2500,500,3000,75.0
5615,Other,138,3,5,2,5000,1500,6500,47.101448
5616,Jabaquara,60,1,1,1,1400,740,2140,35.666668
5617,Bela Vista,28,1,1,0,1250,240,1490,53.214287
5618,Butantã,58,2,1,1,1300,660,1960,33.793102
5619,Santo Amaro,38,1,1,0,1249,0,1249,32.86842
5620,Other,30,1,1,0,1150,150,1300,43.333332
5621,Other,40,1,1,1,3200,586,3786,94.65
5622,Bela Vista,35,1,1,0,1700,279,1979,56.54286
5623,Saúde,68,2,1,1,2800,518,3318,48.794117
5624,Perdizes,80,2,2,1,2700,900,3600,45.0
5625,Santana,60,2,1,0,1500,600,2100,35.0
5626,Brooklin,75,2,2,1,2600,982,3582,47.76
5627,Jardim Paulista,65,2,2,1,4900,960,5860,90.15385
5628,Vila Olímpia,55,2,1,1,1800,1071,2871,52.2
5629,Pinheiros,68,2,1,1,2200,760,2960,43.52941
5630,Other,110,3,5,2,3300,1100,4400,40.0
5631,Jardim Paulista,45,2,1,1,2200,879,3079,68.422226
5632,Saúde,60,2,2,2,3000,680,3680,61.333332
5633,Vila Mariana,75,2,1,0,2600,580,3180,42.4
5634,Other,57,2,1,1,1200,575,1775,31.14035
5635,Other,90,2,2,0,1950,250,2200,24.444445
5636,Other,50,2,1,2,1100,781,1881,37.62
5637,Other,60,2,1,1,1380,1,1381,23.016666
5638,Liberdade,63,2,2,1,2150,710,2860,45.396824
5639,Vila Mariana,35,1,1,0,2000,626,2626,75.02857
5640,Itaim Bibi,70,1,2,1,8000,1000,9000,128.57143
5641,Other,49,2,1,1,1200,370,1570,32.040817
5642,Vila Mariana,106,3,1,2,2750,1531,4281,40.38679
5643,Jardim Paulista,130,3,3,1,7765,1550,9315,71.65385
5644,Cerqueira César,71,2,2,1,2900,886,3786,53.323944
5645,Cidade Monções,83,3,2,1,2300,825,3125,37.650604
5646,Bela Vista,37,1,1,0,1800,400,2200,59.45946
5647,Other,60,2,2,1,1700,1011,2711,45.183334
5648,Other,68,2,2,1,2500,545,3045,44.77941
5649,Pinheiros,118,3,2,1,2700,1400,4100,34.74576
5650,Campo Belo,45,1,1,1,2000,555,2555,56.77778
5651,Other,37,1,1,1,2300,512,2812,76.0
5652,Barra Funda,51,2,1,0,1250,363,1613,31.62745
5653,Aclimação,45,1,1,0,1500,350,1850,41.11111
5654,Higienópolis,130,3,3,2,6000,1230,7230,55.615383
5655,Vila Guarani,45,1,1,1,2200,494,2694,59.866665
5656,Other,25,1,1,0,900,190,1090,43.6
5657,Cerqueira César,40,1,1,0,1550,370,1920,48.0
5658,Paraíso,71,2,1,0,2100,410,2510,35.35211
5659,Vila Mariana,47,1,1,0,1700,400,2100,44.68085
5660,Other,50,2,1,1,1120,380,1500,30.0
5661,Other,22,1,1,1,2436,446,2882,131.0
5662,Vila Buarque,40,1,1,1,1500,681,2181,54.525
5663,Barra Funda,63,2,2,1,1800,890,2690,42.698414
5664,Higienópolis,45,1,2,1,1630,1050,2680,59.555557
5665,Vila Guarani,61,2,1,1,2000,629,2629,43.098362
5666,Chácara Santo Antônio,82,2,2,1,2000,495,2495,30.426828
5667,Moema,45,1,1,1,2395,776,3171,70.46667
5668,Moema,94,3,3,2,7300,1400,8700,92.55319
5669,Other,75,3,2,2,2100,370,2470,32.933334
5670,Saúde,77,2,2,1,1900,850,2750,35.714287
5671,Consolação,35,1,1,1,2300,650,2950,84.28571
5672,Other,30,1,1,0,2300,371,2671,89.03333
5673,Other,75,3,3,1,2200,720,2920,38.933334
5674,Vila Leopoldina,93,3,2,2,4300,815,5115,55.0
5675,Brooklin,69,2,2,1,4500,800,5300,76.81159
5676,Vila Nova Conceição,70,2,2,1,3100,1480,4580,65.42857
5677,Other,40,2,1,0,900,0,900,22.5
5678,Vila Mariana,74,2,2,2,4200,650,4850,65.54054
5679,Other,80,2,1,0,2200,100,2300,28.75
5680,Pinheiros,86,2,2,1,3000,1264,4264,49.581394
5681,Bela Vista,35,1,1,0,1400,450,1850,52.857143
5682,Other,68,3,1,1,2100,0,2100,30.882353
5683,Santana,86,3,3,2,1600,1000,2600,30.232557
5684,Other,62,2,1,1,1250,350,1600,25.806452
5685,Other,74,3,1,1,1700,678,2378,32.135136
5686,Moema,95,3,1,2,3300,1447,4747,49.968422
5687,Ipiranga,48,2,1,1,1800,521,2321,48.354168
5688,Brooklin,67,2,2,2,4900,1200,6100,91.04478
5689,Other,50,1,1,0,1350,0,1350,27.0
5690,Other,50,2,1,1,1300,350,1650,33.0
5691,Aclimação,85,3,3,1,3200,830,4030,47.411766
5692,Other,68,3,2,1,2500,630,3130,46.02941
5693,Jardim Paulista,60,2,2,1,4000,850,4850,80.833336
5694,Paraíso,57,2,2,1,2900,978,3878,68.03509
5695,Brooklin,68,2,3,1,2500,1190,3690,54.264706
5696,Morumbi,90,3,2,2,3800,663,4463,49.58889
5697,Bela Vista,48,1,1,0,1900,900,2800,58.333332
5698,Itaim Bibi,45,1,1,1,2000,670,2670,59.333332
5699,Pinheiros,70,2,1,1,2600,390,2990,42.714287
5700,Other,70,3,2,1,1800,580,2380,34.0
5701,Paraíso,56,2,2,1,2200,883,3083,55.05357
5702,Other,50,2,1,1,1330,670,2000,40.0
5703,Other,64,2,1,1,1050,650,1700,26.5625
5704,Other,70,2,2,1,2300,375,2675,38.214287
5705,Santana,30,1,1,1,2700,0,2700,90.0
5706,Vila Mariana,40,1,2,1,2200,490,2690,67.25
5707,Other,85,2,1,1,2280,0,2280,26.82353
5708,Cambuci,49,2,1,1,1600,500,2100,42.857143
5709,Perdizes,65,2,2,2,3000,700,3700,56.923077
5710,Other,55,3,1,1,1300,565,1865,33.909092
5711,Consolação,62,1,1,1,1800,492,2292,36.967743
5712,Moema,90,3,2,1,3400,317,3717,41.3
5713,Jaguaré,70,3,1,1,2650,0,2650,37.857143
5714,Tatuapé,70,2,2,2,2400,711,3111,44.442856
5715,Itaim Bibi,37,1,1,1,1900,630,2530,68.37838
5716,Other,56,2,1,1,2800,0,2800,50.0
5717,Barra Funda,33,1,1,0,1600,290,1890,57.272728
5718,Pinheiros,100,3,2,0,3000,818,3818,38.18
5719,Pinheiros,60,2,2,1,2300,1243,3543,59.05
5720,Móoca,60,1,1,0,1200,200,1400,23.333334
5721,Other,55,1,1,1,3200,470,3670,66.72727
5722,Vila Guarani,63,2,2,1,2000,680,2680,42.539684
5723,Moema,46,1,1,1,3000,529,3529,76.71739
5724,Pinheiros,42,1,1,1,2500,670,3170,75.47619
5725,Campo Belo,50,1,1,1,3500,450,3950,79.0
5726,Bela Vista,54,1,1,1,1800,1600,3400,62.962963
5727,Other,75,2,2,2,4100,1055,5155,68.73333
5728,Other,56,2,2,1,2200,553,2753,49.160713
5729,Moema,104,2,2,2,6000,1200,7200,69.23077
5730,Other,49,1,1,1,2800,480,3280,66.938774
5731,Other,35,1,1,0,1000,30,1030,29.428572
5732,Vila Mariana,57,2,2,1,2750,920,3670,64.38596
5733,Brooklin,37,1,1,1,2300,700,3000,81.08108
5734,Vila Nova Conceição,36,1,1,1,1800,1042,2842,78.94444
5735,Other,74,2,2,2,2150,671,2821,38.12162
5736,Other,70,3,2,1,2300,450,2750,39.285713
5737,Other,43,2,1,1,1450,0,1450,33.720932
5738,Other,50,2,1,1,1500,400,1900,38.0
5739,Moema,60,2,2,1,4100,780,4880,81.333336
5740,Jardins,45,1,1,1,4800,735,5535,123.0
5741,Vila Leopoldina,83,3,2,2,3300,950,4250,51.20482
5742,Vila Leopoldina,70,2,2,1,2400,677,3077,43.95714
5743,Vila Clementino,112,3,3,1,2700,1050,3750,33.482143
5744,Vila Olímpia,94,3,3,3,7500,1172,8672,92.25532
5745,Perdizes,115,3,3,2,4500,1480,5980,52.0
5746,Other,63,2,2,0,2500,535,3035,48.174603
5747,Ipiranga,86,2,3,2,2500,980,3480,40.465115
5748,Higienópolis,38,1,1,1,1500,540,2040,53.68421
5749,Pompeia,73,3,2,1,2700,853,3553,48.671234
5750,Pinheiros,75,3,2,1,3500,1100,4600,61.333332
5751,Vila Mariana,33,1,1,1,1500,483,1983,60.090908
5752,Other,50,2,1,0,1300,150,1450,29.0
5753,Bela Vista,39,1,1,1,2400,480,2880,73.84615
5754,Other,50,1,1,0,750,180,930,18.6
5755,Santo Amaro,130,3,3,2,5250,1170,6420,49.384617
5756,Vila Mariana,89,3,1,2,2900,650,3550,39.88764
5757,Other,85,2,2,2,5800,1404,7204,84.752945
5758,Moema,87,2,2,1,3500,685,4185,48.103447
5759,Other,75,3,2,1,1990,940,2930,39.066666
5760,Jardim Paulista,115,3,2,2,5500,1050,6550,56.95652
5761,Other,47,2,1,1,1500,0,1500,31.914894
5762,Butantã,20,1,1,0,1200,0,1200,60.0
5763,Vila Mariana,120,4,3,2,3500,916,4416,36.8
5764,Pinheiros,53,1,1,2,2800,940,3740,70.56604
5765,Other,122,3,4,2,5000,1100,6100,50.0
5766,Higienópolis,63,2,2,2,5000,819,5819,92.36508
5767,Campo Belo,43,1,1,1,2450,654,3104,72.18604
5768,Butantã,55,2,1,1,1800,560,2360,42.909092
5769,Perdizes,100,3,2,1,2300,1094,3394,33.94
5770,Saúde,37,1,1,1,2000,450,2450,66.21622
5771,Vila Clementino,68,2,1,0,1500,542,2042,30.029411
5772,Paraíso,40,1,1,1,2100,715,2815,70.375
5773,Santana,123,3,3,2,2100,1395,3495,28.414635
5774,Aclimação,88,3,2,2,2300,847,3147,35.761364
5775,Mirandópolis,40,1,1,1,1400,475,1875,46.875
5776,Other,70,2,1,0,1400,0,1400,20.0
5777,Bela Vista,40,1,1,1,1400,570,1970,49.25
5778,Other,75,2,2,1,1600,510,2110,28.133333
5779,Consolação,161,3,2,1,4990,0,4990,30.99379
5780,Brooklin,70,2,2,1,2790,860,3650,52.142857
5781,Santa Cecília,188,3,3,2,4500,1514,6014,31.98936
5782,Perdizes,137,4,4,3,7000,1700,8700,63.50365
5783,Vila Guarani,50,2,1,1,1400,700,2100,42.0
5784,Pinheiros,82,2,2,1,3500,800,4300,52.439026
5785,Santo Amaro,65,2,1,1,2790,490,3280,50.46154
5786,Ipiranga,140,3,2,2,6000,997,6997,49.978573
5787,Saúde,70,3,2,2,2500,574,3074,43.914288
5788,Vila Madalena,50,2,1,1,2200,336,2536,50.72
5789,Chácara Santo Antônio,80,2,2,2,5650,800,6450,80.625
5790,Vila Leopoldina,52,1,1,1,2600,600,3200,61.53846
5791,Paraíso,66,2,1,1,3700,470,4170,63.18182
5792,Itaim Bibi,97,2,3,1,3600,1241,4841,49.907215
5793,Cerqueira César,140,3,2,1,3200,1500,4700,33.57143
5794,Vila Buarque,60,2,2,1,3500,540,4040,67.333336
5795,Santa Cecília,75,2,2,2,3000,1496,4496,59.946667
5796,Other,30,1,1,1,2550,480,3030,101.0
5797,Paraíso,52,2,1,0,2100,435,2535,48.75
5798,Other,90,2,1,1,1500,885,2385,26.5
5799,Pinheiros,60,2,2,1,4500,860,5360,89.333336
5800,Cerqueira César,100,3,3,1,5000,1700,6700,67.0
5801,Itaim Bibi,29,1,1,1,3000,650,3650,125.86207
5802,Indianópolis,51,2,2,1,4500,0,4500,88.23529
5803,Other,70,3,2,2,1900,856,2756,39.37143
5804,Jaguaré,117,3,3,2,1900,700,2600,22.222221
5805,Pinheiros,73,2,2,2,4000,830,4830,66.16438
5806,Pinheiros,35,1,1,1,2563,768,3331,95.171425
5807,Jardim Paulista,132,2,3,2,9000,865,9865,74.73485
5808,Moema,157,4,5,3,9000,1550,10550,67.19745
5809,Vila Leopoldina,88,2,3,2,3500,0,3500,39.772728
5810,Other,83,2,4,2,3000,983,3983,47.987953
5811,Higienópolis,107,3,2,2,4000,1633,5633,52.64486
5812,Chácara Santo Antônio,112,3,4,2,5700,840,6540,58.392857
5813,Consolação,35,1,1,1,2900,480,3380,96.57143
5814,Lapa,65,2,1,1,1600,380,1980,30.461538
5815,Vila Olímpia,65,2,2,1,4600,880,5480,84.30769
5816,Other,52,2,1,1,1400,529,1929,37.096153
5817,Cidade Monções,38,1,1,1,2800,550,3350,88.1579
5818,Tatuapé,48,2,1,1,1500,375,1875,39.0625
5819,Itaim Bibi,100,3,2,1,4500,1000,5500,55.0
5820,Pinheiros,50,1,1,1,3500,565,4065,81.3
5821,Aclimação,42,1,1,0,1449,301,1750,41.666668
5822,Bela Vista,50,2,1,1,3200,430,3630,72.6
5823,Other,40,2,1,0,1210,140,1350,33.75
5824,Pinheiros,100,3,2,1,2600,1073,3673,36.73
5825,Brooklin,35,1,1,1,2500,550,3050,87.14286
5826,Other,50,2,1,0,1170,0,1170,23.4
5827,Other,61,2,1,2,1500,700,2200,36.065575
5828,Other,62,2,2,1,4700,818,5518,89.0
5829,Itaim Bibi,45,1,1,1,2500,1150,3650,81.111115
5830,Jardim América,120,3,2,1,3000,1281,4281,35.675
5831,Chácara Santo Antônio,70,2,2,1,3200,734,3934,56.2
5832,Other,50,1,1,0,1000,265,1265,25.3
5833,Bela Vista,35,1,1,1,1500,400,1900,54.285713
5834,Brás,60,2,1,1,1300,490,1790,29.833334
5835,Other,60,2,1,1,1800,496,2296,38.266666
5836,Other,64,2,2,1,2200,400,2600,40.625
5837,Mirandópolis,98,3,3,2,4500,893,5393,55.030613
5838,Vila Leopoldina,96,2,2,1,2500,780,3280,34.166668
5839,Indianópolis,97,3,3,2,3800,1300,5100,52.57732
5840,Other,59,3,2,1,1500,740,2240,37.966103
5841,Butantã,60,2,2,1,1900,368,2268,37.8
5842,Other,72,2,3,2,3200,650,3850,53.47222
5843,Liberdade,45,2,1,1,1700,203,1903,42.288887
5844,Vila Mariana,120,3,3,1,3000,1500,4500,37.5
5845,Bela Vista,47,2,1,1,3200,900,4100,87.23404
5846,Higienópolis,37,1,1,1,2600,733,3333,90.08108
5847,Jardim Paulista,120,4,3,1,4000,1488,5488,45.733334
5848,Jardins,48,2,1,1,1800,880,2680,55.833332
5849,Campo Belo,107,2,3,2,4200,800,5000,46.728973
5850,Vila Andrade,70,2,1,1,1400,700,2100,30.0
5851,Other,52,2,1,1,1400,300,1700,32.692307
5852,Consolação,70,2,2,0,2100,0,2100,30.0
5853,Other,81,3,2,2,4000,700,4700,58.024693
5854,Centro,50,1,1,1,1900,650,2550,51.0
5855,Brooklin,39,1,1,1,3250,560,3810,97.69231
5856,Brooklin,55,1,2,1,1900,782,2682,48.763638
5857,Other,36,2,1,0,1200,200,1400,38.88889
5858,Morumbi,50,2,1,1,1880,420,2300,46.0
5859,Other,90,2,2,1,2200,577,2777,30.855556
5860,Other,40,2,1,1,2200,480,2680,67.0
5861,Vila Mariana,59,1,2,1,2200,720,2920,49.491524
5862,Liberdade,20,1,1,0,600,400,1000,50.0
5863,Centro,72,2,1,0,1800,500,2300,31.944445
5864,Santa Cecília,75,3,3,2,2500,1250,3750,50.0
5865,Perdizes,82,2,2,2,2900,1110,4010,48.90244
5866,Other,50,2,2,2,2200,490,2690,53.8
5867,Vila Olímpia,61,2,1,0,1800,495,2295,37.62295
5868,Campo Belo,42,1,2,1,3200,580,3780,90.0
5869,Tatuapé,55,2,1,1,2100,450,2550,46.363636
5870,Brooklin,115,3,3,2,3100,1479,4579,39.81739
5871,Vila Mascote,110,3,4,3,5500,759,6259,56.9
5872,Other,77,3,2,1,2950,0,2950,38.311687
5873,Bela Vista,45,1,1,0,1500,510,2010,44.666668
5874,Other,75,3,3,2,2500,998,3498,46.64
5875,Vila Clementino,40,1,1,1,2200,450,2650,66.25
5876,Moema,55,2,2,2,3150,950,4100,74.545456
5877,Other,48,2,1,1,1200,430,1630,33.958332
5878,Other,30,1,1,0,700,50,750,25.0
5879,Other,38,1,1,1,1700,496,2196,57.789474
5880,Perdizes,70,3,2,1,2800,924,3724,53.2
5881,Other,35,1,1,0,900,202,1102,31.485714
5882,Other,100,2,2,1,2500,700,3200,32.0
5883,Móoca,93,3,2,2,2200,1200,3400,36.55914
5884,Cerqueira César,125,3,3,1,7500,1550,9050,72.4
5885,Vila Nova Conceição,91,3,2,1,3500,448,3948,43.384617
5886,Moema,100,3,3,2,6750,850,7600,76.0
5887,Pinheiros,63,2,2,0,2900,350,3250,51.587303
5888,Vila Madalena,54,1,1,1,2000,982,2982,55.22222
5889,Pinheiros,30,1,1,1,2150,742,2892,96.4
5890,Móoca,100,3,1,0,1320,0,1320,13.2
5891,Pompeia,80,3,3,2,3500,650,4150,51.875
5892,Other,65,3,1,1,1400,574,1974,30.36923
5893,Brooklin,51,1,1,1,3300,590,3890,76.27451
5894,Vila Olímpia,41,1,1,1,3800,0,3800,92.68293
5895,Vila Olímpia,79,3,1,2,3200,1139,4339,54.92405
5896,Campo Belo,42,1,1,1,1700,750,2450,58.333332
5897,Vila Mascote,75,2,1,1,2200,0,2200,29.333334
5898,Other,30,1,1,1,1300,402,1702,56.733334
5899,Jaguaré,60,2,1,1,1250,506,1756,29.266666
5900,Other,90,3,2,2,3200,1300,4500,50.0
5901,Mirandópolis,25,1,1,0,1900,350,2250,90.0
5902,Other,98,2,2,1,2300,823,3123,31.867348
5903,Other,68,3,2,1,1800,756,2556,37.588234
5904,Liberdade,60,1,2,1,1750,907,2657,44.283333
5905,Campo Belo,46,1,1,1,2600,560,3160,68.695656
5906,Jardim Paulista,130,2,3,1,5000,1180,6180,47.53846
5907,Moema,55,1,1,1,3450,720,4170,75.818184
5908,Vila Mariana,50,1,1,1,1650,685,2335,46.7
5909,Vila Clementino,53,2,1,1,4000,650,4650,87.73585
5910,Santana,40,1,1,0,1400,265,1665,41.625
5911,Jardim Paulista,98,2,3,1,4000,1698,5698,58.142857
5912,Other,118,3,4,3,3300,1175,4475,37.92373
5913,Brás,36,1,1,1,2100,465,2565,71.25
5914,Aclimação,26,1,1,1,2000,350,2350,90.38461
5915,Santo Amaro,50,2,1,0,1600,670,2270,45.4
5916,Jabaquara,90,3,1,1,1500,200,1700,18.88889
5917,Jardim Marajoara,70,3,2,2,2900,0,2900,41.42857
5918,Cidade Monções,54,2,2,1,2200,731,2931,54.27778
5919,Other,55,2,2,2,1800,700,2500,45.454544
5920,Aclimação,39,1,1,1,2260,530,2790,71.53846
5921,Itaim Bibi,90,3,3,1,3400,861,4261,47.344444
5922,Jardim Paulista,99,2,3,0,3400,876,4276,43.191917
5923,Vila Mariana,70,2,1,0,1900,310,2210,31.571428
5924,Other,51,1,1,1,2900,600,3500,68.62745
5925,Higienópolis,80,3,3,2,4800,1062,5862,73.275
5926,Other,60,2,2,2,1600,769,2369,39.483334
5927,Lapa,54,2,2,2,3000,734,3734,69.14815
5928,Bela Vista,38,1,1,1,1050,715,1765,46.44737
5929,Campo Belo,130,3,2,2,4000,1300,5300,40.76923
5930,Vila Andrade,66,3,2,2,1901,570,2471,37.439392
5931,Vila Olímpia,77,1,2,1,7800,1200,9000,116.88312
5932,Itaim Bibi,105,3,4,2,7000,1400,8400,80.0
5933,Cambuci,136,3,3,1,1950,1000,2950,21.691177
5934,Other,45,1,1,1,3000,450,3450,76.666664
5935,Vila Mariana,64,2,2,2,3000,935,3935,61.484375
5936,Other,56,2,2,1,1700,420,2120,37.857143
5937,Brooklin,45,1,1,1,3200,586,3786,84.13333
5938,Brooklin,85,3,3,2,3600,1003,4603,54.152943
5939,Other,45,1,1,0,1300,340,1640,36.444443
5940,Saúde,41,1,1,1,1900,550,2450,59.756096
5941,Bela Vista,45,1,1,1,2000,575,2575,57.22222
5942,Other,55,2,2,2,1600,700,2300,41.81818
5943,Moema,75,2,2,2,4550,1067,5617,74.89333
5944,Vila Leopoldina,127,3,5,2,5400,900,6300,49.6063
5945,Bela Vista,68,2,1,1,2800,1445,4245,62.42647
5946,Other,110,4,4,2,5400,1280,6680,60.727272
5947,Móoca,63,2,2,1,2000,590,2590,41.11111
5948,Barra Funda,40,1,1,1,1650,438,2088,52.2
5949,Cerqueira César,36,1,2,0,1650,650,2300,63.88889
5950,Other,56,2,1,1,1050,200,1250,22.321428
5951,Vila Mariana,77,3,1,2,3500,770,4270,55.454544
5952,Morumbi,70,1,1,1,2400,700,3100,44.285713
5953,Other,40,1,1,0,1600,0,1600,40.0
5954,Moema,60,1,1,1,2400,850,3250,54.166668
5955,Vila Olímpia,60,1,2,1,6000,890,6890,114.833336
5956,Perdizes,110,3,3,1,3600,1177,4777,43.427273
5957,Campo Belo,62,2,2,1,2400,720,3120,50.322582
5958,Other,35,1,1,0,550,0,550,15.714286
5959,Moema,131,3,3,0,3200,1100,4300,32.82443
5960,Brooklin,51,1,1,1,3220,545,3765,73.82353
5961,Vila Buarque,110,3,3,1,4000,1490,5490,49.909092
5962,Perdizes,65,2,2,2,3400,990,4390,67.53846
5963,Other,60,2,1,2,1450,850,2300,38.333332
5964,Barra Funda,50,1,1,1,2600,514,3114,62.28
5965,Pinheiros,70,2,2,1,4700,952,5652,80.74286
5966,Móoca,64,2,2,1,1700,800,2500,39.0625
5967,Santo Amaro,101,3,3,2,3800,1195,4995,49.455444
5968,Other,40,2,1,0,1100,150,1250,31.25
5969,Vila Guarani,58,2,2,1,1700,688,2388,41.172413
5970,Other,50,2,1,1,1200,0,1200,24.0
5971,Centro,89,2,2,0,2650,300,2950,33.14607
5972,Other,70,3,2,1,1600,618,2218,31.685715
5973,Bela Vista,45,1,1,1,3500,544,4044,89.86667
5974,Vila Olímpia,76,2,1,2,4000,800,4800,63.157894
5975,Brooklin,80,3,3,2,3000,1221,4221,52.7625
5976,Centro,47,1,1,1,2500,632,3132,66.6383
5977,Jaguaré,52,2,1,1,1400,403,1803,34.673077
5978,Other,65,2,2,1,1700,800,2500,38.46154
5979,Other,53,1,2,1,1450,981,2431,45.867924
5980,Vila Buarque,55,1,1,0,2100,620,2720,49.454544
5981,Liberdade,90,3,2,2,2800,1009,3809,42.322224
5982,Vila Guarani,54,2,2,1,2100,0,2100,38.88889
5983,Pinheiros,85,2,2,2,5500,775,6275,73.82353
5984,Lapa,52,2,1,1,1700,396,2096,40.307693
5985,Brooklin,67,2,2,1,3500,763,4263,63.626865
5986,Brooklin,90,3,3,2,3500,1104,4604,51.155556
5987,Other,62,2,1,1,1900,480,2380,38.387096
5988,Moema,70,2,1,1,1500,717,2217,31.671429
5989,Other,48,2,1,1,1250,565,1815,37.8125
5990,Pinheiros,55,2,1,0,2000,0,2000,36.363636
5991,Other,48,2,1,1,1121,279,1400,29.166666
5992,Bela Vista,60,2,2,1,2800,750,3550,59.166668
5993,Móoca,142,3,5,2,4000,1162,5162,36.35211
5994,Other,65,2,2,1,1650,324,1974,30.36923
5995,Other,49,2,1,1,850,200,1050,21.428572
5996,Mirandópolis,62,3,2,1,1800,350,2150,34.677418
5997,Jardim Paulista,74,2,2,2,4500,610,5110,69.054054
5998,Other,40,2,1,1,2100,0,2100,52.5
5999,Ipiranga,75,2,2,1,3000,750,3750,50.0
6000,Other,50,2,1,1,1150,320,1470,29.4
6001,Mirandópolis,60,2,2,2,3000,900,3900,65.0
6002,Other,47,1,2,1,2500,650,3150,67.02128
6003,Other,52,2,1,1,1150,300,1450,27.884615
6004,Vila Madalena,60,2,2,2,3800,1100,4900,81.666664
6005,Other,70,2,1,1,1600,757,2357,33.67143
6006,Moema,80,3,2,1,3800,935,4735,59.1875
6007,Other,72,3,1,2,2500,873,3373,46.84722
6008,Other,45,1,1,1,2100,700,2800,62.22222
6009,Tatuapé,128,3,3,3,3500,1286,4786,37.390625
6010,Vila Mariana,32,1,1,0,1380,230,1610,50.3125
6011,Other,89,2,3,2,4300,800,5100,57.30337
6012,Other,67,2,2,2,4000,750,4750,70.89552
6013,Ipiranga,111,3,4,2,5500,1000,6500,58.55856
6014,Jardim Marajoara,75,3,2,2,1600,706,2306,30.746666
6015,Tatuapé,65,2,2,2,2200,576,2776,42.70769
6016,Moema,53,2,2,1,2700,481,3181,60.018867
6017,Perdizes,65,2,2,1,2950,761,3711,57.092308
6018,Santa Cecília,52,2,1,1,2300,386,2686,51.653847
6019,Other,45,2,1,1,1000,75,1075,23.88889
6020,Vila Olímpia,54,2,1,1,3500,660,4160,77.03704
6021,Vila Mariana,56,2,2,1,2600,1065,3665,65.44643
6022,Jardim Paulista,45,1,1,1,3600,0,3600,80.0
6023,Jabaquara,49,2,1,1,1500,500,2000,40.816326
6024,Ipiranga,70,3,1,1,2600,700,3300,47.142857
6025,Vila Mascote,66,2,2,1,2000,750,2750,41.666668
6026,Consolação,42,1,1,1,2000,483,2483,59.11905
6027,Brooklin,35,1,1,1,2700,550,3250,92.85714
6028,Ipiranga,50,2,1,1,2300,570,2870,57.4
6029,Saúde,56,2,2,1,4000,628,4628,82.64286
6030,Moema,70,2,1,1,2800,956,3756,53.657143
6031,Other,42,2,1,1,1000,120,1120,26.666666
6032,Vila Mariana,102,3,3,2,4800,850,5650,55.39216
6033,Bela Vista,120,3,2,1,4200,0,4200,35.0
6034,Tatuapé,58,2,1,1,2000,439,2439,42.051723
6035,Bela Vista,42,1,1,0,1600,375,1975,47.02381
6036,Vila Madalena,66,1,1,1,3400,1200,4600,69.69697
6037,Cerqueira César,38,1,1,1,2000,509,2509,66.02631
6038,Other,62,2,2,1,1900,890,2790,45.0
6039,Pinheiros,61,2,2,1,2950,1203,4153,68.08197
6040,Vila Buarque,65,2,2,1,1800,1039,2839,43.67692
6041,Campo Belo,37,1,1,1,2500,500,3000,81.08108
6042,Brooklin,37,1,1,1,1500,698,2198,59.405407
6043,Campo Belo,73,2,2,2,5000,0,5000,68.49315
6044,Bela Vista,47,1,1,1,2250,815,3065,65.21277
6045,Other,105,2,2,2,3200,526,3726,35.485714
6046,Vila Mariana,127,3,2,1,3200,1050,4250,33.464565
6047,Brooklin,47,1,1,0,3500,738,4238,90.17021
6048,Jardim Paulista,42,1,1,2,3700,720,4420,105.2381
6049,Centro,46,1,1,0,2400,741,3141,68.28261
6050,Tatuapé,114,3,5,3,3200,1050,4250,37.2807
6051,Vila Clementino,98,3,3,2,4600,966,5566,56.795918
6052,Campo Belo,60,1,2,1,3635,752,4387,73.11667
6053,Vila Leopoldina,56,2,2,1,3400,534,3934,70.25
6054,Other,40,1,1,0,700,0,700,17.5
6055,Higienópolis,33,1,1,1,2900,550,3450,104.545456
6056,Other,103,3,3,2,3700,862,4562,44.291264
6057,Vila Olímpia,56,2,1,1,1800,1225,3025,54.017857
6058,Chácara Santo Antônio,101,3,3,2,3800,1184,4984,49.346535
6059,Moema,83,2,2,1,3000,1100,4100,49.39759
6060,Vila Mariana,40,1,1,1,2700,700,3400,85.0
6061,Itaim Bibi,100,2,2,1,3200,1300,4500,45.0
6062,Bela Vista,30,1,1,1,1700,514,2214,73.8
6063,Other,46,2,1,1,1100,380,1480,32.173912
6064,Other,47,1,1,1,1700,280,1980,42.12766
6065,Pinheiros,52,2,2,1,4200,800,5000,96.15385
6066,Brooklin,44,1,1,1,3400,585,3985,90.568184
6067,Santana,70,2,1,0,1300,584,1884,26.914286
6068,Other,56,2,1,1,1000,135,1135,20.267857
6069,Other,70,2,2,2,3500,958,4458,63.685715
6070,Pinheiros,58,1,1,1,4900,750,5650,97.413795
6071,Aclimação,40,1,1,1,2290,509,2799,69.975
6072,Other,63,3,2,1,1500,724,2224,35.301586
6073,Moema,170,4,1,2,6300,1400,7700,45.294117
6074,Santana,76,2,2,2,4000,600,4600,60.526318
6075,Aclimação,60,1,1,0,1450,549,1999,33.316666
6076,Brooklin,33,1,1,0,2900,750,3650,110.606064
6077,Brooklin,66,1,1,1,6500,650,7150,108.333336
6078,Vila Mariana,90,3,1,2,2800,1015,3815,42.38889
6079,Vila Madalena,87,2,2,0,2100,440,2540,29.195402
6080,Perdizes,50,1,1,1,1950,665,2615,52.3
6081,Other,165,3,4,3,7050,1,7051,42.733334
6082,Jardim Paulista,50,1,1,1,2700,694,3394,67.88
6083,Vila Mascote,86,3,3,2,4100,0,4100,47.67442
6084,Butantã,55,2,1,1,1600,520,2120,38.545456
6085,Pinheiros,74,2,2,1,3000,850,3850,52.027027
6086,Other,48,2,2,1,2300,550,2850,59.375
6087,Vila Olímpia,30,1,1,1,3000,700,3700,123.333336
6088,Barra Funda,33,1,1,1,1800,520,2320,70.30303
6089,Vila Leopoldina,83,3,3,2,3500,950,4450,53.614456
6090,Vila Andrade,120,3,3,2,5000,840,5840,48.666668
6091,Ipiranga,62,2,1,1,2600,550,3150,50.80645
6092,Other,64,2,3,1,2000,884,2884,45.0625
6093,Other,56,2,1,1,900,140,1040,18.571428
6094,Perdizes,80,2,3,2,5500,1413,6913,86.4125
6095,Cerqueira César,40,1,1,0,1650,370,2020,50.5
6096,Other,63,3,2,2,1700,600,2300,36.50794
6097,Other,49,1,2,1,3000,580,3580,73.061226
6098,Santa Cecília,36,1,1,0,2200,340,2540,70.55556
6099,Paraíso,104,3,2,1,3900,1047,4947,47.567307
6100,Other,52,2,1,1,1300,595,1895,36.442307
6101,Other,104,3,3,2,2200,650,2850,27.403847
6102,Other,60,2,2,1,2300,1100,3400,56.666668
6103,Other,70,2,1,0,1600,250,1850,26.428572
6104,Aclimação,100,3,3,1,3000,830,3830,38.3
6105,Cerqueira César,121,3,3,1,7700,1515,9215,76.15703
6106,Campo Belo,77,3,3,1,4000,1027,5027,65.28571
6107,Saúde,40,1,1,1,1600,408,2008,50.2
6108,Itaim Bibi,45,1,1,1,2300,908,3208,71.28889
6109,Aclimação,37,1,1,0,849,268,1117,30.18919
6110,Paraíso,78,2,3,2,4500,1100,5600,71.79487
6111,Pinheiros,57,1,1,1,4000,715,4715,82.7193
6112,Brás,71,3,2,1,2500,490,2990,42.112675
6113,Moema,42,1,1,1,2000,880,2880,68.57143
6114,Vila Mariana,50,2,2,1,2800,845,3645,72.9
6115,Other,100,3,2,1,2500,200,2700,27.0
6116,Other,110,3,4,3,6700,1396,8096,73.6
6117,Other,60,2,1,1,1300,450,1750,29.166666
6118,Vila Mariana,100,2,1,1,2000,668,2668,26.68
6119,Itaim Bibi,90,2,2,1,3900,1700,5600,62.22222
6120,Brooklin,68,1,2,2,4600,924,5524,81.23529
6121,Brooklin,45,1,2,1,2150,870,3020,67.111115
6122,Pompeia,70,3,2,2,2400,780,3180,45.42857
6123,Vila Mariana,43,1,1,1,2100,317,2417,56.2093
6124,Santana,60,2,1,0,1200,280,1480,24.666666
6125,Jardim Paulista,90,2,3,1,6700,1160,7860,87.333336
6126,Other,70,3,1,1,2400,491,2891,41.3
6127,Vila Mariana,40,1,1,1,3500,500,4000,100.0
6128,Itaim Bibi,55,1,2,1,2000,719,2719,49.436363
6129,Other,96,2,1,0,1500,250,1750,18.229166
6130,Other,52,2,1,1,1700,740,2440,46.923077
6131,Aclimação,85,3,3,1,3000,800,3800,44.705883
6132,Other,50,2,1,0,1500,350,1850,37.0
6133,Vila Mariana,95,2,2,1,3300,688,3988,41.978947
6134,Other,60,2,1,0,1700,180,1880,31.333334
6135,Chácara Santo Antônio,80,2,1,1,2500,680,3180,39.75
6136,Itaim Bibi,131,3,3,1,5000,945,5945,45.38168
6137,Vila Clementino,84,3,3,2,3600,1070,4670,55.595238
6138,Morumbi,112,2,4,2,3000,1676,4676,41.75
6139,Jardins,98,2,2,1,3500,1070,4570,46.632652
6140,Moema,70,2,3,2,3500,1500,5000,71.42857
6141,Other,52,2,1,1,1550,430,1980,38.076923
6142,Vila Mariana,59,2,2,2,2700,1349,4049,68.62712
6143,Other,121,1,1,0,1200,771,1971,16.289257
6144,Vila Olímpia,98,3,2,2,5000,1000,6000,61.22449
6145,Vila Olímpia,46,1,1,1,3500,1380,4880,106.08696
6146,Pinheiros,80,3,2,0,2900,564,3464,43.3
6147,Consolação,35,1,1,1,3200,550,3750,107.14286
6148,Other,65,3,1,1,1400,585,1985,30.538462
6149,Perdizes,110,3,3,1,4000,1415,5415,49.227272
6150,Other,90,2,4,2,3360,980,4340,48.22222
6151,Jardim Paulista,62,1,2,2,2900,1050,3950,63.70968
6152,Aclimação,48,2,1,0,1500,627,2127,44.3125
6153,Pinheiros,90,3,2,1,2600,930,3530,39.22222
6154,Vila Olímpia,65,1,2,1,5500,680,6180,95.07692
6155,Other,100,3,1,2,5500,950,6450,64.5
6156,Pompeia,116,3,2,1,3500,660,4160,35.86207
6157,Tatuapé,42,1,1,1,1440,667,2107,50.166668
6158,Other,75,3,2,1,1940,560,2500,33.333332
6159,Moema,50,1,1,1,1500,780,2280,45.6
6160,Pinheiros,93,3,3,1,3000,1450,4450,47.84946
6161,Paraíso,120,4,3,2,6000,1100,7100,59.166668
6162,Vila Mariana,82,2,2,1,2000,810,2810,34.26829
6163,Centro,50,1,1,0,1300,407,1707,34.14
6164,Liberdade,70,2,1,0,1700,535,2235,31.928572
6165,Other,53,1,2,1,3700,920,4620,87.169815
6166,Vila Mariana,105,3,3,1,3200,1210,4410,42.0
6167,Morumbi,78,1,2,2,2200,1468,3668,47.025642
6168,Vila Guarani,110,3,3,2,4300,980,5280,48.0
6169,Other,46,1,1,1,2100,381,2481,53.934784
6170,Vila Mariana,90,3,2,0,2200,290,2490,27.666666
6171,Higienópolis,70,2,1,0,2400,880,3280,46.857143
6172,Other,77,2,2,2,2300,1218,3518,45.688313
6173,Other,75,3,1,1,1500,650,2150,28.666666
6174,Moema,110,3,4,2,4500,1356,5856,53.236362
6175,Móoca,63,2,2,1,1800,530,2330,36.984127
6176,Ipiranga,67,2,2,1,3400,539,3939,58.791046
6177,Other,30,1,1,0,2000,523,2523,84.1
6178,Vila Mariana,66,2,2,1,2950,935,3885,58.863636
6179,Saúde,37,1,1,1,1700,576,2276,61.51351
6180,Jabaquara,78,3,2,1,1650,881,2531,32.44872
6181,Vila Mascote,70,2,2,2,3100,795,3895,55.642857
6182,Other,50,2,1,1,1300,500,1800,36.0
6183,Other,50,2,1,1,1800,292,2092,41.84
6184,Other,41,2,1,0,1100,0,1100,26.829268
6185,Other,32,2,1,0,950,50,1000,31.25
6186,Vila Buarque,32,1,1,1,1400,546,1946,60.8125
6187,Moema,75,2,3,1,4700,980,5680,75.73333
6188,Consolação,45,1,1,1,1800,622,2422,53.822224
6189,Other,65,2,1,1,2200,290,2490,38.307693
6190,Liberdade,35,1,1,0,850,250,1100,31.428572
6191,Chácara Santo Antônio,62,2,2,1,5200,784,5984,96.51613
6192,Santa Cecília,40,1,1,1,1600,600,2200,55.0
6193,Vila Mascote,64,2,2,2,2800,575,3375,52.734375
6194,Moema,80,2,2,1,2500,950,3450,43.125
6195,Cerqueira César,135,3,3,2,8000,980,8980,66.51852
6196,Vila Mascote,69,2,1,1,1880,920,2800,40.579712
6197,Vila Andrade,46,2,2,1,1330,470,1800,39.130436
6198,Paraíso,48,1,1,1,3500,0,3500,72.916664
6199,Morumbi,70,3,2,2,2200,630,2830,40.42857
6200,Perdizes,105,2,3,2,2800,1223,4023,38.314285
6201,Vila Nova Conceição,59,1,1,0,2100,416,2516,42.64407
6202,Consolação,56,2,1,1,2800,840,3640,65.0
6203,Other,62,3,2,1,1750,450,2200,35.48387
6204,Brooklin,98,3,3,2,4750,1330,6080,62.040817
6205,Jaguaré,70,3,1,1,2700,500,3200,45.714287
6206,Itaim Bibi,67,2,2,1,6200,0,6200,92.537315
6207,Vila Mariana,35,1,1,1,2000,929,2929,83.685715
6208,Consolação,52,1,1,1,1800,495,2295,44.134617
6209,Other,48,1,1,1,3350,1400,4750,98.958336
6210,Itaim Bibi,40,1,2,1,2000,620,2620,65.5
6211,Cambuci,25,1,1,0,950,0,950,38.0
6212,Other,67,2,2,1,3000,692,3692,55.104477
6213,Paraíso,83,2,1,1,2500,1240,3740,45.06024
6214,Vila Leopoldina,79,2,2,2,3600,789,4389,55.55696
6215,Pinheiros,70,1,1,0,2400,0,2400,34.285713
6216,Butantã,32,1,1,1,2800,530,3330,104.0625
6217,Vila Mariana,35,1,1,1,1490,1358,2848,81.37143
6218,Other,68,2,1,1,3000,0,3000,44.117645
6219,Mirandópolis,30,1,1,0,2240,175,2415,80.5
6220,Campo Belo,50,1,1,0,3200,587,3787,75.74
6221,Other,78,3,1,1,1500,706,2206,28.282051
6222,Other,49,2,1,1,1100,350,1450,29.591837
6223,Tatuapé,28,1,1,1,1700,300,2000,71.42857
6224,Santa Cecília,81,2,3,2,3200,947,4147,51.197533
6225,Other,65,3,2,1,1200,684,1884,28.984615
6226,Perdizes,110,2,3,3,4500,1571,6071,55.19091
6227,Other,120,3,3,3,3600,1172,4772,39.766666
6228,Chácara Santo Antônio,50,2,1,2,3500,671,4171,83.42
6229,Other,45,2,1,1,1600,450,2050,45.555557
6230,Moema,87,3,3,1,2500,1213,3713,42.67816
6231,Brooklin,55,1,1,1,3100,950,4050,73.63636
6232,Lapa,98,3,2,1,2000,449,2449,24.989796
6233,Itaim Bibi,60,1,2,1,5500,1000,6500,108.333336
6234,Brooklin,52,1,2,1,2000,1052,3052,58.692307
6235,Vila Olímpia,70,2,1,1,3300,580,3880,55.42857
6236,Tatuapé,89,2,4,1,2500,1550,4050,45.50562
6237,Other,48,2,1,0,1400,425,1825,38.020832
6238,Santana,40,1,1,2,2400,600,3000,75.0
6239,Perdizes,65,1,1,1,1750,350,2100,32.307693
6240,Consolação,43,1,1,1,2500,450,2950,68.60465
6241,Vila Olímpia,86,2,2,1,2200,860,3060,35.581394
6242,Other,70,3,2,1,1600,618,2218,31.685715
6243,Other,68,3,1,1,2000,580,2580,37.941177
6244,Móoca,42,1,1,0,1100,40,1140,27.142857
6245,Barra Funda,54,2,2,1,2300,572,2872,53.185184
6246,Liberdade,86,2,2,1,2200,890,3090,35.930233
6247,Brooklin,53,1,1,1,4000,900,4900,92.45283
6248,Other,64,3,1,1,1650,440,2090,32.65625
6249,Vila Mariana,110,3,2,1,2500,1100,3600,32.727272
6250,Brooklin,78,2,2,1,2600,840,3440,44.102566
6251,Other,138,3,5,2,7000,1100,8100,58.695652
6252,Pinheiros,86,2,2,0,2100,0,2100,24.418604
6253,Perdizes,42,1,1,1,1650,1150,2800,66.666664
6254,Other,168,4,4,3,8000,1500,9500,56.54762
6255,Moema,110,2,2,1,8000,1255,9255,84.13636
6256,Bela Vista,24,1,1,0,2900,217,3117,129.875
6257,Bela Vista,50,1,1,0,1300,280,1580,31.6
6258,Other,70,3,3,2,2500,546,3046,43.514286
6259,Itaim Bibi,50,1,1,1,2700,755,3455,69.1
6260,Perdizes,60,2,1,0,2500,200,2700,45.0
6261,Campo Belo,35,1,1,1,2050,650,2700,77.14286
6262,Higienópolis,30,1,1,1,2550,450,3000,100.0
6263,Perdizes,50,1,1,1,1900,680,2580,51.6
6264,Other,69,3,2,1,1550,700,2250,32.608696
6265,Other,85,3,2,2,2200,894,3094,36.4
6266,Saúde,43,1,1,1,1700,503,2203,51.23256
6267,Other,50,2,1,1,1500,430,1930,38.6
6268,Other,28,1,1,0,1700,250,1950,69.64286
6269,Pinheiros,80,2,2,1,3000,857,3857,48.2125
6270,Other,68,3,1,1,1800,450,2250,33.088234
6271,Bela Vista,40,1,1,1,2100,900,3000,75.0
6272,Vila Clementino,52,2,1,0,1700,441,2141,41.173077
6273,Moema,135,3,4,2,6000,1200,7200,53.333332
6274,Vila Olímpia,100,1,2,1,8000,1500,9500,95.0
6275,Other,126,3,5,3,4500,1300,5800,46.031746
6276,Vila Mariana,55,1,1,0,2000,355,2355,42.81818
6277,Brooklin,47,1,1,1,3800,650,4450,94.680855
6278,Cambuci,31,1,1,0,1200,250,1450,46.774193
6279,Saúde,37,1,1,1,1950,490,2440,65.945946
6280,Other,40,2,1,0,1000,500,1500,37.5
6281,Bela Vista,63,2,1,1,3600,1143,4743,75.28571
6282,Moema,81,2,2,2,6600,613,7213,89.049385
6283,Jardim Paulista,69,1,1,1,5400,1128,6528,94.608696
6284,Itaim Bibi,80,2,2,1,3100,992,4092,51.15
6285,Aclimação,40,1,1,0,1150,400,1550,38.75
6286,Tatuapé,52,2,2,1,2600,650,3250,62.5
6287,Jardim Paulista,60,1,1,1,2500,736,3236,53.933334
6288,Morumbi,74,2,2,2,2500,1100,3600,48.648647
6289,Itaim Bibi,67,2,2,0,1900,1043,2943,43.925373
6290,Other,70,2,2,2,2500,970,3470,49.57143
6291,Vila Mascote,75,2,2,1,2200,716,2916,38.88
6292,Pinheiros,67,2,2,2,3500,1050,4550,67.910446
6293,Itaim Bibi,80,2,2,2,7431,1580,9011,112.6375
6294,Other,59,2,1,0,1500,650,2150,36.440678
6295,Vila Prudente,35,1,1,0,1300,0,1300,37.142857
6296,Other,42,2,1,1,1100,220,1320,31.428572
6297,Vila Madalena,35,1,1,1,3300,600,3900,111.42857
6298,Higienópolis,130,2,4,2,4200,1606,5806,44.661537
6299,Other,65,2,2,1,4800,830,5630,86.61539
6300,Centro,61,1,2,0,1590,355,1945,31.885246
6301,Pinheiros,94,3,3,1,3500,1472,4972,52.893616
6302,Perdizes,65,1,1,0,1800,0,1800,27.692308
6303,Jardim América,130,3,3,1,4000,1660,5660,43.53846
6304,Pinheiros,70,3,3,1,2700,1032,3732,53.314285
6305,Liberdade,28,1,1,0,1350,310,1660,59.285713
6306,Bela Vista,43,1,1,0,1200,373,1573,36.581394
6307,Vila Leopoldina,70,2,1,1,2900,710,3610,51.57143
6308,Pinheiros,50,1,1,1,2700,670,3370,67.4
6309,Centro,27,1,1,0,1500,340,1840,68.14815
6310,Jardim Marajoara,79,3,2,2,3500,0,3500,44.3038
6311,Campo Belo,33,1,1,1,2180,670,2850,86.36364
6312,Other,47,2,1,1,1550,265,1815,38.61702
6313,Centro,47,2,1,1,2150,480,2630,55.957447
6314,Moema,90,2,4,2,4400,1170,5570,61.88889
6315,Vila Buarque,52,1,1,0,1500,526,2026,38.96154
6316,Other,20,1,1,0,1300,0,1300,65.0
6317,Jardim Paulista,119,2,3,1,3700,1415,5115,42.983192
6318,Other,57,3,1,1,2050,484,2534,44.45614
6319,Bela Vista,42,1,1,1,2500,415,2915,69.40476
6320,Pompeia,94,3,3,2,3350,1083,4433,47.159573
6321,Santo Amaro,65,2,2,1,3000,615,3615,55.615383
6322,Vila Olímpia,50,1,1,1,2695,707,3402,68.04
6323,Bela Vista,40,1,1,1,2100,516,2616,65.4
6324,Jabaquara,50,2,1,1,1000,685,1685,33.7
6325,Other,56,3,1,1,1150,150,1300,23.214285
6326,Other,54,1,1,2,2000,653,2653,49.12963
6327,Pinheiros,85,2,2,1,2200,1033,3233,38.035294
6328,Pinheiros,130,3,3,1,4500,1032,5532,42.553844
6329,Vila Prudente,72,2,1,1,1950,530,2480,34.444443
6330,Tatuapé,59,2,2,1,3000,465,3465,58.728813
6331,Aclimação,80,3,2,1,2500,840,3340,41.75
6332,Saúde,94,3,3,2,2800,950,3750,39.893616
6333,Other,72,2,2,2,3200,780,3980,55.27778
6334,Pinheiros,72,2,2,1,3000,800,3800,52.77778
6335,Vila Andrade,42,1,1,1,1450,412,1862,44.333332
6336,Vila Olímpia,43,1,1,1,2600,666,3266,75.95349
6337,Moema,55,2,1,1,2200,582,2782,50.581818
6338,Pinheiros,86,2,2,1,2500,1038,3538,41.139534
6339,Vila Olímpia,35,1,1,1,2700,660,3360,96.0
6340,Moema,70,2,2,2,5000,850,5850,83.57143
6341,Perdizes,72,1,1,1,2000,590,2590,35.97222
6342,Pompeia,110,2,2,2,3800,1062,4862,44.2
6343,Pinheiros,57,1,1,1,6000,888,6888,120.8421
6344,República,37,1,1,1,1400,450,1850,50.0
6345,Paraíso,77,2,3,1,2300,1223,3523,45.753246
6346,Other,70,3,2,2,1590,745,2335,33.357143
6347,Other,50,2,1,1,1600,600,2200,44.0
6348,Pinheiros,148,4,4,2,4500,1570,6070,41.01351
6349,Pinheiros,50,2,1,1,2300,616,2916,58.32
6350,Itaim Bibi,167,3,2,2,7000,0,7000,41.91617
6351,Other,48,2,1,1,1600,270,1870,38.958332
6352,Vila Buarque,46,2,1,0,1000,460,1460,31.73913
6353,Vila Clementino,40,1,1,1,2750,674,3424,85.6
6354,Bela Vista,45,1,1,1,1750,602,2352,52.266666
6355,Other,53,2,2,2,2250,616,2866,54.07547
6356,Other,73,3,2,2,2798,581,3379,46.28767
6357,Perdizes,120,3,2,2,4500,1450,5950,49.583332
6358,Other,52,1,1,1,1300,600,1900,36.53846
6359,Other,47,2,1,1,748,252,1000,21.276596
6360,Saúde,56,2,1,1,1999,1168,3167,56.55357
6361,Other,45,1,1,1,2200,450,2650,58.88889
6362,Consolação,174,3,2,1,5500,1700,7200,41.37931
6363,Vila Leopoldina,117,3,4,2,5400,810,6210,53.076923
6364,Vila Leopoldina,88,3,3,2,3500,990,4490,51.022728
6365,Campo Belo,130,3,4,2,2800,1310,4110,31.615385
6366,Itaim Bibi,61,1,2,1,6000,1050,7050,115.57377
6367,Campo Belo,80,2,3,2,3200,1007,4207,52.5875
6368,Other,70,2,1,0,1790,230,2020,28.857143
6369,Vila Nova Conceição,82,2,1,1,1900,785,2685,32.743904
6370,Other,56,2,2,1,1950,600,2550,45.535713
6371,Vila Nova Conceição,150,2,2,1,8400,1165,9565,63.766666
6372,Campo Belo,76,1,1,2,4800,1059,5859,77.0921
6373,Brooklin,73,2,3,1,4100,615,4715,64.58904
6374,Other,51,2,1,1,900,403,1303,25.549019
6375,Pinheiros,69,2,2,1,3200,720,3920,56.811596
6376,Other,62,2,2,1,3700,839,4539,73.20968
6377,Other,45,1,1,1,2000,600,2600,57.77778
6378,Jardim Paulista,47,1,1,1,2400,701,3101,65.97872
6379,Other,32,1,1,0,1200,140,1340,41.875
6380,Santa Cecília,56,2,2,1,2100,685,2785,49.732143
6381,Cambuci,26,1,1,0,1100,180,1280,49.23077
6382,Vila Nova Conceição,70,2,2,1,2600,809,3409,48.7
6383,Vila Guarani,53,1,1,1,2499,550,3049,57.5283
6384,Bela Vista,72,2,2,2,2900,982,3882,53.916668
6385,Perdizes,40,1,1,1,1600,650,2250,56.25
6386,Barra Funda,33,1,1,1,2300,393,2693,81.606064
6387,Brás,55,2,1,1,1200,600,1800,32.727272
6388,Butantã,49,2,1,1,1150,350,1500,30.612246
6389,Other,40,2,1,0,1750,350,2100,52.5
6390,Paraíso,105,3,2,1,5500,1250,6750,64.28571
6391,Bela Vista,32,1,1,1,1200,1000,2200,68.75
6392,Ipiranga,59,2,1,1,2000,700,2700,45.76271
6393,Other,78,3,1,2,2500,680,3180,40.76923
6394,Cambuci,27,1,1,0,1300,150,1450,53.703705
6395,Other,50,2,2,1,850,600,1450,29.0
6396,Pinheiros,73,2,3,2,3500,1580,5080,69.58904
6397,Jardim Paulista,44,1,1,1,2900,739,3639,82.704544
6398,Ipiranga,108,3,1,2,4500,1200,5700,52.77778
6399,Vila Nova Conceição,128,3,2,1,5300,1428,6728,52.5625
6400,Perdizes,76,3,3,3,2600,1540,4140,54.473682
6401,Pinheiros,68,2,1,1,2000,670,2670,39.264706
6402,Vila Mascote,60,2,2,1,2300,595,2895,48.25
6403,Other,71,1,1,0,1650,0,1650,23.239437
6404,Jaguaré,57,3,1,1,2000,560,2560,44.91228
6405,Butantã,58,2,1,1,1200,643,1843,31.775862
6406,Pinheiros,90,3,2,1,2500,847,3347,37.18889
6407,Vila Olímpia,59,1,1,1,3000,903,3903,66.15254
6408,Other,62,3,2,1,1650,500,2150,34.677418
6409,Pinheiros,72,3,2,1,5100,615,5715,79.375
6410,Pinheiros,65,2,1,1,3240,730,3970,61.076923
6411,Lapa,76,2,1,0,1500,581,2081,27.381578
6412,Consolação,37,1,1,1,1950,300,2250,60.81081
6413,Other,62,2,1,1,1700,518,2218,35.774193
6414,Vila Clementino,50,1,1,1,1600,850,2450,49.0
6415,Other,48,1,1,1,1820,496,2316,48.25
6416,Vila Mariana,54,2,1,1,1999,802,2801,51.87037
6417,Other,37,1,1,1,2200,495,2695,72.83784
6418,Other,48,2,1,1,921,600,1521,31.6875
6419,Cerqueira César,50,1,1,1,5500,0,5500,110.0
6420,República,130,3,2,0,2550,955,3505,26.961538
6421,Vila Buarque,67,2,2,1,4100,691,4791,71.50746
6422,Moema,40,1,1,1,2150,800,2950,73.75
6423,Pinheiros,84,2,2,2,8500,1200,9700,115.47619
6424,Other,65,2,1,2,2800,950,3750,57.692307
6425,Vila Guarani,55,2,2,1,2300,560,2860,52.0
6426,Other,130,3,4,2,3900,1300,5200,40.0
6427,Vila Mariana,40,1,1,1,1500,360,1860,46.5
6428,Other,53,2,1,1,2499,389,2888,54.490566
6429,Other,82,2,2,2,3200,830,4030,49.146343
6430,Jardim Paulista,70,2,2,1,2300,392,2692,38.45714
6431,Other,64,3,1,1,2000,519,2519,39.359375
6432,Paraíso,66,2,1,1,3500,800,4300,65.15151
6433,Cidade Monções,53,1,1,1,4440,640,5080,95.84906
6434,Brooklin,40,1,1,0,1750,0,1750,43.75
6435,Vila Nova Conceição,40,1,1,1,4300,600,4900,122.5
6436,Bela Vista,96,2,2,1,2800,800,3600,37.5
6437,Vila Olímpia,81,2,2,1,3200,920,4120,50.864197
6438,Other,44,1,1,1,1650,545,2195,49.886364
6439,Vila Clementino,38,1,1,1,1700,576,2276,59.894737
6440,Vila Mariana,45,1,1,1,2150,648,2798,62.177776
6441,Other,190,3,3,2,5360,681,6041,31.794737
6442,Barra Funda,35,2,1,0,1900,400,2300,65.71429
6443,Tatuapé,93,2,2,0,1500,460,1960,21.07527
6444,Other,22,1,1,0,2400,450,2850,129.54546
6445,Saúde,48,1,1,1,1800,500,2300,47.916668
6446,Vila Mariana,58,2,2,1,2500,700,3200,55.172413
6447,Santa Cecília,63,2,2,1,2500,890,3390,53.809525
6448,Aclimação,64,1,1,1,3200,0,3200,50.0
6449,Barra Funda,33,1,1,0,1600,260,1860,56.363636
6450,Other,45,1,1,1,2200,380,2580,57.333332
6451,Pompeia,80,2,2,2,5000,1340,6340,79.25
6452,Vila Prudente,85,3,2,1,1600,828,2428,28.564707
6453,Other,65,2,2,1,2700,0,2700,41.53846
6454,Perdizes,25,1,1,1,1800,483,2283,91.32
6455,Consolação,40,1,1,1,2600,479,3079,76.975
6456,Vila Leopoldina,117,4,4,2,3555,1200,4755,40.641026
6457,Vila Mariana,137,3,3,2,3500,1160,4660,34.0146
6458,Vila Buarque,37,1,1,1,1200,892,2092,56.54054
6459,Other,62,3,1,1,1400,730,2130,34.35484
6460,Other,44,1,1,1,1600,535,2135,48.522728
6461,Other,56,3,1,1,2800,500,3300,58.92857
6462,Moema,54,1,1,1,2100,765,2865,53.055557
6463,Santana,60,1,2,1,3200,654,3854,64.23333
6464,Santo Amaro,67,2,2,2,3500,720,4220,62.985073
6465,Vila Madalena,128,1,1,2,6700,1200,7900,61.71875
6466,Aclimação,83,3,2,1,2200,1052,3252,39.18072
6467,Vila Mascote,42,1,1,1,2700,500,3200,76.190475
6468,Moema,55,2,2,1,2500,520,3020,54.909092
6469,Vila Mariana,72,2,3,2,3520,1150,4670,64.861115
6470,Vila Mariana,90,3,3,1,2550,1450,4000,44.444443
6471,Vila Guarani,51,2,1,1,1980,599,2579,50.568626
6472,Vila Mariana,45,1,1,0,1500,160,1660,36.88889
6473,Moema,60,1,2,1,4300,842,5142,85.7
6474,Other,50,2,1,1,1100,700,1800,36.0
6475,Other,61,3,1,1,1300,650,1950,31.967213
6476,Other,58,2,2,1,1600,818,2418,41.689655
6477,Other,50,1,1,1,3500,1376,4876,97.52
6478,Centro,39,1,1,1,2000,508,2508,64.30769
6479,Vila Andrade,100,3,1,2,3490,948,4438,44.38
6480,Other,60,2,2,1,2300,341,2641,44.016666
6481,Tatuapé,35,1,1,1,2400,380,2780,79.42857
6482,Vila Olímpia,86,3,2,2,3500,1069,4569,53.127907
6483,Moema,110,4,3,2,6000,1140,7140,64.90909
6484,Pinheiros,84,1,2,2,6200,1400,7600,90.47619
6485,Paraíso,80,2,1,2,5400,1052,6452,80.65
6486,Móoca,210,4,4,2,4800,1300,6100,29.047619
6487,Vila Olímpia,56,1,1,1,4000,900,4900,87.5
6488,Other,35,1,1,1,2400,380,2780,79.42857
6489,Vila Mariana,60,2,2,2,2680,1096,3776,62.933334
6490,Vila Leopoldina,70,1,2,2,3750,1230,4980,71.14286
6491,Centro,37,1,1,0,1180,670,1850,50.0
6492,Other,53,2,1,1,1600,350,1950,36.792454
6493,Brooklin,40,1,1,1,3800,770,4570,114.25
6494,Bela Vista,37,1,1,1,2250,413,2663,71.97298
6495,Jabaquara,57,2,1,2,1600,543,2143,37.596493
6496,Consolação,81,1,1,1,2000,747,2747,33.91358
6497,Vila Mascote,100,3,3,2,3000,1100,4100,41.0
6498,Santa Cecília,130,2,2,1,4000,1160,5160,39.692307
6499,Paraíso,60,1,1,0,2600,491,3091,51.516666
6500,Vila Andrade,38,1,1,1,1490,379,1869,49.18421
6501,Other,116,3,1,1,1950,925,2875,24.784483
6502,Vila Andrade,150,3,4,2,5900,1129,7029,46.86
6503,Other,28,1,1,1,1600,570,2170,77.5
6504,Vila Clementino,127,3,5,3,6000,1660,7660,60.31496
6505,Paraíso,55,1,2,1,1700,640,2340,42.545456
6506,Bela Vista,70,2,1,1,2450,0,2450,35.0
6507,Jaguaré,70,3,2,2,2500,780,3280,46.857143
6508,Consolação,100,3,2,0,2800,680,3480,34.8
6509,Saúde,96,3,3,2,4500,0,4500,46.875
6510,Cidade Monções,70,2,2,2,4200,850,5050,72.14286
6511,Vila Madalena,57,2,2,1,2600,1056,3656,64.14035
6512,Barra Funda,33,1,1,1,2400,560,2960,89.69697
6513,Vila Olímpia,39,1,1,1,3800,702,4502,115.4359
6514,Jardim Paulista,90,2,1,1,3600,1121,4721,52.455555
6515,Jabaquara,72,2,1,1,1750,538,2288,31.777779
6516,Liberdade,44,1,1,1,1800,476,2276,51.727272
6517,Perdizes,143,3,5,3,5000,1675,6675,46.67832
6518,Other,38,1,1,1,1520,325,1845,48.55263
6519,Other,43,2,1,1,1950,0,1950,45.34884
6520,Moema,117,3,5,3,4600,1379,5979,51.102566
6521,Moema,25,1,1,0,2500,460,2960,118.4
6522,Moema,130,2,1,2,2900,1463,4363,33.56154
6523,Vila Olímpia,87,3,3,2,6100,915,7015,80.63219
6524,Other,94,2,1,1,5000,1700,6700,71.276596
6525,Pompeia,84,2,1,0,2100,390,2490,29.642857
6526,Other,50,2,1,1,2000,0,2000,40.0
6527,Vila Madalena,77,2,2,2,4700,970,5670,73.63636
6528,Jardim Paulista,90,2,2,0,3300,646,3946,43.844444
6529,Tatuapé,57,2,1,1,1600,432,2032,35.649124
6530,Vila Clementino,110,3,3,0,1950,980,2930,26.636364
6531,Jardins,37,1,1,1,1900,1350,3250,87.83784
6532,Vila Clementino,38,1,1,1,1900,670,2570,67.63158
6533,Vila Olímpia,100,2,2,1,2500,1150,3650,36.5
6534,Other,75,3,3,2,3500,765,4265,56.866665
6535,Pinheiros,60,2,1,0,2499,530,3029,50.483334
6536,Other,56,2,1,1,1038,162,1200,21.428572
6537,Other,72,3,2,2,2485,565,3050,42.36111
6538,Campo Belo,45,1,1,1,1600,600,2200,48.88889
6539,Other,44,2,1,1,1600,250,1850,42.045456
6540,Bela Vista,107,3,1,1,3400,850,4250,39.719627
6541,Moema,47,1,2,1,5200,500,5700,121.276596
6542,Bela Vista,60,2,2,1,2900,750,3650,60.833332
6543,Bela Vista,110,3,2,1,3800,764,4564,41.49091
6544,Other,103,3,2,0,1900,0,1900,18.446602
6545,Vila Mariana,77,2,2,2,3200,950,4150,53.896103
6546,Other,65,3,2,1,2400,774,3174,48.83077
6547,Santo Amaro,78,2,2,1,1850,1100,2950,37.820515
6548,Vila Clementino,50,1,1,1,1600,764,2364,47.28
6549,Brooklin,87,2,2,1,3100,680,3780,43.448277
6550,Perdizes,68,2,2,0,3000,1500,4500,66.17647
6551,Vila Olímpia,65,2,3,1,3500,752,4252,65.41538
6552,Vila Leopoldina,93,3,2,2,4100,930,5030,54.08602
6553,Saúde,58,2,1,1,2000,707,2707,46.672413
6554,Moema,108,3,3,2,4200,1700,5900,54.62963
6555,Perdizes,25,1,1,1,2000,400,2400,96.0
6556,Other,55,3,1,1,1400,507,1907,34.672726
6557,Bela Vista,54,2,1,0,4000,880,4880,90.37037
6558,Campo Belo,108,3,5,2,5000,1400,6400,59.25926
6559,Campo Belo,56,2,2,1,2900,846,3746,66.89286
6560,Higienópolis,40,1,1,1,2700,750,3450,86.25
6561,Brooklin,41,1,1,1,4000,500,4500,109.756096
6562,Brooklin,147,3,5,3,7000,1583,8583,58.387756
6563,Bela Vista,47,1,2,1,1800,550,2350,50.0
6564,Pinheiros,120,3,3,2,8000,1200,9200,76.666664
6565,Vila Nova Conceição,32,1,1,1,1884,1000,2884,90.125
6566,Aclimação,100,2,2,1,2200,770,2970,29.7
6567,Vila Olímpia,75,2,2,1,2600,845,3445,45.933334
6568,Other,49,2,1,1,950,150,1100,22.44898
6569,Moema,85,2,2,1,4485,1170,5655,66.52941
6570,Chácara Santo Antônio,95,3,3,2,6200,682,6882,72.44211
6571,Ipiranga,147,3,5,2,6750,1480,8230,55.986393
6572,Other,50,2,1,1,600,0,600,12.0
6573,Other,33,1,1,0,700,0,700,21.212122
6574,Brás,54,1,1,0,1300,130,1430,26.481482
6575,Perdizes,130,3,3,2,3500,1662,5162,39.70769
6576,Vila Clementino,42,1,2,1,2000,750,2750,65.47619
6577,Pompeia,60,3,2,1,2400,746,3146,52.433334
6578,Jaguaré,65,3,2,1,1750,587,2337,35.953846
6579,Campo Belo,68,2,2,1,3200,840,4040,59.411766
6580,Morumbi,125,4,4,2,2700,1300,4000,32.0
6581,Other,55,1,1,2,3490,490,3980,72.36364
6582,Moema,44,1,1,1,2350,606,2956,67.181816
6583,Itaim Bibi,118,4,3,1,4200,1000,5200,44.067795
6584,Other,90,2,2,0,1600,180,1780,19.777779
6585,Santa Cecília,75,2,1,1,2700,504,3204,42.72
6586,Other,55,2,1,1,1800,600,2400,43.636364
6587,Pompeia,65,2,2,1,2300,850,3150,48.46154
6588,Jardim América,80,2,2,1,3000,900,3900,48.75
6589,Perdizes,80,2,1,1,2300,820,3120,39.0
6590,Aclimação,75,3,3,2,2800,807,3607,48.093334
6591,Vila Nova Conceição,40,1,1,1,4400,598,4998,124.95
6592,Santa Cecília,130,3,3,2,5000,1430,6430,49.46154
6593,Brooklin,111,2,4,2,5800,900,6700,60.36036
6594,Cambuci,29,1,1,0,1300,230,1530,52.75862
6595,Moema,75,2,3,1,4710,980,5690,75.86667
6596,Other,93,3,3,2,3000,645,3645,39.19355
6597,Moema,66,2,2,1,2500,893,3393,51.409092
6598,Campo Belo,100,3,2,2,2500,1280,3780,37.8
6599,Vila Mariana,52,2,2,1,2500,709,3209,61.71154
6600,Jardim Marajoara,57,2,2,1,1690,573,2263,39.701756
6601,Brooklin,44,1,1,1,3300,585,3885,88.295456
6602,Bela Vista,40,1,1,1,2100,405,2505,62.625
6603,Other,52,2,1,1,1100,315,1415,27.211538
6604,Jabaquara,62,2,2,2,1400,910,2310,37.258064
6605,Other,83,2,2,1,5400,800,6200,74.69879
6606,Consolação,62,2,2,2,4250,715,4965,80.08064
6607,Brooklin,37,1,1,1,2800,0,2800,75.675674
6608,Other,40,1,1,0,1200,400,1600,40.0
6609,Jardim Paulista,120,4,3,2,4000,1650,5650,47.083332
6610,Consolação,53,1,1,1,2000,1700,3700,69.81132
6611,Vila Nova Conceição,85,2,1,1,4000,834,4834,56.870586
6612,Liberdade,50,1,1,0,1200,497,1697,33.94
6613,Itaim Bibi,70,2,1,1,3985,1700,5685,81.21429
6614,Vila Clementino,50,1,1,1,1650,532,2182,43.64
6615,Brooklin,43,1,1,1,2100,860,2960,68.83721
6616,Bela Vista,150,3,3,1,3750,1214,4964,33.093334
6617,Santa Cecília,50,2,2,1,1900,600,2500,50.0
6618,Itaim Bibi,85,2,2,1,4400,1044,5444,64.04706
6619,Other,60,2,2,2,3000,914,3914,65.23333
6620,Bela Vista,40,1,1,1,1050,450,1500,37.5
6621,Vila Olímpia,78,2,2,2,2590,970,3560,45.641026
6622,Other,89,2,2,1,5350,1183,6533,73.404495
6623,Vila Madalena,83,3,2,2,3600,1150,4750,57.228916
6624,Perdizes,67,2,2,1,3000,640,3640,54.328358
6625,Other,85,2,3,2,4800,897,5697,67.02353
6626,Bela Vista,139,3,5,2,8500,1350,9850,70.86331
6627,Other,58,2,1,1,1250,450,1700,29.310345
6628,Other,50,2,1,1,1330,420,1750,35.0
6629,Pompeia,40,1,1,1,2200,530,2730,68.25
6630,Moema,100,2,3,2,6200,850,7050,70.5
6631,Other,60,2,1,1,1600,350,1950,32.5
6632,Perdizes,35,1,1,1,3000,650,3650,104.28571
6633,Other,29,1,1,0,1100,50,1150,39.655174
6634,Brooklin,52,1,2,1,2200,1052,3252,62.53846
6635,Other,63,2,1,1,1900,630,2530,40.15873
6636,Other,126,2,1,1,1700,718,2418,19.190475
6637,Vila Mariana,50,1,2,1,2800,862,3662,73.24
6638,Other,40,1,1,1,1650,418,2068,51.7
6639,Brooklin,41,1,1,1,3700,300,4000,97.560974
6640,Perdizes,100,2,1,0,2150,0,2150,21.5
6641,Saúde,105,4,1,2,4200,700,4900,46.666668
6642,Pinheiros,68,2,1,1,2000,670,2670,39.264706
6643,Chácara Santo Antônio,79,2,3,2,6300,643,6943,87.88608
6644,Vila Clementino,43,1,1,1,2800,675,3475,80.81396
6645,Pinheiros,73,2,1,0,2500,375,2875,39.38356
6646,Vila Clementino,169,3,5,3,6500,1492,7992,47.28994
6647,Vila Mariana,50,2,2,1,2800,845,3645,72.9
6648,Cambuci,105,3,3,2,5400,1324,6724,64.03809
6649,Other,85,2,1,2,6200,1404,7604,89.458824
6650,Vila Buarque,83,4,1,0,2200,320,2520,30.361446
6651,Other,72,3,2,1,2200,731,2931,40.708332
6652,Vila Clementino,100,3,3,2,5600,1413,7013,70.13
6653,Pinheiros,108,3,2,1,3300,1150,4450,41.203705
6654,Mirandópolis,68,2,1,0,1900,670,2570,37.794117
6655,Other,70,2,2,1,2700,1114,3814,54.485714
6656,Other,44,2,1,1,1000,208,1208,27.454546
6657,Moema,87,3,1,2,4200,1170,5370,61.724136
6658,Other,72,3,2,1,1400,500,1900,26.38889
6659,Vila Mascote,66,2,2,1,2000,800,2800,42.424244
6660,Vila Madalena,70,2,2,1,2700,983,3683,52.614285
6661,Bela Vista,126,3,2,1,3300,1163,4463,35.420635
6662,Itaim Bibi,65,1,2,1,6000,0,6000,92.30769
6663,Other,42,2,1,1,1200,100,1300,30.952381
6664,Other,105,3,3,2,3800,1400,5200,49.52381
6665,Vila Andrade,44,2,1,0,1180,300,1480,33.636364
6666,Other,62,2,4,2,1490,571,2061,33.241936
6667,Itaim Bibi,61,2,2,0,6500,1200,7700,126.22951
6668,Perdizes,80,2,2,0,1600,478,2078,25.975
6669,Other,60,2,1,0,2500,507,3007,50.116665
6670,Pinheiros,136,2,4,2,8000,1477,9477,69.68382
6671,Barra Funda,38,1,1,1,1600,350,1950,51.31579
6672,Mirandópolis,33,1,1,0,1500,0,1500,45.454544
6673,Vila Mascote,116,3,5,3,3300,1500,4800,41.37931
6674,Campo Belo,65,2,1,1,4900,700,5600,86.15385
6675,Pinheiros,63,2,2,1,4800,980,5780,91.74603
6676,Jaguaré,65,3,1,1,1500,530,2030,31.23077
6677,Other,180,4,5,2,2500,1405,3905,21.694445
6678,Vila Guarani,65,3,2,1,1990,662,2652,40.8
6679,Bela Vista,43,1,1,1,3024,475,3499,81.37209
6680,Pinheiros,62,2,2,1,3000,950,3950,63.70968
6681,Consolação,120,2,2,1,2600,771,3371,28.091667
6682,Tatuapé,72,3,1,1,2840,650,3490,48.47222
6683,Bela Vista,47,2,1,1,3700,832,4532,96.42553
6684,Other,30,1,1,0,1000,285,1285,42.833332
6685,Santana,41,1,1,1,2200,639,2839,69.243904
6686,Cambuci,40,1,1,0,1000,298,1298,32.45
6687,Other,70,2,1,2,2700,970,3670,52.42857
6688,Vila Madalena,35,1,1,0,3500,400,3900,111.42857
6689,Brooklin,50,2,2,1,2500,622,3122,62.44
6690,Bela Vista,47,2,1,1,3400,900,4300,91.489365
6691,Other,48,2,1,1,1200,0,1200,25.0
6692,Other,63,2,1,1,1400,473,1873,29.730158
6693,Cidade Monções,70,2,2,1,6720,800,7520,107.42857
6694,Santa Cecília,116,3,3,1,5200,1,5201,44.83621
6695,Pinheiros,43,1,1,1,3100,647,3747,87.139534
6696,Cidade Monções,96,3,3,2,3200,1200,4400,45.833332
6697,Other,71,2,2,2,3280,680,3960,55.774647
6698,Pinheiros,62,2,2,1,4000,830,4830,77.90323
6699,Pinheiros,57,1,1,0,1590,410,2000,35.08772
6700,Jardim Paulista,54,1,1,0,2000,532,2532,46.88889
6701,Other,57,2,2,1,2200,472,2672,46.877193
6702,Other,78,2,2,2,3200,625,3825,49.03846
6703,Other,58,2,1,1,1900,650,2550,43.96552
6704,Pinheiros,86,2,2,1,3000,1000,4000,46.511627
6705,Bela Vista,33,1,1,1,1000,493,1493,45.242424
6706,Vila Nova Conceição,116,3,4,2,7200,1200,8400,72.413795
6707,Vila Olímpia,124,3,3,2,4350,1350,5700,45.967743
6708,Vila Leopoldina,88,2,3,2,3499,0,3499,39.761364
6709,Tatuapé,29,1,1,0,1490,120,1610,55.517242
6710,Tatuapé,56,2,1,1,1850,590,2440,43.57143
6711,Móoca,63,3,1,1,2500,450,2950,46.825397
6712,Ipiranga,67,2,1,1,3250,539,3789,56.55224
6713,Paraíso,100,2,2,1,2750,1090,3840,38.4
6714,Other,65,2,1,1,1200,0,1200,18.461538
6715,Other,48,2,1,2,900,0,900,18.75
6716,Other,54,2,1,1,1380,625,2005,37.12963
6717,Pinheiros,78,2,3,1,3000,1233,4233,54.26923
6718,Vila Mariana,60,2,1,1,2200,978,3178,52.966667
6719,Vila Madalena,75,2,2,1,3800,1012,4812,64.16
6720,Bela Vista,50,2,2,1,2400,650,3050,61.0
6721,Vila Olímpia,97,3,3,2,9000,1172,10172,104.86598
6722,Other,75,3,2,2,2700,915,3615,48.2
6723,Other,96,2,1,0,1500,161,1661,17.302084
6724,Pinheiros,120,3,3,0,4000,400,4400,36.666668
6725,Other,20,1,1,0,1200,0,1200,60.0
6726,Brooklin,50,2,2,1,2500,629,3129,62.58
6727,Vila Mariana,100,3,1,2,4500,600,5100,51.0
6728,Other,70,2,2,1,2200,970,3170,45.285713
6729,Other,53,2,2,1,2000,550,2550,48.11321
6730,Jardim Marajoara,93,3,3,2,3500,772,4272,45.935482
6731,Other,50,2,1,1,1100,277,1377,27.54
6732,Bela Vista,39,1,1,1,2600,450,3050,78.20513
6733,Ipiranga,87,2,3,1,2700,640,3340,38.390804
6734,Jardim Paulista,70,2,1,2,5000,1100,6100,87.14286
6735,Saúde,35,1,1,1,2200,492,2692,76.91428
6736,Other,34,1,1,1,2350,523,2873,84.5
6737,Paraíso,50,2,1,0,2500,854,3354,67.08
6738,Vila Buarque,50,1,1,1,2200,400,2600,52.0
6739,Chácara Santo Antônio,66,1,2,2,3800,540,4340,65.757576
6740,Other,58,2,1,1,1480,559,2039,35.155174
6741,Móoca,63,3,2,1,2500,450,2950,46.825397
6742,Pinheiros,65,2,2,2,4700,860,5560,85.53846
6743,Moema,35,1,1,1,3000,700,3700,105.71429
6744,Santana,32,1,1,1,1800,636,2436,76.125
6745,Vila Mariana,55,1,1,0,1500,600,2100,38.18182
6746,Other,70,3,1,1,2100,500,2600,37.142857
6747,Other,70,2,1,0,1800,210,2010,28.714285
6748,Other,100,3,1,1,2500,1000,3500,35.0
6749,Liberdade,40,1,1,0,1150,0,1150,28.75
6750,Higienópolis,40,1,1,1,3000,1100,4100,102.5
6751,Vila Mascote,118,3,4,2,4000,1100,5100,43.22034
6752,Other,40,1,1,1,2100,450,2550,63.75
6753,Tatuapé,52,2,1,1,2300,552,2852,54.846153
6754,Other,44,1,1,1,1100,798,1898,43.136364
6755,Other,57,2,2,1,4000,1020,5020,88.070175
6756,Other,60,3,1,1,2700,490,3190,53.166668
6757,Bela Vista,80,2,1,1,4360,846,5206,65.075
6758,Other,73,3,1,1,1700,450,2150,29.452055
6759,Other,70,3,2,1,1300,897,2197,31.385714
6760,Morumbi,50,1,1,1,1300,525,1825,36.5
6761,Other,57,2,1,1,1100,201,1301,22.824562
6762,Ipiranga,35,1,1,1,2400,560,2960,84.57143
6763,Aclimação,82,2,1,2,2700,660,3360,40.97561
6764,Other,110,3,3,2,5000,1550,6550,59.545456
6765,Other,67,2,2,1,2300,414,2714,40.50746
6766,Other,117,3,4,2,5000,900,5900,50.42735
6767,Jabaquara,35,1,1,0,1550,385,1935,55.285713
6768,Bela Vista,50,2,1,0,2200,705,2905,58.1
6769,Butantã,48,2,1,1,1300,440,1740,36.25
6770,Tatuapé,58,1,1,0,1300,100,1400,24.137932
6771,Pinheiros,42,1,1,0,1700,333,2033,48.404762
6772,Moema,53,1,1,1,3600,1182,4782,90.22642
6773,Santana,55,2,1,1,3000,670,3670,66.72727
6774,Vila Nova Conceição,116,3,4,2,8000,1470,9470,81.63793
6775,Brooklin,98,2,3,2,8000,1550,9550,97.44898
6776,Other,50,2,1,1,1200,331,1531,30.62
6777,Vila Mascote,55,2,1,1,1300,700,2000,36.363636
6778,Brooklin,63,2,2,1,2900,790,3690,58.57143
6779,Vila Buarque,38,1,1,1,1400,604,2004,52.736843
6780,Itaim Bibi,131,3,1,1,4985,945,5930,45.267174
6781,Other,55,3,1,1,1500,0,1500,27.272728
6782,Other,118,3,2,2,6000,1100,7100,60.16949
6783,Other,58,2,1,1,2000,540,2540,43.793102
6784,Santo Amaro,33,1,1,1,3300,598,3898,118.121216
6785,Santa Cecília,105,3,3,1,2800,1455,4255,40.52381
6786,Cambuci,70,2,2,0,1450,290,1740,24.857143
6787,Brooklin,48,1,1,1,3800,700,4500,93.75
6788,Pinheiros,32,1,1,0,4000,150,4150,129.6875
6789,Aclimação,69,3,2,2,2800,720,3520,51.014492
6790,Other,180,3,5,2,6600,1579,8179,45.43889
6791,Other,55,2,1,1,2095,405,2500,45.454544
6792,Móoca,72,2,1,0,1400,470,1870,25.972221
6793,Vila Mariana,66,2,1,0,1350,574,1924,29.151516
6794,Brooklin,63,2,1,1,2500,800,3300,52.38095
6795,Jardim Marajoara,50,2,1,1,1600,480,2080,41.6
6796,Other,75,2,1,2,1500,0,1500,20.0
6797,Moema,48,1,1,1,2000,720,2720,56.666668
6798,Ipiranga,170,4,5,3,7500,1380,8880,52.235294
6799,Campo Belo,60,1,2,2,2950,900,3850,64.166664
6800,Vila Clementino,65,2,2,1,1600,1050,2650,40.76923
6801,Cidade Monções,70,1,1,1,5500,994,6494,92.77143
6802,Vila Mariana,101,3,3,0,3500,1133,4633,45.87129
6803,Other,50,1,1,0,1700,400,2100,42.0
6804,Other,99,3,3,2,6000,900,6900,69.69697
6805,Vila Leopoldina,73,2,3,2,2700,885,3585,49.10959
6806,Perdizes,37,1,1,1,3880,690,4570,123.51351
6807,Vila Olímpia,67,1,1,1,5500,1200,6700,100.0
6808,Other,90,2,2,0,1550,250,1800,20.0
6809,Vila Leopoldina,68,2,2,1,2000,880,2880,42.35294
6810,Other,50,2,1,1,1300,400,1700,34.0
6811,Other,110,3,3,2,2700,1200,3900,35.454544
6812,Vila Mariana,40,2,1,0,1800,130,1930,48.25
6813,Cambuci,50,2,1,0,1500,585,2085,41.7
6814,Other,32,2,1,0,1200,190,1390,43.4375
6815,Vila Olímpia,55,2,2,2,3430,990,4420,80.36364
6816,Jabaquara,65,2,2,1,1750,730,2480,38.153847
6817,Moema,42,1,1,1,2300,880,3180,75.71429
6818,Vila Olímpia,94,3,3,2,7500,1171,8671,92.24468
6819,Vila Leopoldina,50,2,1,1,2300,530,2830,56.6
6820,Consolação,24,1,1,0,2500,260,2760,115.0
6821,Brooklin,87,3,2,0,3100,611,3711,42.655174
6822,Saúde,35,1,1,1,1800,590,2390,68.28571
6823,Móoca,125,3,2,2,2800,1080,3880,31.04
6824,Other,37,1,1,1,2350,512,2862,77.35135
6825,Other,70,2,1,1,1600,650,2250,32.142857
6826,Barra Funda,70,2,1,0,1400,160,1560,22.285715
6827,Moema,31,1,1,1,1260,1700,2960,95.48387
6828,Other,60,2,1,1,2000,420,2420,40.333332
6829,Other,50,2,1,1,1000,500,1500,30.0
6830,Vila Olímpia,74,2,1,0,2500,786,3286,44.405407
6831,Bela Vista,28,1,1,1,1100,357,1457,52.035713
6832,Vila Mariana,31,1,1,1,2420,528,2948,95.09677
6833,Other,53,2,1,0,1400,253,1653,31.188679
6834,Bela Vista,40,1,1,0,1900,0,1900,47.5
6835,Jardim Paulista,52,1,1,1,3500,467,3967,76.28846
6836,Other,64,2,2,1,1700,700,2400,37.5
6837,Vila Olímpia,126,3,5,2,9000,1500,10500,83.333336
6838,Mirandópolis,100,3,1,0,1800,0,1800,18.0
6839,Jardim Paulista,134,3,3,1,6000,1100,7100,52.985073
6840,Cambuci,60,2,1,0,1300,300,1600,26.666666
6841,Perdizes,86,3,3,2,3500,1088,4588,53.34884
6842,Vila Mariana,47,1,2,1,3000,723,3723,79.21277
6843,Vila Mariana,51,2,1,1,1650,450,2100,41.17647
6844,Other,60,2,2,1,2300,620,2920,48.666668
6845,Vila Olímpia,45,1,1,1,2350,665,3015,67.0
6846,Other,65,3,2,1,928,322,1250,19.23077
6847,Other,84,3,3,2,2300,1263,3563,42.416668
6848,Vila Andrade,87,2,2,2,3450,1050,4500,51.724136
6849,Moema,46,1,1,1,2300,484,2784,60.52174
6850,Consolação,40,1,1,0,1500,482,1982,49.55
6851,Saúde,89,2,2,1,2750,0,2750,30.898876
6852,Other,56,2,1,1,1450,570,2020,36.07143
6853,República,44,1,1,0,1900,379,2279,51.795456
6854,Brooklin,69,2,3,1,2700,836,3536,51.246376
6855,Jaguaré,100,3,1,1,2400,620,3020,30.2
6856,Vila Mariana,45,1,1,1,1800,900,2700,60.0
6857,Other,47,2,1,1,1100,0,1100,23.404255
6858,Other,61,1,2,2,2700,650,3350,54.918034
6859,Other,45,1,2,1,2100,508,2608,57.955555
6860,Bela Vista,37,1,1,1,2400,500,2900,78.37838
6861,Other,31,1,1,1,1800,500,2300,74.19355
6862,Aclimação,63,2,2,2,2500,641,3141,49.857143
6863,Pinheiros,60,2,2,1,4300,830,5130,85.5
6864,Aclimação,45,1,1,1,1800,451,2251,50.02222
6865,Other,35,1,1,0,1400,0,1400,40.0
6866,Pinheiros,65,2,2,1,4590,830,5420,83.38461
6867,Perdizes,50,2,1,1,1900,680,2580,51.6
6868,Other,35,1,1,1,2000,695,2695,77.0
6869,Other,53,2,2,1,3500,900,4400,83.01887
6870,Other,60,3,2,1,1850,480,2330,38.833332
6871,Vila Nova Conceição,70,2,1,1,3300,1395,4695,67.07143
6872,Vila Mariana,84,3,2,2,2499,1260,3759,44.75
6873,Other,57,2,2,1,2000,543,2543,44.614037
6874,Pinheiros,85,2,2,1,6700,1000,7700,90.588234
6875,Consolação,42,1,1,1,3500,800,4300,102.38095
6876,Brooklin,60,2,2,0,3300,1023,4323,72.05
6877,Vila Mariana,90,2,1,0,1800,130,1930,21.444445
6878,Other,74,1,2,2,4500,959,5459,73.77027
6879,Jaguaré,70,3,2,2,2800,498,3298,47.114285
6880,Vila Andrade,68,3,2,1,2200,660,2860,42.058823
6881,Pinheiros,75,2,2,1,2300,941,3241,43.213333
6882,Vila Nova Conceição,98,2,2,1,4000,834,4834,49.32653
6883,Butantã,50,2,1,1,1450,523,1973,39.46
6884,Moema,83,2,1,1,2500,1037,3537,42.614456
6885,Pinheiros,140,3,2,2,5000,650,5650,40.357143
6886,Higienópolis,60,2,1,0,2800,314,3114,51.9
6887,Jabaquara,37,1,1,1,1650,350,2000,54.054054
6888,Tatuapé,47,1,1,1,2100,700,2800,59.574467
6889,Brooklin,66,1,2,2,4500,1147,5647,85.56061
6890,Perdizes,119,3,3,2,2800,1575,4375,36.764706
6891,Other,28,1,1,0,1050,50,1100,39.285713
6892,Other,80,2,3,2,4600,700,5300,66.25
6893,Jabaquara,40,1,2,1,1550,461,2011,50.275
6894,Itaim Bibi,100,3,2,1,8500,600,9100,91.0
6895,Campo Belo,40,1,1,1,1700,716,2416,60.4
6896,Ipiranga,78,3,2,2,2500,736,3236,41.48718
6897,Perdizes,55,2,1,1,2200,725,2925,53.18182
6898,Other,100,3,2,1,3000,915,3915,39.15
6899,Vila Mariana,123,3,3,1,3400,1100,4500,36.585365
6900,Other,48,2,1,1,1200,0,1200,25.0
6901,Itaim Bibi,105,3,3,1,3900,1290,5190,49.42857
6902,Jaguaré,80,3,1,1,1400,550,1950,24.375
6903,Other,65,2,2,2,4900,1100,6000,92.30769
6904,Ipiranga,72,2,1,0,1600,140,1740,24.166666
6905,Centro,52,2,2,1,2400,830,3230,62.115383
6906,Jardim América,170,3,3,2,7300,1215,8515,50.088234
6907,Other,128,4,5,2,5100,1280,6380,49.84375
6908,Other,48,2,1,1,1900,300,2200,45.833332
6909,Móoca,51,1,2,1,1800,1070,2870,56.27451
6910,Cerqueira César,51,1,2,1,3800,1000,4800,94.117645
6911,Other,57,3,1,1,2000,0,2000,35.08772
6912,Jardim Marajoara,50,2,1,1,1500,560,2060,41.2
6913,Vila Leopoldina,60,2,2,1,2600,754,3354,55.9
6914,Other,55,1,1,1,3340,550,3890,70.72727
6915,Other,105,2,3,2,3100,1600,4700,44.761906
6916,Vila Andrade,54,2,1,2,1300,844,2144,39.703705
6917,Pinheiros,120,3,2,2,4000,1133,5133,42.775
6918,Brooklin,113,3,2,2,3295,970,4265,37.743362
6919,Other,27,1,1,0,650,550,1200,44.444443
6920,Moema,54,1,1,1,2100,765,2865,53.055557
6921,Móoca,74,2,2,2,3200,800,4000,54.054054
6922,Vila Mariana,60,2,1,0,1700,374,2074,34.566666
6923,Consolação,52,1,1,1,2850,370,3220,61.923077
6924,Moema,48,1,1,1,3200,700,3900,81.25
6925,Paraíso,88,3,2,2,3600,1200,4800,54.545456
6926,Brooklin,57,2,2,2,2800,1040,3840,67.36842
6927,Moema,116,3,5,2,8100,1300,9400,81.034485
6928,Vila Clementino,54,1,1,1,1700,780,2480,45.925926
6929,Moema,110,3,2,2,4000,1522,5522,50.2
6930,Morumbi,125,3,4,2,4900,1100,6000,48.0
6931,Moema,55,2,1,1,1600,750,2350,42.727272
6932,Other,73,2,1,1,4500,1120,5620,76.9863
6933,Other,132,3,5,4,5000,974,5974,45.257576
6934,Cidade Monções,53,1,1,1,3500,880,4380,82.64151
6935,Other,55,2,1,1,1300,500,1800,32.727272
6936,Chácara Santo Antônio,70,2,2,2,4500,852,5352,76.457146
6937,Bela Vista,35,1,1,0,850,464,1314,37.54286
6938,Brooklin,90,3,2,2,3300,980,4280,47.555557
6939,Jardim Paulista,96,2,1,1,3950,1600,5550,57.8125
6940,Vila Nova Conceição,128,3,3,2,8000,1346,9346,73.015625
6941,Santa Cecília,38,1,1,1,1900,525,2425,63.81579
6942,Other,61,2,1,1,1344,544,1888,30.950819
6943,Other,60,2,1,1,1650,430,2080,34.666668
6944,Vila Madalena,91,2,2,2,5932,1430,7362,80.9011
6945,Vila Andrade,56,2,2,1,2400,285,2685,47.94643
6946,Pinheiros,58,1,2,1,2700,689,3389,58.431034
6947,Other,56,2,1,1,1500,530,2030,36.25
6948,Brooklin,43,1,1,1,4100,769,4869,113.23256
6949,Itaim Bibi,60,1,1,1,4590,950,5540,92.333336
6950,Itaim Bibi,98,2,3,1,5500,1174,6674,68.10204
6951,Bela Vista,62,2,2,1,2600,1046,3646,58.80645
6952,Other,40,1,1,1,2100,511,2611,65.275
6953,Other,75,2,1,0,1100,400,1500,20.0
6954,Other,67,3,3,1,3200,820,4020,60.0
6955,Other,20,1,1,0,925,0,925,46.25
6956,Other,40,2,1,0,800,65,865,21.625
6957,Vila Mariana,56,2,2,1,2490,1000,3490,62.32143
6958,Aclimação,86,2,3,1,2300,1100,3400,39.534885
6959,Other,37,1,1,1,1700,576,2276,61.51351
6960,Paraíso,60,2,1,0,1600,569,2169,36.15
6961,Higienópolis,79,2,2,1,3300,900,4200,53.16456
6962,Other,55,2,1,1,1300,710,2010,36.545456
6963,Consolação,60,2,2,2,4000,800,4800,80.0
6964,Other,38,1,1,1,2600,580,3180,83.68421
6965,Moema,74,2,2,1,3000,800,3800,51.351353
6966,Other,47,2,1,0,1700,0,1700,36.17021
6967,Brooklin,45,1,1,1,3000,585,3585,79.666664
6968,Other,65,2,2,1,2000,860,2860,44.0
6969,Vila Clementino,60,2,1,0,1400,991,2391,39.85
6970,Ipiranga,80,3,3,2,2500,936,3436,42.95
6971,Vila Olímpia,54,2,1,1,3900,660,4560,84.44444
6972,Vila Prudente,33,1,1,0,1800,480,2280,69.09091
6973,Moema,65,2,2,1,2000,790,2790,42.923077
6974,Butantã,70,3,1,1,1700,780,2480,35.42857
6975,Itaim Bibi,32,1,1,1,2800,0,2800,87.5
6976,Pinheiros,85,2,1,2,5807,1651,7458,87.74117
6977,Brooklin,70,2,2,1,4000,900,4900,70.0
6978,Campo Belo,73,2,2,1,2800,793,3593,49.219177
6979,Brás,105,2,2,0,1600,500,2100,20.0
6980,Vila Clementino,43,1,1,1,2000,700,2700,62.7907
6981,Other,86,2,2,2,1650,988,2638,30.67442
6982,Bela Vista,42,1,1,1,2100,740,2840,67.61905
6983,Santa Cecília,40,1,1,0,1400,430,1830,45.75
6984,Other,50,2,1,1,1200,400,1600,32.0
6985,Vila Andrade,89,3,3,2,1900,750,2650,29.77528
6986,Cerqueira César,60,2,1,1,2800,723,3523,58.716667
6987,Vila Mariana,50,2,1,1,2700,674,3374,67.48
6988,Cambuci,85,2,3,1,1300,1226,2526,29.717648
6989,Other,75,2,2,1,3500,960,4460,59.466667
6990,Vila Mariana,55,2,1,1,1800,802,2602,47.30909
6991,Tatuapé,35,1,1,1,2200,380,2580,73.71429
6992,Centro,36,1,1,1,1700,380,2080,57.77778
6993,Moema,56,1,1,1,4300,845,5145,91.875
6994,Ipiranga,32,1,1,1,1600,437,2037,63.65625
6995,Vila Olímpia,100,3,3,1,3750,970,4720,47.2
6996,Campo Belo,83,2,3,2,4500,698,5198,62.626507
6997,Vila Olímpia,60,2,1,1,2400,871,3271,54.516666
6998,Pinheiros,55,2,1,1,2500,690,3190,58.0
6999,Jardim Paulista,45,1,1,1,2500,750,3250,72.22222
7000,Tatuapé,37,1,1,1,2500,370,2870,77.567566
7001,Pompeia,72,2,2,2,2300,845,3145,43.680557
7002,Other,60,2,2,1,1277,1200,2477,41.283333
7003,Pinheiros,38,1,1,1,3900,900,4800,126.31579
7004,Vila Leopoldina,114,3,3,2,4800,871,5671,49.745613
7005,Brooklin,63,2,2,1,3300,700,4000,63.49206
7006,Other,74,2,2,2,3100,770,3870,52.2973
7007,Other,48,1,2,1,2200,600,2800,58.333332
7008,Santa Cecília,42,1,1,1,1800,590,2390,56.904762
7009,Vila Madalena,42,1,1,1,2300,980,3280,78.09524
7010,Santo Amaro,130,3,2,2,4500,1100,5600,43.076923
7011,Jardins,100,3,2,1,2800,1084,3884,38.84
7012,Other,60,2,1,1,1200,250,1450,24.166666
7013,Other,56,2,1,1,1500,0,1500,26.785715
7014,Perdizes,65,2,2,2,2800,850,3650,56.153847
7015,Other,68,2,2,2,4800,750,5550,81.617645
7016,Brooklin,75,2,2,2,6900,1200,8100,108.0
7017,Jardim Paulista,65,2,2,2,2800,1035,3835,59.0
7018,Cambuci,39,1,1,1,2260,530,2790,71.53846
7019,Móoca,45,2,1,1,1800,340,2140,47.555557
7020,Pinheiros,58,1,1,1,4000,770,4770,82.24138
7021,Vila Mascote,130,3,5,2,3800,1450,5250,40.384617
7022,Saúde,90,3,1,2,2000,345,2345,26.055555
7023,Moema,56,1,1,1,2300,437,2737,48.875
7024,Other,71,3,1,1,1100,360,1460,20.563381
7025,Other,46,1,1,1,2700,390,3090,67.17391
7026,Butantã,77,2,2,1,2400,600,3000,38.96104
7027,Brooklin,67,2,1,1,4200,995,5195,77.537315
7028,Jardins,47,1,1,1,2200,810,3010,64.04256
7029,Liberdade,35,1,1,0,1150,349,1499,42.82857
7030,Other,90,2,1,1,1600,0,1600,17.777779
7031,Other,75,3,2,0,1159,687,1846,24.613333
7032,Consolação,29,1,1,0,2900,340,3240,111.72414
7033,Jardim América,90,2,2,1,3600,1185,4785,53.166668
7034,Tatuapé,90,3,2,1,2400,980,3380,37.555557
7035,Itaim Bibi,90,2,3,1,4290,765,5055,56.166668
7036,Paraíso,100,3,1,2,3500,1550,5050,50.5
7037,Vila Olímpia,120,2,3,1,4000,1050,5050,42.083332
7038,Other,45,1,1,1,1800,536,2336,51.91111
7039,Chácara Santo Antônio,104,3,4,2,3900,980,4880,46.923077
7040,Other,103,3,4,2,3300,1190,4490,43.59223
7041,Tatuapé,65,2,1,1,2150,600,2750,42.307693
7042,Pompeia,72,3,2,2,3100,799,3899,54.15278
7043,Other,72,2,2,2,3000,850,3850,53.47222
7044,Ipiranga,63,2,2,1,2000,500,2500,39.68254
7045,Santana,50,1,1,1,1150,560,1710,34.2
7046,Other,47,1,1,1,1650,240,1890,40.212765
7047,Vila Guarani,88,3,3,2,2700,674,3374,38.340908
7048,Barra Funda,50,2,1,1,1200,1000,2200,44.0
7049,Pinheiros,65,1,1,0,1550,450,2000,30.76923
7050,Móoca,70,2,1,1,2300,0,2300,32.857143
7051,Brooklin,94,3,4,2,4900,1300,6200,65.95744
7052,Vila Madalena,68,2,2,1,2300,680,2980,43.82353
7053,Pompeia,128,3,4,2,7300,1200,8500,66.40625
7054,Other,70,3,2,1,1300,720,2020,28.857143
7055,Vila Guarani,92,3,2,2,4800,691,5491,59.684784
7056,Other,38,1,1,1,1800,500,2300,60.526318
7057,Bela Vista,26,1,1,0,1250,376,1626,62.53846
7058,Tatuapé,57,2,2,1,2200,339,2539,44.54386
7059,Other,78,2,2,0,1700,582,2282,29.25641
7060,Bela Vista,70,1,2,0,2600,400,3000,42.857143
7061,Vila Mascote,63,2,2,1,2500,702,3202,50.825397
7062,Campo Belo,89,2,2,2,4700,525,5225,58.707867
7063,Other,68,2,2,1,1800,860,2660,39.117645
7064,Consolação,64,2,2,1,4200,700,4900,76.5625
7065,Consolação,38,1,1,1,1400,1200,2600,68.42105
7066,Vila Madalena,90,2,2,0,2000,530,2530,28.11111
7067,Other,40,1,1,0,1000,0,1000,25.0
7068,Pinheiros,62,1,1,1,2850,700,3550,57.258064
7069,Other,55,2,1,1,2400,877,3277,59.581818
7070,Other,60,2,1,1,1900,923,2823,47.05
7071,Other,44,1,1,1,2750,624,3374,76.681816
7072,Vila Mariana,70,3,1,0,2500,0,2500,35.714287
7073,Other,60,2,1,1,1500,490,1990,33.166668
7074,Vila Clementino,45,1,1,1,2000,420,2420,53.77778
7075,Higienópolis,66,2,1,1,3000,970,3970,60.151516
7076,Other,30,1,1,0,1350,150,1500,50.0
7077,Other,62,2,2,2,1390,649,2039,32.887096
7078,Chácara Santo Antônio,64,2,2,2,3800,650,4450,69.53125
7079,Tatuapé,60,2,1,1,2600,650,3250,54.166668
7080,Vila Madalena,35,1,1,1,3000,505,3505,100.14286
7081,Aclimação,176,4,5,3,7500,1350,8850,50.284092
7082,Pinheiros,49,1,1,0,1700,300,2000,40.816326
7083,Chácara Santo Antônio,60,2,2,1,3170,630,3800,63.333332
7084,Brooklin,105,2,3,2,9000,1100,10100,96.190475
7085,Other,54,2,1,0,900,310,1210,22.407408
7086,Vila Mascote,65,3,2,1,2500,640,3140,48.307693
7087,Jabaquara,49,2,1,1,1300,700,2000,40.816326
7088,Itaim Bibi,44,1,1,1,3200,790,3990,90.681816
7089,Pinheiros,80,2,2,1,2700,625,3325,41.5625
7090,Brooklin,96,2,3,3,8250,1420,9670,100.729164
7091,Other,82,3,3,2,2200,450,2650,32.317074
7092,Campo Belo,110,3,3,1,2800,1133,3933,35.754547
7093,Campo Belo,108,3,5,2,5000,820,5820,53.88889
7094,Vila Olímpia,52,1,1,1,3450,1150,4600,88.46154
7095,Jardim Paulista,45,1,1,1,2200,670,2870,63.77778
7096,Vila Leopoldina,96,3,4,2,3600,1074,4674,48.6875
7097,Jabaquara,55,2,1,1,1650,550,2200,40.0
7098,Brooklin,69,2,2,1,5500,890,6390,92.608696
7099,Pompeia,41,1,1,1,2100,594,2694,65.70731
7100,Other,60,2,1,1,1600,658,2258,37.633335
7101,Pompeia,48,2,2,1,2500,600,3100,64.583336
7102,Other,70,3,1,1,1500,445,1945,27.785715
7103,Other,50,1,1,1,2000,550,2550,51.0
7104,Vila Nova Conceição,39,1,1,1,2125,1042,3167,81.20513
7105,Vila Mariana,39,2,1,1,1650,600,2250,57.692307
7106,Vila Andrade,51,2,1,1,2750,380,3130,61.372547
7107,Other,105,3,1,1,2600,990,3590,34.190475
7108,Vila Madalena,83,1,2,2,3600,1150,4750,57.228916
7109,Pinheiros,100,2,2,0,3000,360,3360,33.6
7110,Campo Belo,41,1,1,1,3200,850,4050,98.78049
7111,Itaim Bibi,50,1,1,1,3500,815,4315,86.3
7112,Jardim Paulista,74,2,2,2,4450,1400,5850,79.054054
7113,Other,73,2,1,1,4500,710,5210,71.369865
7114,Moema,114,3,4,2,6500,1100,7600,66.666664
7115,Other,112,3,1,0,2700,0,2700,24.107143
7116,Brooklin,119,3,2,3,7000,1550,8550,71.84874
7117,Itaim Bibi,70,1,2,1,5000,1200,6200,88.57143
7118,Jardins,60,2,2,1,2500,819,3319,55.316666
7119,Saúde,60,2,2,1,1700,550,2250,37.5
7120,Campo Belo,58,2,1,1,2400,760,3160,54.482758
7121,Jardim Paulista,60,1,2,1,2100,613,2713,45.216667
7122,Vila Olímpia,52,1,1,1,3500,780,4280,82.30769
7123,Brooklin,146,3,3,2,9000,1350,10350,70.89041
7124,Móoca,64,3,2,1,2500,428,2928,45.75
7125,Vila Mascote,147,3,3,2,5100,1150,6250,42.517006
7126,Other,51,2,1,1,1464,401,1865,36.568626
7127,Vila Nova Conceição,76,1,2,2,8900,1050,9950,130.92105
7128,Brooklin,50,2,2,1,2800,548,3348,66.96
7129,Pinheiros,60,2,1,0,2300,501,2801,46.683334
7130,Móoca,67,2,2,1,1300,860,2160,32.238808
7131,Other,62,2,1,1,1468,626,2094,33.774193
7132,Lapa,53,2,1,1,2200,400,2600,49.056602
7133,Other,48,2,1,1,1900,453,2353,49.020832
7134,Other,55,1,1,0,899,0,899,16.345455
7135,Pinheiros,60,2,1,0,2000,485,2485,41.416668
7136,Other,69,3,2,1,1450,600,2050,29.710144
7137,Campo Belo,32,1,1,1,800,1400,2200,68.75
7138,Itaim Bibi,90,2,3,1,3500,965,4465,49.61111
7139,Moema,46,1,2,1,2750,600,3350,72.82609
7140,Other,55,1,1,0,1100,1,1101,20.018183
7141,Chácara Santo Antônio,135,4,4,2,6800,805,7605,56.333332
7142,Vila Clementino,128,3,4,2,5000,1500,6500,50.78125
7143,Other,75,2,1,0,1800,160,1960,26.133333
7144,Other,55,2,1,1,1300,612,1912,34.763638
7145,Other,64,2,2,1,2200,897,3097,48.390625
7146,Santana,85,2,1,0,1300,160,1460,17.17647
7147,Jardins,32,1,1,0,2000,150,2150,67.1875
7148,Vila Mariana,51,1,1,1,2300,439,2739,53.705883
7149,Other,106,3,1,2,2800,850,3650,34.433964
7150,Pinheiros,90,2,2,2,6600,1290,7890,87.666664
7151,Pompeia,38,1,1,1,1900,450,2350,61.842106
7152,Vila Olímpia,89,3,2,2,6170,914,7084,79.595505
7153,Moema,44,1,1,1,4800,732,5532,125.72727
7154,Barra Funda,126,3,3,2,5850,1300,7150,56.746033
7155,Brooklin,93,2,2,1,2800,780,3580,38.494625
7156,Moema,46,1,1,1,2100,980,3080,66.95652
7157,Other,78,2,1,1,1850,485,2335,29.935898
7158,Vila Mariana,55,1,1,2,4500,869,5369,97.61818
7159,Bela Vista,40,1,1,0,1500,700,2200,55.0
7160,República,26,1,1,0,1050,265,1315,50.576923
7161,Other,238,4,6,4,9000,1535,10535,44.264706
7162,Vila Madalena,62,2,2,2,2300,1498,3798,61.258064
7163,Cidade Monções,54,2,2,1,2100,731,2831,52.425926
7164,Other,58,2,1,2,1700,770,2470,42.58621
7165,Other,53,2,1,1,1800,535,2335,44.056602
7166,Vila Olímpia,45,1,1,1,2800,650,3450,76.666664
7167,Other,47,2,1,1,1800,340,2140,45.531914
7168,Perdizes,106,3,2,1,2600,1032,3632,34.264153
7169,Other,57,2,2,1,2400,580,2980,52.2807
7170,Pinheiros,60,2,1,0,2000,485,2485,41.416668
7171,Vila Olímpia,60,2,1,1,2500,874,3374,56.233334
7172,Other,80,3,2,0,1500,0,1500,18.75
7173,Other,50,1,2,0,1550,350,1900,38.0
7174,Other,58,2,1,1,1380,598,1978,34.103447
7175,Moema,45,1,1,1,2100,765,2865,63.666668
7176,Other,32,2,1,0,1200,187,1387,43.34375
7177,Other,65,2,1,1,1500,774,2274,34.984615
7178,Vila Mariana,84,1,2,1,3300,522,3822,45.5
7179,Brooklin,50,1,1,1,3855,820,4675,93.5
7180,Móoca,55,2,2,1,3000,500,3500,63.636364
7181,Indianópolis,42,1,1,1,4000,1200,5200,123.809525
7182,Tatuapé,65,3,2,2,2200,672,2872,44.184616
7183,Santo Amaro,72,2,2,1,3900,684,4584,63.666668
7184,Other,40,2,1,1,1500,0,1500,37.5
7185,Chácara Santo Antônio,80,2,1,0,1890,300,2190,27.375
7186,Barra Funda,126,3,3,1,5800,1200,7000,55.555557
7187,Morumbi,145,4,4,2,2900,1201,4101,28.282759
7188,Itaim Bibi,137,3,3,1,4500,1361,5861,42.78102
7189,Jardim Paulista,50,1,2,1,3200,1045,4245,84.9
7190,Perdizes,55,2,1,2,2700,1010,3710,67.454544
7191,Other,55,2,1,1,1900,426,2326,42.29091
7192,Vila Mascote,53,1,2,1,3500,420,3920,73.962265
7193,Pinheiros,127,3,3,2,4890,1250,6140,48.34646
7194,Higienópolis,127,3,2,1,4000,1400,5400,42.519684
7195,Vila Leopoldina,35,2,1,0,2000,305,2305,65.85714
7196,Pinheiros,113,3,2,1,3700,1192,4892,43.292034
7197,Santo Amaro,130,3,4,3,4400,1329,5729,44.06923
7198,Jardim Marajoara,45,2,1,1,2200,0,2200,48.88889
7199,Other,68,2,1,1,1800,950,2750,40.441177
7200,Other,40,2,1,1,1500,0,1500,37.5
7201,Moema,112,3,3,2,3300,1337,4637,41.401787
7202,Moema,26,1,1,1,2500,539,3039,116.88461
7203,Higienópolis,36,1,1,1,1500,551,2051,56.97222
7204,Santana,100,3,2,1,3300,900,4200,42.0
7205,Other,74,2,2,1,1000,700,1700,22.972973
7206,Jardim Paulista,121,2,3,2,6300,1200,7500,61.98347
7207,Bela Vista,45,1,1,1,1500,578,2078,46.177776
7208,Cambuci,80,3,3,2,2600,1190,3790,47.375
7209,Pinheiros,70,2,1,1,4500,800,5300,75.71429
7210,Other,50,2,2,1,1950,500,2450,49.0
7211,Bela Vista,110,2,2,1,3100,1300,4400,40.0
7212,Other,90,3,2,1,4000,905,4905,54.5
7213,Bela Vista,58,1,1,0,2200,595,2795,48.189655
7214,Moema,70,2,3,1,4620,780,5400,77.14286
7215,Consolação,25,1,1,1,1300,605,1905,76.2
7216,Other,50,2,1,1,2000,500,2500,50.0
7217,Campo Belo,62,1,2,2,4000,0,4000,64.51613
7218,Vila Leopoldina,60,2,2,2,3400,0,3400,56.666668
7219,Perdizes,115,3,3,2,3600,1600,5200,45.217392
7220,Brooklin,147,3,5,3,7000,1573,8573,58.31973
7221,Cambuci,70,1,1,0,1750,161,1911,27.3
7222,Other,40,2,1,0,1200,165,1365,34.125
7223,Brooklin,40,1,1,1,1500,834,2334,58.35
7224,Other,47,2,1,1,1100,570,1670,35.531914
7225,Pinheiros,39,1,1,1,3550,490,4040,103.589745
7226,Other,73,2,2,1,1600,1100,2700,36.9863
7227,Moema,70,2,3,2,3900,909,4809,68.7
7228,Itaim Bibi,118,2,3,2,7000,1342,8342,70.694916
7229,Cerqueira César,136,3,3,1,4000,1300,5300,38.97059
7230,Cidade Monções,80,2,2,1,2050,770,2820,35.25
7231,Indianópolis,50,1,1,1,4500,871,5371,107.42
7232,Liberdade,75,2,1,0,1300,406,1706,22.746666
7233,Campo Belo,75,3,2,2,3500,1080,4580,61.066666
7234,Higienópolis,80,3,2,0,2600,400,3000,37.5
7235,Pinheiros,75,2,2,1,2500,425,2925,39.0
7236,Brooklin,47,1,1,1,1800,695,2495,53.085106
7237,Morumbi,46,1,1,1,1690,960,2650,57.608696
7238,Pinheiros,57,1,2,0,4000,750,4750,83.333336
7239,Vila Leopoldina,83,3,3,2,3300,950,4250,51.20482
7240,Paraíso,101,3,3,1,3799,1254,5053,50.0297
7241,Jardins,70,2,3,1,3900,642,4542,64.88571
7242,Other,69,2,1,1,3000,800,3800,55.072464
7243,Other,56,2,1,1,1500,400,1900,33.92857
7244,Aclimação,91,3,1,3,3300,820,4120,45.274727
7245,Liberdade,35,1,1,1,1300,300,1600,45.714287
7246,Pinheiros,80,2,2,1,2600,868,3468,43.35
7247,Mirandópolis,27,1,1,0,1500,380,1880,69.62963
7248,Saúde,65,2,1,0,2401,600,3001,46.16923
7249,Other,40,2,1,0,1600,220,1820,45.5
7250,Paraíso,130,3,3,1,3200,1155,4355,33.5
7251,Itaim Bibi,97,3,2,2,5900,1290,7190,74.12371
7252,Aclimação,89,3,3,1,3000,840,3840,43.14607
7253,Vila Clementino,40,1,1,1,1800,568,2368,59.2
7254,Other,68,2,1,1,1300,369,1669,24.544117
7255,Vila Nova Conceição,50,1,2,2,3639,1400,5039,100.78
7256,Other,88,2,2,0,3200,1220,4420,50.227272
7257,Brooklin,148,3,2,2,4500,1450,5950,40.2027
7258,Chácara Santo Antônio,102,3,3,2,4800,980,5780,56.666668
7259,Lapa,93,3,3,2,4000,813,4813,51.75269
7260,Moema,54,2,2,1,2300,645,2945,54.537037
7261,Vila Guarani,128,3,3,2,4600,980,5580,43.59375
7262,Other,40,1,1,2,1300,639,1939,48.475
7263,Brooklin,65,2,2,1,3500,650,4150,63.846153
7264,Santa Cecília,197,3,3,1,4500,1589,6089,30.90863
7265,Brooklin,42,1,1,1,3200,600,3800,90.47619
7266,Vila Leopoldina,56,2,2,2,2500,750,3250,58.035713
7267,Other,87,3,3,2,5100,630,5730,65.86207
7268,Other,87,2,3,2,5000,535,5535,63.62069
7269,Itaim Bibi,40,1,1,1,3500,813,4313,107.825
7270,Other,58,2,2,1,1400,860,2260,38.96552
7271,Saúde,37,1,1,1,2200,492,2692,72.75676
7272,Other,64,2,1,0,1300,250,1550,24.21875
7273,Jardim Paulista,45,2,1,1,2300,837,3137,69.71111
7274,Santa Cecília,68,1,2,1,1500,1440,2940,43.235294
7275,Other,38,1,1,0,1400,100,1500,39.473682
7276,Jabaquara,52,2,1,1,1600,650,2250,43.26923
7277,Bela Vista,32,1,1,0,1100,450,1550,48.4375
7278,Vila Olímpia,70,2,1,1,2300,839,3139,44.842857
7279,Ipiranga,68,2,2,2,2700,605,3305,48.60294
7280,Vila Mariana,51,1,1,1,2000,434,2434,47.72549
7281,Other,47,2,1,1,1000,290,1290,27.446808
7282,Pompeia,84,3,2,2,3800,1180,4980,59.285713
7283,Jabaquara,60,2,1,1,1700,600,2300,38.333332
7284,Jardim Paulista,45,1,1,1,3900,750,4650,103.333336
7285,Other,131,3,2,1,3300,0,3300,25.19084
7286,Bela Vista,46,1,2,1,3100,381,3481,75.67391
7287,Vila Nova Conceição,85,2,2,1,2900,1290,4190,49.294117
7288,Itaim Bibi,85,2,2,1,6000,0,6000,70.588234
7289,Morumbi,42,1,1,1,1200,800,2000,47.61905
7290,Morumbi,148,2,3,2,4700,1317,6017,40.655407
7291,Vila Nova Conceição,70,1,1,0,1800,230,2030,29.0
7292,Itaim Bibi,65,1,2,1,5500,930,6430,98.92308
7293,Vila Mariana,69,2,2,1,2199,747,2946,42.695652
7294,Móoca,73,2,2,2,3030,770,3800,52.054794
7295,Chácara Santo Antônio,53,2,1,1,4460,982,5442,102.679245
7296,Morumbi,62,2,2,2,2500,611,3111,50.177418
7297,Other,54,2,1,1,1600,560,2160,40.0
7298,Vila Nova Conceição,80,2,2,1,3500,1000,4500,56.25
7299,Perdizes,84,2,2,0,2400,300,2700,32.142857
7300,Other,61,2,1,2,2500,1094,3594,58.918034
7301,Consolação,50,2,2,2,5000,0,5000,100.0
7302,Moema,81,2,3,2,6500,994,7494,92.51852
7303,Campo Belo,42,1,1,1,3500,0,3500,83.333336
7304,Vila Olímpia,43,1,1,1,1680,1129,2809,65.325584
7305,Moema,130,3,3,1,5000,1340,6340,48.76923
7306,Santo Amaro,85,3,1,2,4000,0,4000,47.058823
7307,Perdizes,42,1,1,1,2300,820,3120,74.28571
7308,Vila Mariana,80,2,2,1,2500,820,3320,41.5
7309,Brooklin,104,2,2,1,2800,665,3465,33.317307
7310,Brooklin,60,2,2,1,2200,637,2837,47.283333
7311,Other,68,2,2,1,1600,900,2500,36.764706
7312,Consolação,52,2,1,1,2500,577,3077,59.173077
7313,Vila Mascote,34,1,1,1,1200,457,1657,48.735294
7314,Brooklin,117,3,5,2,6800,1220,8020,68.54701
7315,Bela Vista,45,1,1,0,1300,520,1820,40.444443
7316,Pinheiros,68,2,2,1,2600,1145,3745,55.07353
7317,Pompeia,65,2,2,1,2600,637,3237,49.8
7318,Santa Cecília,50,1,1,0,1850,550,2400,48.0
7319,Brooklin,50,1,1,1,2300,700,3000,60.0
7320,Tatuapé,65,2,1,1,1550,387,1937,29.8
7321,Brooklin,100,3,2,1,3200,790,3990,39.9
7322,Other,172,3,4,3,8000,1630,9630,55.988373
7323,Other,47,2,1,1,1480,0,1480,31.48936
7324,Bela Vista,39,1,1,1,2400,550,2950,75.64103
7325,Brooklin,60,2,2,1,2500,962,3462,57.7
7326,Bela Vista,47,1,2,1,2200,560,2760,58.723404
7327,Campo Belo,35,1,1,1,2500,500,3000,85.71429
7328,Itaim Bibi,90,1,2,1,8900,1412,10312,114.577774
7329,Santana,86,2,1,0,1750,415,2165,25.17442
7330,Jardim Marajoara,61,2,1,1,2500,415,2915,47.786884
7331,Vila Prudente,50,2,2,1,1650,495,2145,42.9
7332,Other,45,2,1,1,1750,150,1900,42.22222
7333,Cambuci,94,2,2,0,2000,384,2384,25.361702
7334,Jardim Paulista,88,2,1,1,3400,0,3400,38.636364
7335,Indianópolis,115,3,3,2,4000,1584,5584,48.556522
7336,Pinheiros,30,1,1,1,2000,720,2720,90.666664
7337,Pinheiros,100,2,2,1,3550,1256,4806,48.06
7338,Barra Funda,128,4,3,2,5500,1200,6700,52.34375
7339,Chácara Santo Antônio,146,4,3,2,6200,1050,7250,49.657536
7340,Paraíso,95,2,1,1,2080,1020,3100,32.63158
7341,Higienópolis,90,2,3,2,3200,900,4100,45.555557
7342,Ipiranga,69,2,2,1,2900,490,3390,49.130436
7343,Santa Cecília,90,3,1,2,3000,1150,4150,46.11111
7344,Other,104,3,2,1,1500,1600,3100,29.807692
7345,Other,65,3,1,1,1450,408,1858,28.584616
7346,Tatuapé,85,3,3,2,2500,799,3299,38.811764
7347,Vila Buarque,42,1,1,1,1400,559,1959,46.642857
7348,Other,55,2,1,1,1350,483,1833,33.327274
7349,Moema,105,3,5,2,5500,1100,6600,62.857143
7350,Santana,76,2,2,2,3500,702,4202,55.289474
7351,Other,43,2,1,1,1200,278,1478,34.372093
7352,Other,158,3,2,2,4500,0,4500,28.481012
7353,Moema,55,2,2,1,4000,673,4673,84.96364
7354,Other,40,1,1,0,1000,150,1150,28.75
7355,Vila Clementino,100,3,4,2,4000,1390,5390,53.9
7356,Aclimação,50,2,2,0,1350,0,1350,27.0
7357,Other,88,1,2,0,3500,1220,4720,53.636364
7358,Brooklin,86,3,2,2,3900,900,4800,55.813953
7359,Saúde,48,1,1,1,1800,550,2350,48.958332
7360,Jardim Paulista,80,2,2,0,2450,659,3109,38.8625
7361,Moema,109,3,2,2,4900,1350,6250,57.33945
7362,Other,70,3,2,1,2500,491,2991,42.728573
7363,Cerqueira César,110,2,3,1,7800,1400,9200,83.63636
7364,Saúde,30,1,1,0,1200,200,1400,46.666668
7365,Other,128,4,4,2,6300,810,7110,55.546875
7366,Other,50,2,1,1,950,315,1265,25.3
7367,Itaim Bibi,45,1,1,1,3200,717,3917,87.04444
7368,Moema,75,3,2,2,3200,1150,4350,58.0
7369,Other,68,2,2,1,1755,0,1755,25.808823
7370,Other,72,2,2,2,3000,900,3900,54.166668
7371,Paraíso,70,2,2,1,2900,815,3715,53.07143
7372,Other,36,1,1,0,1400,0,1400,38.88889
7373,Other,55,2,1,1,2500,610,3110,56.545456
7374,Vila Andrade,70,2,2,2,1600,950,2550,36.42857
7375,Santo Amaro,60,2,1,1,2000,600,2600,43.333332
7376,Jardins,85,2,2,1,3000,1197,4197,49.376472
7377,Brooklin,117,3,4,2,4200,1680,5880,50.25641
7378,Campo Belo,75,2,2,1,2300,811,3111,41.48
7379,Vila Olímpia,74,2,2,1,3500,750,4250,57.432434
7380,Other,94,3,2,0,1600,820,2420,25.74468
7381,Perdizes,52,1,2,1,2400,400,2800,53.846153
7382,Vila Mascote,48,2,1,1,2100,850,2950,61.458332
7383,Higienópolis,43,1,1,1,2200,550,2750,63.953487
7384,Vila Leopoldina,53,2,1,1,2100,425,2525,47.64151
7385,Vila Mariana,37,1,1,1,1700,576,2276,61.51351
7386,Cidade Monções,105,2,3,2,6600,1149,7749,73.8
7387,Bela Vista,62,1,2,1,1500,1102,2602,41.967743
7388,Vila Mariana,86,3,1,2,3200,650,3850,44.76744
7389,Pinheiros,85,2,3,2,3850,1520,5370,63.17647
7390,Vila Olímpia,80,3,2,2,2500,1211,3711,46.3875
7391,Vila Mariana,100,3,1,1,2500,858,3358,33.58
7392,Vila Mariana,25,1,1,0,1100,80,1180,47.2
7393,Other,48,1,1,1,2700,665,3365,70.104164
7394,Barra Funda,33,1,1,0,1500,290,1790,54.242424
7395,Vila Olímpia,80,3,2,2,4200,1100,5300,66.25
7396,Centro,30,1,1,0,1800,534,2334,77.8
7397,Chácara Santo Antônio,134,4,4,3,4600,830,5430,40.52239
7398,Other,110,3,3,2,5000,1550,6550,59.545456
7399,Bela Vista,50,1,1,0,1600,579,2179,43.58
7400,Cambuci,63,2,2,1,2000,790,2790,44.285713
7401,Other,91,2,2,0,1600,430,2030,22.307692
7402,Vila Guarani,56,2,1,1,1500,637,2137,38.160713
7403,Aclimação,40,1,1,1,1900,558,2458,61.45
7404,Vila Mariana,38,1,1,1,1500,497,1997,52.55263
7405,Móoca,39,1,1,1,1900,300,2200,56.410255
7406,Bela Vista,38,1,1,0,1490,372,1862,49.0
7407,Itaim Bibi,89,2,2,1,4950,821,5771,64.8427
7408,Pinheiros,57,1,1,1,3800,770,4570,80.17544
7409,Consolação,67,2,2,1,3800,750,4550,67.910446
7410,Moema,88,3,3,1,2900,1685,4585,52.102272
7411,Morumbi,81,3,3,2,3050,750,3800,46.91358
7412,Pinheiros,72,3,2,1,5500,580,6080,84.44444
7413,Tatuapé,130,2,2,2,5700,800,6500,50.0
7414,Tatuapé,72,2,1,1,1600,590,2190,30.416666
7415,Vila Mariana,68,2,2,1,2300,707,3007,44.22059
7416,Other,50,2,1,1,1400,400,1800,36.0
7417,Itaim Bibi,78,3,2,1,3500,1030,4530,58.076923
7418,Bela Vista,37,1,1,0,1150,340,1490,40.27027
7419,Other,70,3,1,1,2000,580,2580,36.857143
7420,Vila Mariana,85,2,2,1,2600,650,3250,38.235294
7421,Other,60,2,2,2,1800,995,2795,46.583332
7422,Santa Cecília,39,1,1,1,1750,680,2430,62.307693
7423,Consolação,48,1,1,1,1800,439,2239,46.645832
7424,Jardim Paulista,50,2,1,1,2600,838,3438,68.76
7425,Aclimação,52,2,1,1,1600,520,2120,40.76923
7426,Other,47,2,1,1,1750,385,2135,45.425533
7427,Other,67,3,1,1,1680,607,2287,34.134327
7428,Brooklin,42,1,1,1,3000,605,3605,85.833336
7429,Liberdade,45,1,1,1,1500,773,2273,50.511112
7430,Jabaquara,76,2,2,2,1440,928,2368,31.157894
7431,Pinheiros,30,1,1,0,3000,500,3500,116.666664
7432,Other,76,2,2,2,2700,956,3656,48.105263
7433,Other,44,1,1,0,1600,0,1600,36.363636
7434,Jardim Paulista,82,2,2,1,3600,955,4555,55.548782
7435,Jardim Paulista,90,2,1,1,3200,0,3200,35.555557
7436,Other,82,3,2,1,2500,550,3050,37.19512
7437,Other,76,3,2,2,3057,760,3817,50.223682
7438,Other,70,3,1,1,2000,779,2779,39.7
7439,Bela Vista,75,2,1,0,1600,300,1900,25.333334
7440,Other,100,3,2,1,2600,791,3391,33.91
7441,Campo Belo,130,3,4,1,4100,1200,5300,40.76923
7442,Liberdade,36,1,1,0,1200,349,1549,43.02778
7443,Tatuapé,93,2,3,2,5000,695,5695,61.23656
7444,Brás,38,1,1,0,1500,350,1850,48.68421
7445,Brooklin,126,3,4,2,7000,1048,8048,63.873016
7446,Vila Mariana,100,3,3,2,5800,1500,7300,73.0
7447,Vila Andrade,70,2,2,2,1150,900,2050,29.285715
7448,Other,64,2,2,1,2530,490,3020,47.1875
7449,Other,52,2,1,1,800,253,1053,20.25
7450,Vila Mascote,45,2,1,1,1300,629,1929,42.866665
7451,Other,68,2,1,1,1000,750,1750,25.735294
7452,Lapa,115,3,3,1,3300,790,4090,35.565216
7453,Other,56,2,1,1,1000,300,1300,23.214285
7454,Vila Clementino,84,2,3,2,2800,1138,3938,46.88095
7455,Other,60,2,2,1,850,390,1240,20.666666
7456,Móoca,45,2,1,1,2200,500,2700,60.0
7457,Cambuci,51,2,1,1,1500,805,2305,45.19608
7458,Brooklin,44,2,1,1,2500,880,3380,76.818184
7459,Other,130,3,2,1,2400,850,3250,25.0
7460,Other,54,2,1,2,2102,0,2102,38.925926
7461,Other,67,3,2,1,1700,513,2213,33.02985
7462,Chácara Santo Antônio,50,2,2,1,2650,0,2650,53.0
7463,Móoca,92,3,1,2,2500,850,3350,36.413044
7464,Vila Leopoldina,56,2,2,1,2200,648,2848,50.857143
7465,Jardins,109,3,2,1,4500,1119,5619,51.550457
7466,Other,72,3,2,2,1750,698,2448,34.0
7467,Vila Mariana,50,1,2,1,3500,856,4356,87.12
7468,Higienópolis,62,2,2,1,3000,970,3970,64.03226
7469,Other,65,2,1,1,2600,0,2600,40.0
7470,Vila Nova Conceição,35,1,1,0,2300,400,2700,77.14286
7471,Butantã,67,2,1,2,1500,705,2205,32.910446
7472,Barra Funda,70,3,2,2,3700,650,4350,62.142857
7473,Saúde,47,1,1,1,1800,602,2402,51.106384
7474,Other,61,2,2,1,1900,360,2260,37.04918
7475,Chácara Santo Antônio,95,2,3,2,5500,725,6225,65.52631
7476,Moema,113,4,2,2,5500,1196,6696,59.256638
7477,Pinheiros,70,2,1,0,2200,300,2500,35.714287
7478,Moema,92,3,4,2,3800,1089,4889,53.141304
7479,Vila Nova Conceição,85,3,1,1,6200,0,6200,72.94118
7480,Brooklin,91,3,3,2,3500,1018,4518,49.64835
7481,Jardim Paulista,120,3,3,2,7000,1460,8460,70.5
7482,Pinheiros,49,2,1,1,2600,602,3202,65.34694
7483,Moema,73,2,2,2,4700,950,5650,77.39726
7484,Tatuapé,65,2,2,1,2100,600,2700,41.53846
7485,Brás,65,2,1,1,1200,589,1789,27.523077
7486,Móoca,65,2,2,1,2400,520,2920,44.923077
7487,Tatuapé,63,3,2,1,2500,680,3180,50.47619
7488,Other,75,2,2,2,2035,912,2947,39.293335
7489,Brooklin,42,1,1,1,2900,580,3480,82.85714
7490,Vila Nova Conceição,36,1,1,1,2836,967,3803,105.638885
7491,Vila Olímpia,47,1,1,1,2320,670,2990,63.61702
7492,Moema,70,2,2,2,5300,720,6020,86.0
7493,Higienópolis,70,2,2,1,2600,960,3560,50.857143
7494,Other,44,2,1,1,2150,250,2400,54.545456
7495,Pinheiros,60,2,2,1,3900,1100,5000,83.333336
7496,Pinheiros,65,2,1,2,4454,1458,5912,90.95385
7497,Santo Amaro,85,3,2,1,3900,0,3900,45.882355
7498,Vila Clementino,43,1,1,1,3500,530,4030,93.72093
7499,Vila Mariana,47,1,2,1,2000,719,2719,57.851063
7500,Moema,74,2,3,2,3650,1260,4910,66.35135
7501,Other,45,2,1,1,1600,300,1900,42.22222
7502,Jardim Paulista,110,3,3,2,5500,1060,6560,59.636364
7503,Perdizes,75,2,2,0,3500,1,3501,46.68
7504,Other,60,2,1,1,1690,542,2232,37.2
7505,Indianópolis,43,1,1,1,2000,796,2796,65.023254
7506,Ipiranga,63,1,1,0,1400,0,1400,22.222221
7507,Perdizes,42,1,1,1,2200,554,2754,65.57143
7508,Bela Vista,35,1,1,1,2356,551,2907,83.057144
7509,Pinheiros,66,2,1,1,2300,980,3280,49.696968
7510,Saúde,37,1,1,1,2000,480,2480,67.02702
7511,Vila Guarani,50,1,1,1,2200,494,2694,53.88
7512,Santa Cecília,65,2,1,1,2800,800,3600,55.384617
7513,Other,40,2,1,1,1300,0,1300,32.5
7514,Other,85,2,2,1,2000,783,2783,32.741177
7515,Chácara Santo Antônio,51,1,1,1,4100,760,4860,95.29412
7516,Vila Madalena,79,2,1,1,4650,875,5525,69.93671
7517,Perdizes,50,1,1,1,1900,600,2500,50.0
7518,Moema,80,2,3,1,2600,950,3550,44.375
7519,Other,32,1,1,0,1100,0,1100,34.375
7520,Aclimação,43,1,1,1,2300,800,3100,72.093025
7521,Vila Mariana,49,2,1,1,2800,463,3263,66.591835
7522,Pinheiros,110,3,3,1,3900,880,4780,43.454544
7523,Vila Mariana,60,2,1,1,2200,690,2890,48.166668
7524,Lapa,87,2,2,1,3500,320,3820,43.908047
7525,Brooklin,55,1,1,1,6000,1070,7070,128.54546
7526,Jabaquara,55,2,1,1,1500,600,2100,38.18182
7527,Brooklin,70,2,1,1,2100,1000,3100,44.285713
7528,Cidade Monções,52,2,2,1,3370,0,3370,64.80769
7529,República,36,1,1,1,2200,440,2640,73.333336
7530,Campo Belo,78,3,2,1,2200,950,3150,40.384617
7531,Ipiranga,125,3,3,2,6000,1028,7028,56.224
7532,Chácara Santo Antônio,70,2,2,2,4500,852,5352,76.457146
7533,Bela Vista,45,1,1,1,1700,660,2360,52.444443
7534,Campo Belo,125,4,4,2,3000,1415,4415,35.32
7535,Tatuapé,40,1,1,1,2500,660,3160,79.0
7536,Other,49,2,1,1,1000,698,1698,34.65306
7537,Other,49,2,1,0,1100,280,1380,28.163265
7538,Other,32,1,1,0,1200,0,1200,37.5
7539,Lapa,80,1,1,1,3300,0,3300,41.25
7540,Other,64,1,2,1,4000,1058,5058,79.03125
7541,Saúde,77,2,2,1,1800,998,2798,36.33766
7542,Brooklin,70,2,1,1,3995,850,4845,69.21429
7543,Cerqueira César,91,2,2,1,2900,954,3854,42.35165
7544,Other,70,3,2,1,1650,650,2300,32.857143
7545,Pinheiros,160,3,4,2,5000,1700,6700,41.875
7546,Other,65,2,2,1,1800,587,2387,36.723076
7547,Cambuci,105,3,2,1,2500,1050,3550,33.809525
7548,Vila Mariana,45,1,1,1,3500,0,3500,77.77778
7549,Pompeia,40,1,1,1,1800,500,2300,57.5
7550,Vila Leopoldina,56,2,2,1,3400,535,3935,70.26786
7551,Ipiranga,70,3,2,2,2300,653,2953,42.185715
7552,Santa Cecília,42,1,1,1,2850,558,3408,81.14286
7553,Other,48,2,1,1,1500,300,1800,37.5
7554,Perdizes,80,3,1,0,2750,0,2750,34.375
7555,Aclimação,39,1,1,1,2260,530,2790,71.53846
7556,Vila Mascote,70,2,1,1,1500,599,2099,29.985714
7557,Vila Guarani,56,2,2,1,2800,560,3360,60.0
7558,Jardim Paulista,82,2,2,0,2900,360,3260,39.756096
7559,Other,58,2,1,1,1500,610,2110,36.37931
7560,Vila Madalena,78,1,2,2,2600,1200,3800,48.71795
7561,Brooklin,68,2,2,1,7500,1085,8585,126.25
7562,Vila Clementino,43,1,1,1,2700,675,3375,78.48837
7563,Consolação,86,2,1,1,3000,700,3700,43.023254
7564,Vila Mariana,91,3,3,1,2800,1100,3900,42.857143
7565,Bela Vista,104,3,2,0,2200,955,3155,30.336538
7566,Saúde,67,2,2,1,3100,830,3930,58.656715
7567,Other,60,2,2,1,1200,1,1201,20.016666
7568,Vila Mariana,80,3,1,1,1800,535,2335,29.1875
7569,Other,75,3,3,2,3500,765,4265,56.866665
7570,Brooklin,67,1,2,2,4300,1048,5348,79.82089
7571,Brooklin,126,3,3,0,4500,1664,6164,48.920635
7572,Cerqueira César,55,2,1,0,2500,850,3350,60.909092
7573,Vila Mariana,63,2,2,0,1800,406,2206,35.015873
7574,Santo Amaro,210,4,4,4,8000,1700,9700,46.190475
7575,Other,152,3,2,0,1800,1250,3050,20.06579
7576,Ipiranga,60,2,2,2,2000,870,2870,47.833332
7577,Aclimação,40,1,1,1,2290,561,2851,71.275
7578,Barra Funda,34,1,1,0,1500,210,1710,50.294117
7579,Cerqueira César,62,2,2,1,4490,590,5080,81.935486
7580,Chácara Santo Antônio,70,2,3,1,3200,734,3934,56.2
7581,Jardim Marajoara,64,3,1,1,1775,636,2411,37.671875
7582,Campo Belo,39,1,1,1,2550,330,2880,73.84615
7583,Itaim Bibi,110,3,4,2,4900,1500,6400,58.18182
7584,Higienópolis,35,1,1,1,1600,512,2112,60.342857
7585,Vila Olímpia,80,2,1,1,2100,364,2464,30.8
7586,Other,32,2,1,0,800,185,985,30.78125
7587,Vila Nova Conceição,105,2,3,1,5450,1346,6796,64.72381
7588,Other,120,2,1,1,1800,510,2310,19.25
7589,Perdizes,115,4,3,2,3580,1607,5187,45.104347
7590,Other,50,2,1,1,1800,291,2091,41.82
7591,Perdizes,84,2,2,2,2800,1157,3957,47.107143
7592,Other,49,2,1,1,1900,350,2250,45.918365
7593,Centro,40,1,1,1,2500,450,2950,73.75
7594,Cerqueira César,105,2,3,1,2600,1374,3974,37.84762
7595,Brás,44,2,1,1,1550,370,1920,43.636364
7596,Other,24,1,1,1,2450,0,2450,102.083336
7597,Other,41,1,1,1,2400,900,3300,80.48781
7598,Itaim Bibi,45,1,1,1,3500,624,4124,91.64445
7599,Other,45,1,1,0,1100,0,1100,24.444445
7600,Moema,84,2,2,1,1700,702,2402,28.595238
7601,Aclimação,62,2,1,2,1600,750,2350,37.903225
7602,Vila Madalena,81,2,2,1,3500,1289,4789,59.123455
7603,Santo Amaro,65,2,1,1,2700,490,3190,49.076923
7604,Itaim Bibi,50,1,1,1,2600,728,3328,66.56
7605,Bela Vista,48,1,2,0,2800,450,3250,67.708336
7606,Other,47,1,1,1,3100,595,3695,78.61702
7607,Ipiranga,192,4,1,3,7500,0,7500,39.0625
7608,Pinheiros,85,2,2,2,5785,1342,7127,83.84706
7609,Vila Andrade,52,2,1,1,2500,0,2500,48.076923
7610,Vila Mascote,50,2,1,1,2800,405,3205,64.1
7611,Campo Belo,44,1,1,1,1900,665,2565,58.295456
7612,Bela Vista,42,1,1,1,1399,669,2068,49.238094
7613,Vila Prudente,41,2,1,1,2000,300,2300,56.09756
7614,Vila Buarque,25,1,1,0,1000,368,1368,54.72
7615,Pinheiros,42,1,1,1,3600,647,4247,101.11905
7616,Perdizes,140,3,3,1,3900,1000,4900,35.0
7617,Moema,110,3,1,2,6000,1200,7200,65.454544
7618,Brooklin,62,2,1,1,2100,720,2820,45.48387
7619,Brás,60,2,2,0,1600,500,2100,35.0
7620,Jabaquara,114,3,2,2,2200,1300,3500,30.701754
7621,Brooklin,43,1,1,1,4205,628,4833,112.39535
7622,Other,50,2,1,1,1300,450,1750,35.0
7623,Ipiranga,60,2,2,2,1700,874,2574,42.9
7624,Bela Vista,48,1,1,0,1300,523,1823,37.979168
7625,Liberdade,30,1,1,1,1846,1254,3100,103.333336
7626,Jardim Paulista,42,1,1,1,1399,699,2098,49.95238
7627,Vila Olímpia,60,2,1,1,3200,1000,4200,70.0
7628,Aclimação,66,2,2,2,2700,741,3441,52.136364
7629,Vila Nova Conceição,70,2,2,1,2950,1600,4550,65.0
7630,Bela Vista,34,1,1,0,1200,353,1553,45.67647
7631,Vila Clementino,65,2,2,1,1900,1167,3067,47.184616
7632,Barra Funda,126,4,3,2,5859,1200,7059,56.02381
7633,Móoca,40,1,1,0,1300,180,1480,37.0
7634,Other,60,2,2,2,3300,623,3923,65.38333
7635,Santo Amaro,65,2,2,2,4000,685,4685,72.07692
7636,Saúde,62,2,2,1,2200,930,3130,50.48387
7637,Other,55,2,2,1,1200,452,1652,30.036364
7638,Other,130,4,4,2,7000,1350,8350,64.23077
7639,Other,64,2,1,1,1300,875,2175,33.984375
7640,Jardins,76,2,1,1,5300,1000,6300,82.89474
7641,Campo Belo,50,1,1,1,2950,700,3650,73.0
7642,Bela Vista,25,1,1,0,1050,190,1240,49.6
7643,Barra Funda,160,3,2,2,7000,1204,8204,51.275
7644,Jardins,53,2,2,1,3700,730,4430,83.58491
7645,Liberdade,49,2,1,1,1600,222,1822,37.183674
7646,Brooklin,47,1,1,1,3000,485,3485,74.14893
7647,Jardim Marajoara,59,2,1,1,1585,614,2199,37.271187
7648,Brás,55,2,1,1,1450,350,1800,32.727272
7649,Chácara Santo Antônio,48,1,1,1,2250,326,2576,53.666668
7650,Other,33,1,1,1,2500,800,3300,100.0
7651,Tatuapé,70,3,2,1,2000,561,2561,36.585712
7652,Jaguaré,60,2,1,1,1650,700,2350,39.166668
7653,Bela Vista,103,3,3,1,2800,830,3630,35.242718
7654,Other,102,2,1,1,1000,333,1333,13.068627
7655,Other,58,2,2,0,1800,646,2446,42.172413
7656,Moema,35,1,1,0,3000,0,3000,85.71429
7657,Perdizes,86,3,3,1,3000,850,3850,44.76744
7658,Moema,70,2,2,1,2600,900,3500,50.0
7659,Other,98,4,3,2,4000,660,4660,47.55102
7660,Campo Belo,60,2,1,0,2200,1,2201,36.683334
7661,Jardim Paulista,68,2,2,1,2700,809,3509,51.60294
7662,Jardim Paulista,34,1,1,1,1800,577,2377,69.911766
7663,Tatuapé,82,3,2,1,2500,830,3330,40.609756
7664,Barra Funda,66,2,2,1,2700,995,3695,55.984848
7665,Other,90,2,4,1,2800,1239,4039,44.877777
7666,Bela Vista,103,3,3,1,3500,1430,4930,47.86408
7667,Ipiranga,68,2,2,1,2700,0,2700,39.705883
7668,Mirandópolis,27,1,1,0,1500,390,1890,70.0
7669,Bela Vista,35,1,1,0,1300,0,1300,37.142857
7670,Moema,130,3,3,2,5200,1287,6487,49.9
7671,Other,75,3,2,1,1400,750,2150,28.666666
7672,Moema,40,1,1,1,2500,800,3300,82.5
7673,Aclimação,77,3,1,2,2900,0,2900,37.66234
7674,Tatuapé,48,2,1,1,1500,356,1856,38.666668
7675,Vila Olímpia,35,1,1,1,3000,858,3858,110.22857
7676,Other,110,3,3,2,3200,920,4120,37.454544
7677,Vila Nova Conceição,37,1,1,1,2300,900,3200,86.48649
7678,Ipiranga,70,2,1,0,1700,310,2010,28.714285
7679,Bela Vista,65,1,2,1,3000,1118,4118,63.353848
7680,Itaim Bibi,62,2,2,1,5000,873,5873,94.72581
7681,Other,50,2,1,2,1500,350,1850,37.0
7682,Other,49,2,1,0,1200,100,1300,26.530613
7683,Consolação,40,1,1,1,2100,378,2478,61.95
7684,Other,56,2,1,1,1700,640,2340,41.785713
7685,Paraíso,59,2,2,1,3300,615,3915,66.355934
7686,Jardim Paulista,118,3,3,2,3500,1282,4782,40.525425
7687,Other,69,2,2,1,1600,510,2110,30.57971
7688,Jardim Paulista,45,1,1,1,3000,780,3780,84.0
7689,Other,35,1,1,0,1200,0,1200,34.285713
7690,Other,52,2,1,1,1750,450,2200,42.307693
7691,Vila Olímpia,65,2,2,1,3500,875,4375,67.30769
7692,Paraíso,38,1,1,1,1400,510,1910,50.263157
7693,Other,52,1,1,1,1300,0,1300,25.0
7694,Moema,165,3,4,2,6000,1400,7400,44.848484
7695,Jabaquara,55,2,1,1,1549,641,2190,39.81818
7696,Morumbi,86,1,2,2,3000,1300,4300,50.0
7697,Other,62,2,1,1,1200,535,1735,27.983871
7698,Vila Olímpia,31,1,1,1,3000,800,3800,122.58064
7699,Lapa,62,2,1,1,2700,628,3328,53.677418
7700,Other,52,2,1,1,1500,420,1920,36.923077
7701,Higienópolis,50,1,1,1,1800,550,2350,47.0
7702,Other,47,2,1,1,1500,0,1500,31.914894
7703,Campo Belo,83,2,3,1,2000,1149,3149,37.93976
7704,Vila Olímpia,105,3,3,1,2700,950,3650,34.761906
7705,Jardins,38,1,1,1,4000,0,4000,105.26316
7706,Cerqueira César,72,2,2,2,3000,971,3971,55.15278
7707,Campo Belo,37,1,1,1,1800,1400,3200,86.48649
7708,Brooklin,50,1,1,1,1800,641,2441,48.82
7709,Vila Olímpia,70,2,1,1,2409,715,3124,44.62857
7710,Other,57,2,1,2,1500,550,2050,35.964912
7711,Itaim Bibi,125,2,2,1,4500,1660,6160,49.28
7712,Bela Vista,60,2,2,1,3300,612,3912,65.2
7713,Chácara Santo Antônio,103,3,3,2,4800,1000,5800,56.31068
7714,Other,50,2,1,1,1400,424,1824,36.48
7715,Pinheiros,49,2,1,1,2800,657,3457,70.55102
7716,Pinheiros,45,1,1,1,2200,1002,3202,71.155556
7717,Perdizes,105,3,3,1,3500,998,4498,42.838097
7718,Paraíso,201,2,3,0,5000,919,5919,29.447762
7719,Other,65,2,1,0,1500,328,1828,28.123077
7720,Brooklin,36,1,1,1,3200,0,3200,88.888885
7721,Consolação,27,1,1,0,2400,280,2680,99.25926
7722,Jardim Paulista,68,2,2,0,3000,690,3690,54.264706
7723,Vila Buarque,50,1,1,0,1400,572,1972,39.44
7724,Pinheiros,85,3,2,1,3000,800,3800,44.705883
7725,Vila Andrade,49,1,1,1,2000,475,2475,50.510204
7726,Vila Mariana,70,2,1,0,1600,392,1992,28.457144
7727,Santana,205,3,5,2,7000,0,7000,34.146343
7728,Vila Mariana,60,2,2,1,3550,920,4470,74.5
7729,Ipiranga,137,4,2,2,6000,1100,7100,51.824818
7730,Jardim América,40,1,1,0,2200,429,2629,65.725
7731,Other,60,2,1,0,1600,236,1836,30.6
7732,Vila Mariana,73,2,1,2,4600,1156,5756,78.84931
7733,Perdizes,127,3,2,2,7500,1331,8831,69.53543
7734,Other,42,1,1,0,780,0,780,18.571428
7735,Other,80,2,2,0,1400,700,2100,26.25
7736,Perdizes,33,1,1,0,2500,426,2926,88.666664
7737,Perdizes,75,2,1,1,1850,975,2825,37.666668
7738,Other,137,3,1,1,1900,1200,3100,22.627737
7739,Other,76,2,1,0,1600,0,1600,21.052631
7740,Aclimação,50,1,1,0,1300,487,1787,35.74
7741,Chácara Santo Antônio,70,2,2,1,3200,750,3950,56.42857
7742,Vila Prudente,69,3,2,1,2300,515,2815,40.7971
7743,Tatuapé,67,2,2,1,3000,476,3476,51.880596
7744,Vila Leopoldina,68,2,1,1,1800,905,2705,39.77941
7745,Consolação,29,1,1,0,2100,276,2376,81.93104
7746,Ipiranga,60,2,2,1,2200,737,2937,48.95
7747,Moema,60,2,2,1,2900,787,3687,61.45
7748,Vila Olímpia,97,2,3,1,3900,1090,4990,51.4433
7749,Other,70,2,2,2,2000,680,2680,38.285713
7750,Lapa,60,2,2,1,2730,660,3390,56.5
7751,Santana,50,1,1,0,1100,345,1445,28.9
7752,Other,66,3,1,1,1300,502,1802,27.30303
7753,Moema,156,3,6,3,9000,1585,10585,67.85256
7754,Other,58,2,1,1,2100,390,2490,42.931034
7755,Saúde,60,2,1,1,1800,750,2550,42.5
7756,Aclimação,23,1,1,0,1080,267,1347,58.565216
7757,Other,46,2,1,1,1600,1600,3200,69.565216
7758,Vila Nova Conceição,127,3,3,2,9170,1415,10585,83.34646
7759,Bela Vista,33,1,1,0,1700,450,2150,65.15151
7760,Brooklin,93,3,4,2,4500,1320,5820,62.580647
7761,Other,75,2,2,1,1700,930,2630,35.066666
7762,Consolação,40,1,1,1,2100,450,2550,63.75
7763,Campo Belo,70,2,2,2,1800,939,2739,39.12857
7764,Other,47,2,1,1,1250,367,1617,34.404255
7765,Other,22,1,1,0,2100,361,2461,111.86364
7766,Vila Nova Conceição,55,2,1,1,1400,780,2180,39.636364
7767,Cidade Monções,62,1,1,1,3850,913,4763,76.82258
7768,Saúde,66,2,2,1,1900,599,2499,37.863636
7769,Other,95,3,3,2,2600,1056,3656,38.48421
7770,Pinheiros,50,2,1,1,2600,662,3262,65.24
7771,Jardim Paulista,43,1,1,1,2300,1300,3600,83.72093
7772,Campo Belo,106,3,3,2,4200,1344,5544,52.301888
7773,Bela Vista,39,1,1,1,2800,428,3228,82.76923
7774,Brás,98,2,1,0,1680,0,1680,17.142857
7775,Perdizes,115,3,4,2,3800,1100,4900,42.608696
7776,Perdizes,70,2,2,2,2950,650,3600,51.42857
7777,Brooklin,51,1,1,1,3300,592,3892,76.31373
7778,Móoca,77,3,2,2,2800,700,3500,45.454544
7779,Other,75,3,1,1,1950,647,2597,34.626667
7780,Brooklin,112,3,4,2,3800,1251,5051,45.098213
7781,Jardim Paulista,110,3,3,2,5500,1060,6560,59.636364
7782,Pinheiros,42,1,1,1,2300,656,2956,70.38095
7783,Other,60,2,2,1,3350,583,3933,65.55
7784,Other,68,2,1,1,1500,880,2380,35.0
7785,Santo Amaro,115,3,3,2,5000,900,5900,51.304348
7786,Other,47,1,2,1,2300,600,2900,61.70213
7787,Barra Funda,162,3,4,2,8000,1500,9500,58.641975
7788,Bela Vista,40,1,1,1,2550,602,3152,78.8
7789,Morumbi,135,3,4,2,2500,1170,3670,27.185184
7790,Jardim Paulista,75,2,1,1,3050,1100,4150,55.333332
7791,Other,70,2,2,1,1800,747,2547,36.385715
7792,Butantã,50,2,1,1,1400,450,1850,37.0
7793,Other,60,2,2,1,1300,500,1800,30.0
7794,Brooklin,37,1,1,1,2000,800,2800,75.675674
7795,Morumbi,110,2,4,2,2800,1300,4100,37.272728
7796,Other,48,2,1,1,2300,500,2800,58.333332
7797,Other,45,1,1,1,1900,500,2400,53.333332
7798,Higienópolis,62,2,2,2,4800,747,5547,89.46774
7799,Other,58,2,1,1,1300,460,1760,30.344828
7800,Other,36,2,1,0,1500,120,1620,45.0
7801,Other,41,2,1,0,1200,0,1200,29.268293
7802,Other,50,2,2,1,1800,650,2450,49.0
7803,Other,64,2,2,1,2620,600,3220,50.3125
7804,Vila Madalena,72,2,2,1,4700,950,5650,78.47222
7805,Pinheiros,50,1,2,1,3100,740,3840,76.8
7806,Other,98,3,4,2,3000,1200,4200,42.857143
7807,Jaguaré,63,2,2,1,2000,440,2440,38.73016
7808,Santana,44,1,1,1,1600,600,2200,50.0
7809,Other,80,3,2,1,3100,505,3605,45.0625
7810,Higienópolis,93,3,3,1,3600,1100,4700,50.537636
7811,Móoca,58,2,1,1,2000,470,2470,42.58621
7812,Jardim América,79,2,2,1,4000,1050,5050,63.92405
7813,Bela Vista,100,3,2,1,2400,980,3380,33.8
7814,Perdizes,96,3,3,2,3500,1250,4750,49.479168
7815,Jaguaré,80,2,2,2,1450,685,2135,26.6875
7816,Jabaquara,47,2,1,1,1550,645,2195,46.70213
7817,Brás,40,1,1,1,1500,210,1710,42.75
7818,Brooklin,49,1,1,1,3500,900,4400,89.79592
7819,Paraíso,47,1,1,1,1600,660,2260,48.085106
7820,Butantã,72,2,1,1,1800,0,1800,25.0
7821,Campo Belo,45,1,2,1,2800,352,3152,70.04444
7822,Tatuapé,60,2,1,1,2100,450,2550,42.5
7823,Vila Guarani,65,3,2,2,1900,801,2701,41.553844
7824,Other,32,1,1,0,800,0,800,25.0
7825,Other,32,1,1,0,1250,100,1350,42.1875
7826,Other,55,2,1,1,1200,440,1640,29.818182
7827,Paraíso,102,3,2,1,3800,1325,5125,50.2451
7828,Other,52,1,1,1,2950,500,3450,66.34615
7829,Jardim Marajoara,50,2,1,2,1460,490,1950,39.0
7830,Consolação,110,2,2,0,2500,750,3250,29.545454
7831,Other,70,1,1,1,2400,994,3394,48.485714
7832,Vila Mariana,68,2,2,0,2000,452,2452,36.058823
7833,Other,76,3,2,1,3400,550,3950,51.973682
7834,Santana,38,1,1,1,1500,735,2235,58.81579
7835,Barra Funda,90,3,3,1,2600,750,3350,37.22222
7836,Morumbi,50,1,2,1,2700,750,3450,69.0
7837,Vila Andrade,58,2,1,2,1800,670,2470,42.58621
7838,Santa Cecília,78,2,2,0,2100,721,2821,36.166668
7839,Santo Amaro,65,2,2,2,3200,1060,4260,65.53846
7840,Moema,55,2,2,2,2750,810,3560,64.72727
7841,Bela Vista,76,2,1,1,3300,860,4160,54.736843
7842,Other,80,3,2,1,1500,747,2247,28.0875
7843,Other,32,1,1,0,1150,150,1300,40.625
7844,Perdizes,84,3,2,1,2800,972,3772,44.904762
7845,Other,80,2,2,2,4500,975,5475,68.4375
7846,Consolação,65,1,1,1,1350,1013,2363,36.353848
7847,Cerqueira César,29,1,1,1,2000,1051,3051,105.206894
7848,Cidade Monções,75,2,2,2,5800,1200,7000,93.333336
7849,Indianópolis,75,2,3,1,3800,1160,4960,66.13333
7850,Other,55,2,1,1,1360,540,1900,34.545456
7851,Brooklin,180,3,3,3,9000,1500,10500,58.333332
7852,Brooklin,68,2,2,1,5000,900,5900,86.76471
7853,Other,86,3,3,2,3000,760,3760,43.720932
7854,Vila Mariana,90,2,2,1,2500,844,3344,37.155556
7855,Liberdade,54,2,1,1,3000,630,3630,67.22222
7856,Other,84,2,2,2,3600,600,4200,50.0
7857,Vila Buarque,120,2,1,1,3000,840,3840,32.0
7858,Vila Leopoldina,70,2,2,1,2300,750,3050,43.57143
7859,Vila Mascote,83,2,2,2,4500,699,5199,62.638554
7860,Morumbi,60,1,1,1,1900,1172,3072,51.2
7861,Vila Mariana,84,2,2,1,2650,521,3171,37.75
7862,Morumbi,50,1,1,1,1650,322,1972,39.44
7863,Cambuci,100,3,3,1,1950,980,2930,29.3
7864,Other,73,2,1,1,1200,600,1800,24.657534
7865,Vila Leopoldina,93,2,2,2,3800,800,4600,49.462364
7866,Vila Mascote,84,3,1,2,2300,1303,3603,42.892857
7867,Butantã,24,1,1,0,1300,0,1300,54.166668
7868,Paraíso,80,2,1,0,2300,160,2460,30.75
7869,Bela Vista,110,3,2,1,3300,964,4264,38.763638
7870,Vila Guarani,56,2,1,1,2000,600,2600,46.42857
7871,Santa Cecília,140,2,4,1,3200,1670,4870,34.785713
7872,Other,57,2,1,1,950,0,950,16.666666
7873,Other,160,4,4,2,2500,1200,3700,23.125
7874,República,32,1,1,1,1000,785,1785,55.78125
7875,Chácara Santo Antônio,112,3,3,2,5800,840,6640,59.285713
7876,Vila Andrade,68,2,2,2,2420,550,2970,43.67647
7877,Campo Belo,90,3,2,2,3000,1200,4200,46.666668
7878,Moema,110,3,2,2,4000,1055,5055,45.954544
7879,Other,38,1,1,1,1800,320,2120,55.789474
7880,Vila Mariana,68,1,1,1,1900,661,2561,37.661766
7881,Santa Cecília,100,2,3,1,2800,922,3722,37.22
7882,Other,63,2,2,2,4500,890,5390,85.55556
7883,Bela Vista,110,3,3,1,2500,1038,3538,32.163635
7884,Other,80,2,1,1,1100,395,1495,18.6875
7885,Indianópolis,42,1,2,1,1750,550,2300,54.761906
7886,Itaim Bibi,50,1,2,1,2800,856,3656,73.12
7887,Other,55,2,1,1,2200,450,2650,48.18182
7888,Brooklin,39,1,1,1,2400,500,2900,74.35897
7889,Tatuapé,50,1,1,1,2700,400,3100,62.0
7890,Vila Mariana,80,3,2,1,2600,740,3340,41.75
7891,Vila Nova Conceição,55,2,1,1,3500,1685,5185,94.27273
7892,Itaim Bibi,120,3,2,1,3800,1298,5098,42.483334
7893,Aclimação,39,1,1,1,2260,530,2790,71.53846
7894,Tatuapé,40,1,1,1,2700,794,3494,87.35
7895,Other,111,3,4,2,7900,1300,9200,82.88288
7896,Perdizes,120,3,1,2,2700,1100,3800,31.666666
7897,Other,138,4,4,2,6800,805,7605,55.108696
7898,Santo Amaro,45,2,1,0,1600,0,1600,35.555557
7899,Santana,50,1,1,0,1150,180,1330,26.6
7900,Other,48,2,1,1,1300,300,1600,33.333332
7901,Other,70,3,2,2,2200,425,2625,37.5
7902,Other,38,2,1,1,2100,300,2400,63.157894
7903,Pinheiros,72,2,2,2,2300,1420,3720,51.666668
7904,Campo Belo,50,1,1,1,2900,795,3695,73.9
7905,Campo Belo,120,3,4,2,3700,1250,4950,41.25
7906,Vila Guarani,40,1,1,1,1500,460,1960,49.0
7907,Higienópolis,33,1,1,1,1990,520,2510,76.06061
7908,Other,70,3,2,1,2000,480,2480,35.42857
7909,Consolação,37,1,1,1,2200,541,2741,74.08108
7910,Other,49,2,1,1,1400,0,1400,28.571428
7911,Other,34,1,1,1,2500,523,3023,88.911766
7912,Ipiranga,133,3,4,2,5500,1150,6650,50.0
7913,Vila Mariana,87,3,3,2,3800,1000,4800,55.172413
7914,Other,100,3,3,1,1899,860,2759,27.59
7915,Other,65,2,2,1,3240,560,3800,58.46154
7916,Vila Mariana,37,1,1,1,1500,514,2014,54.432434
7917,Other,77,3,2,1,2228,603,2831,36.766235
7918,Other,55,2,1,1,1700,458,2158,39.236362
7919,Higienópolis,107,3,2,2,4000,1633,5633,52.64486
7920,Mirandópolis,65,2,1,1,1500,514,2014,30.984615
7921,Pompeia,41,1,1,1,2300,590,2890,70.48781
7922,Vila Leopoldina,57,2,1,1,1900,1080,2980,52.2807
7923,Other,68,2,1,1,1900,0,1900,27.941177
7924,Brooklin,45,1,1,1,3200,580,3780,84.0
7925,Other,35,1,1,1,3000,386,3386,96.74286
7926,Itaim Bibi,115,3,3,1,6000,1500,7500,65.21739
7927,Campo Belo,60,2,2,1,3900,743,4643,77.38333
7928,Bela Vista,43,1,1,0,1150,500,1650,38.372093
7929,Other,93,3,3,2,3100,870,3970,42.68817
7930,Pinheiros,103,2,2,2,6300,1200,7500,72.81554
7931,Brooklin,45,1,1,1,2000,850,2850,63.333332
7932,Móoca,90,3,3,2,2500,950,3450,38.333332
7933,Chácara Santo Antônio,37,1,1,1,2000,540,2540,68.64865
7934,Vila Leopoldina,83,3,2,2,3300,950,4250,51.20482
7935,Other,40,2,1,0,1300,150,1450,36.25
7936,Aclimação,58,2,1,1,1600,490,2090,36.03448
7937,Morumbi,107,2,3,2,2500,1680,4180,39.065422
7938,Santana,40,1,1,0,1100,100,1200,30.0
7939,Jardim Paulista,35,1,1,1,1600,509,2109,60.25714
7940,Vila Mariana,165,3,5,4,8000,1450,9450,57.272728
7941,Vila Clementino,100,3,4,2,5600,1350,6950,69.5
7942,Campo Belo,66,2,1,1,3300,718,4018,60.878788
7943,Saúde,95,3,2,2,4300,681,4981,52.43158
7944,Cambuci,72,2,1,1,2000,668,2668,37.055557
7945,Other,30,1,1,0,1300,0,1300,43.333332
7946,Centro,65,2,2,1,3500,900,4400,67.69231
7947,Other,56,2,1,1,1500,515,2015,35.982143
7948,Jardim Marajoara,60,3,1,1,1800,436,2236,37.266666
7949,Pinheiros,102,3,2,2,4476,1491,5967,58.5
7950,Brooklin,70,3,3,1,2200,836,3036,43.37143
7951,Jardim Paulista,65,2,2,2,4000,850,4850,74.61539
7952,Saúde,40,1,1,1,1200,1300,2500,62.5
7953,Other,117,3,3,2,2300,1276,3576,30.564102
7954,Jardim Paulista,66,1,1,1,8000,0,8000,121.21212
7955,Santana,65,3,2,2,2200,622,2822,43.415386
7956,Santa Cecília,60,2,1,0,2800,680,3480,58.0
7957,Brooklin,75,2,2,1,2500,849,3349,44.65333
7958,Vila Mariana,80,2,3,1,2500,840,3340,41.75
7959,Vila Mariana,51,2,1,1,1700,623,2323,45.54902
7960,Brooklin,52,2,1,1,3402,949,4351,83.67308
7961,Vila Leopoldina,70,2,2,1,2000,598,2598,37.114285
7962,Pinheiros,44,1,1,1,3500,0,3500,79.545456
7963,Other,90,3,2,1,1400,440,1840,20.444445
7964,Morumbi,70,2,2,2,3500,850,4350,62.142857
7965,Brooklin,52,2,2,1,2500,843,3343,64.28846
7966,Tatuapé,35,1,1,1,2200,360,2560,73.14286
7967,Other,55,2,1,1,1200,815,2015,36.636364
7968,Other,60,2,2,0,1300,0,1300,21.666666
7969,Cambuci,39,1,1,1,2260,530,2790,71.53846
7970,Moema,94,3,3,2,4200,1137,5337,56.776596
7971,Other,65,3,1,2,1850,10,1860,28.615385
7972,Itaim Bibi,98,2,3,1,4900,1174,6074,61.97959
7973,Brooklin,60,2,2,2,5500,0,5500,91.666664
7974,Paraíso,66,2,2,1,3500,880,4380,66.36364
7975,Other,61,3,1,1,1300,650,1950,31.967213
7976,Ipiranga,120,3,1,3,4600,0,4600,38.333332
7977,Jardins,125,3,2,1,7500,1550,9050,72.4
7978,Bela Vista,33,1,1,0,1300,487,1787,54.151516
7979,Other,50,2,1,1,1200,600,1800,36.0
7980,Pinheiros,63,2,2,1,2400,1060,3460,54.920635
7981,Bela Vista,50,1,1,1,2400,490,2890,57.8
7982,Other,68,2,1,1,2300,654,2954,43.441177
7983,Other,78,3,1,1,1550,440,1990,25.512821
7984,Tatuapé,60,2,2,1,2850,493,3343,55.716667
7985,Jabaquara,40,1,1,1,1200,405,1605,40.125
7986,Other,55,1,1,1,3500,600,4100,74.545456
7987,Other,50,2,2,1,1250,250,1500,30.0
7988,Jardim Paulista,42,1,1,1,4000,0,4000,95.2381
7989,Vila Mariana,140,2,2,2,3300,1038,4338,30.985714
7990,Brás,40,1,1,1,1700,400,2100,52.5
7991,Consolação,120,4,3,2,6000,1250,7250,60.416668
7992,Vila Mariana,36,1,1,1,2799,620,3419,94.97222
7993,Cambuci,30,1,1,0,1200,300,1500,50.0
7994,Jardim Paulista,65,2,2,1,2800,756,3556,54.70769
7995,Vila Mascote,90,2,2,2,2000,836,2836,31.51111
7996,Moema,45,1,1,1,1800,700,2500,55.555557
7997,Butantã,56,2,1,0,1490,405,1895,33.839287
7998,Vila Mascote,37,1,1,0,1850,150,2000,54.054054
7999,Other,51,1,1,1,3500,584,4084,80.07843
8000,Butantã,60,2,1,1,2150,523,2673,44.55
8001,Other,98,3,4,2,3900,750,4650,47.44898
8002,Aclimação,42,1,1,1,1900,580,2480,59.04762
8003,Campo Belo,60,2,1,1,2500,990,3490,58.166668
8004,Other,70,2,2,2,4500,853,5353,76.47143
8005,Higienópolis,200,3,3,2,4300,1627,5927,29.635
8006,Itaim Bibi,86,2,1,1,3500,790,4290,49.88372
8007,Other,65,2,2,1,3000,691,3691,56.784615
8008,Consolação,35,1,1,1,3500,360,3860,110.28571
8009,Paraíso,60,2,2,1,4200,1350,5550,92.5
8010,Vila Olímpia,65,1,2,2,6000,970,6970,107.23077
8011,Other,128,4,4,2,5500,1050,6550,51.171875
8012,Perdizes,68,2,3,2,3000,1180,4180,61.47059
8013,Higienópolis,60,2,2,1,5000,725,5725,95.416664
8014,Indianópolis,97,2,2,1,1900,1147,3047,31.41237
8015,Jabaquara,35,1,1,1,1300,390,1690,48.285713
8016,Santa Cecília,82,3,3,1,3000,990,3990,48.658535
8017,Vila Leopoldina,96,2,3,2,4700,1500,6200,64.583336
8018,Tatuapé,69,2,2,1,2200,450,2650,38.405796
8019,Perdizes,140,2,4,3,8100,1700,9800,70.0
8020,Tatuapé,40,1,1,1,1600,679,2279,56.975
8021,Other,44,1,1,1,1600,536,2136,48.545456
8022,Cambuci,55,2,1,1,1200,300,1500,27.272728
8023,Perdizes,36,1,1,1,2150,463,2613,72.583336
8024,Vila Mariana,75,2,2,1,1950,500,2450,32.666668
8025,Other,50,2,1,1,1200,0,1200,24.0
8026,Vila Prudente,75,3,2,1,1600,710,2310,30.8
8027,Vila Nova Conceição,60,2,1,1,2800,1401,4201,70.01667
8028,Indianópolis,31,1,1,0,3000,580,3580,115.48387
8029,Perdizes,64,2,2,1,2700,790,3490,54.53125
8030,Other,38,1,1,0,900,0,900,23.68421
8031,Other,50,2,1,0,1200,90,1290,25.8
8032,Other,90,2,2,0,1600,300,1900,21.11111
8033,Pinheiros,59,1,1,1,4100,800,4900,83.05085
8034,Santa Cecília,33,1,1,1,2000,530,2530,76.666664
8035,Santa Cecília,160,3,3,4,7500,1700,9200,57.5
8036,Brooklin,49,1,2,1,3000,580,3580,73.061226
8037,Itaim Bibi,50,1,1,1,2700,755,3455,69.1
8038,Consolação,52,1,1,0,2000,562,2562,49.26923
8039,Other,55,2,1,0,1600,430,2030,36.909092
8040,Vila Buarque,30,1,1,0,1100,470,1570,52.333332
8041,Ipiranga,55,2,1,0,1500,487,1987,36.127274
8042,Jardim Paulista,100,2,2,1,2850,1177,4027,40.27
8043,Vila Nova Conceição,57,1,1,0,1900,500,2400,42.105263
8044,Móoca,100,3,4,2,4500,510,5010,50.1
8045,Liberdade,50,2,1,0,1300,581,1881,37.62
8046,Vila Leopoldina,48,1,1,1,1950,454,2404,50.083332
8047,Other,18,1,1,1,1000,150,1150,63.88889
8048,Vila Nova Conceição,105,2,2,1,6600,1480,8080,76.95238
8049,Vila Olímpia,100,3,2,2,3150,973,4123,41.23
8050,Pinheiros,100,2,2,1,2300,778,3078,30.78
8051,Chácara Santo Antônio,38,1,1,1,2300,482,2782,73.210526
8052,Butantã,50,2,1,1,2500,307,2807,56.14
8053,Moema,77,3,2,1,3800,975,4775,62.012985
8054,Bela Vista,32,1,1,1,1000,440,1440,45.0
8055,Other,62,2,2,1,2400,500,2900,46.774193
8056,Other,44,2,1,1,1650,300,1950,44.31818
8057,Tatuapé,64,3,1,1,1500,670,2170,33.90625
8058,Vila Mariana,85,2,2,1,3150,790,3940,46.35294
8059,Other,60,2,2,1,2700,0,2700,45.0
8060,Vila Mariana,50,1,1,1,1100,954,2054,41.08
8061,Bela Vista,35,1,1,1,2400,1,2401,68.6
8062,Aclimação,39,1,1,1,2260,530,2790,71.53846
8063,Vila Olímpia,60,2,1,1,2400,871,3271,54.516666
8064,Aclimação,45,1,1,1,1700,610,2310,51.333332
8065,Cerqueira César,41,1,1,0,1390,384,1774,43.26829
8066,Other,45,2,1,0,1500,0,1500,33.333332
8067,Other,45,1,1,0,1400,216,1616,35.91111
8068,Vila Mariana,45,1,1,1,3120,830,3950,87.77778
8069,Saúde,60,2,2,1,2500,720,3220,53.666668
8070,Ipiranga,68,2,1,1,2600,622,3222,47.382355
8071,República,24,1,1,0,1150,270,1420,59.166668
8072,Other,62,3,1,1,1350,450,1800,29.032259
8073,Other,45,1,1,0,1100,250,1350,30.0
8074,Brás,82,2,1,0,1500,340,1840,22.439024
8075,Other,55,2,2,2,2500,799,3299,59.98182
8076,Brooklin,55,1,1,2,3100,970,4070,74.0
8077,Vila Buarque,50,1,1,0,1300,575,1875,37.5
8078,Cidade Monções,75,2,2,2,6800,1200,8000,106.666664
8079,Other,56,2,2,1,1950,590,2540,45.357143
8080,Jabaquara,33,1,1,0,1180,0,1180,35.757576
8081,Other,54,2,1,1,1200,460,1660,30.74074
8082,Other,105,3,3,1,2300,960,3260,31.047619
8083,Santa Cecília,28,1,1,1,1200,491,1691,60.392857
8084,Barra Funda,45,1,1,1,2300,550,2850,63.333332
8085,Jaguaré,17,1,1,0,790,0,790,46.47059
8086,Other,55,2,1,1,1000,623,1623,29.50909
8087,Móoca,50,2,1,0,1300,500,1800,36.0
8088,Campo Belo,35,1,1,1,1800,570,2370,67.71429
8089,Bela Vista,35,1,1,1,1050,715,1765,50.42857
8090,Other,70,2,2,1,2300,600,2900,41.42857
8091,Móoca,60,2,2,1,2000,120,2120,35.333332
8092,Brooklin,20,1,1,0,2450,0,2450,122.5
8093,Brooklin,60,2,1,1,2500,962,3462,57.7
8094,Campo Belo,37,1,1,1,2050,560,2610,70.54054
8095,Vila Madalena,57,1,1,1,4450,1084,5534,97.08772
8096,Other,50,2,2,1,850,600,1450,29.0
8097,Brooklin,57,1,2,1,3500,1128,4628,81.192986
8098,Vila Mascote,48,1,1,1,920,516,1436,29.916666
8099,Bela Vista,54,2,1,1,3400,936,4336,80.296295
8100,Liberdade,45,1,1,0,1000,300,1300,28.88889
8101,Vila Mascote,53,1,2,1,2800,400,3200,60.377357
8102,Higienópolis,44,1,1,1,2200,1000,3200,72.72727
8103,Vila Andrade,48,2,1,1,1700,390,2090,43.541668
8104,Bela Vista,78,2,2,2,5000,550,5550,71.15385
8105,Campo Belo,51,1,1,1,3200,590,3790,74.31373
8106,Other,55,1,1,0,1800,279,2079,37.8
8107,Tatuapé,123,3,2,2,2541,771,3312,26.926828
8108,Jardim Marajoara,75,3,2,2,1500,706,2206,29.413334
8109,Other,85,3,2,2,1850,780,2630,30.941177
8110,Barra Funda,45,1,1,0,1200,369,1569,34.866665
8111,Liberdade,50,1,1,1,1700,420,2120,42.4
8112,Higienópolis,70,2,1,0,2220,675,2895,41.357143
8113,Vila Mariana,38,1,1,1,3000,440,3440,90.52631
8114,Moema,31,1,1,1,3400,31,3431,110.67742
8115,Vila Olímpia,74,2,2,2,5450,853,6303,85.175674
8116,Other,70,3,2,1,2000,350,2350,33.57143
8117,Butantã,30,1,1,0,1200,350,1550,51.666668
8118,Paraíso,80,2,3,2,3200,901,4101,51.2625
8119,Other,78,2,1,0,1600,100,1700,21.794872
8120,Other,30,1,1,0,1000,222,1222,40.733334
8121,Jardins,110,3,3,1,4300,1445,5745,52.227272
8122,Butantã,17,1,1,0,1350,0,1350,79.411766
8123,Pinheiros,40,1,1,1,3000,770,3770,94.25
8124,Santana,62,2,1,1,1750,735,2485,40.080647
8125,Morumbi,58,2,2,1,1500,600,2100,36.206898
8126,Brooklin,95,2,2,0,2950,869,3819,40.2
8127,Other,78,2,2,1,2000,350,2350,30.128204
8128,Perdizes,110,3,3,2,3500,1050,4550,41.363636
8129,Vila Guarani,42,1,1,1,1250,658,1908,45.42857
8130,Other,70,3,2,1,2300,670,2970,42.42857
8131,Other,71,3,1,1,1400,370,1770,24.929577
8132,Vila Mariana,30,1,1,0,1400,130,1530,51.0
8133,Ipiranga,31,1,1,1,1500,474,1974,63.677418
8134,Jabaquara,56,2,2,2,1600,543,2143,38.267857
8135,Santa Cecília,70,2,1,0,1800,160,1960,28.0
8136,Consolação,39,1,1,1,2200,392,2592,66.46154
8137,Other,100,2,1,0,1550,0,1550,15.5
8138,Other,104,3,3,2,3800,810,4610,44.326923
8139,Vila Mariana,78,2,2,2,3100,970,4070,52.179485
8140,Bela Vista,57,1,1,0,1200,430,1630,28.59649
8141,Jardim Paulista,55,2,1,1,2800,950,3750,68.181816
8142,Other,140,3,1,1,6000,1400,7400,52.857143
8143,Tatuapé,45,1,1,1,2350,458,2808,62.4
8144,Santana,90,3,2,1,1650,916,2566,28.51111
8145,Jardim América,30,1,1,1,1750,720,2470,82.333336
8146,Perdizes,110,3,2,1,2500,1256,3756,34.145454
8147,Bela Vista,63,2,1,1,5600,0,5600,88.888885
8148,Vila Mariana,76,2,2,1,1880,1290,3170,41.710526
8149,Itaim Bibi,46,1,1,1,3943,815,4758,103.434784
8150,Santana,68,2,1,1,1700,750,2450,36.02941
8151,Other,75,3,1,1,1500,770,2270,30.266666
8152,Saúde,40,1,1,1,2500,782,3282,82.05
8153,Ipiranga,67,2,2,1,3800,539,4339,64.76119
8154,Other,40,2,1,0,1400,100,1500,37.5
8155,Vila Nova Conceição,85,2,2,0,3000,660,3660,43.058823
8156,Santo Amaro,85,3,2,1,4000,0,4000,47.058823
8157,Other,60,2,1,1,1600,250,1850,30.833334
8158,Other,35,1,2,1,1350,750,2100,60.0
8159,Vila Mariana,45,1,1,0,1500,160,1660,36.88889
8160,Liberdade,60,2,1,1,3000,750,3750,62.5
8161,Other,64,2,1,1,1300,670,1970,30.78125
8162,Consolação,120,2,3,1,5400,1419,6819,56.825
8163,Other,38,1,1,1,2500,507,3007,79.13158
8164,Vila Prudente,104,2,3,2,3600,812,4412,42.423077
8165,Pompeia,60,2,2,1,2200,930,3130,52.166668
8166,Morumbi,65,3,1,1,1550,490,2040,31.384615
8167,Centro,35,1,1,0,700,350,1050,30.0
8168,Other,63,2,2,2,2500,629,3129,49.666668
8169,Jardim América,85,2,2,0,3000,926,3926,46.188236
8170,Bela Vista,35,1,1,1,1300,1151,2451,70.02857
8171,Cidade Monções,70,1,1,1,5500,994,6494,92.77143
8172,Other,50,2,1,1,1300,350,1650,33.0
8173,Brooklin,75,2,2,1,2900,1250,4150,55.333332
8174,República,30,1,1,1,2400,950,3350,111.666664
8175,Other,109,3,2,2,4000,874,4874,44.715595
8176,Vila Olímpia,60,2,1,1,2600,950,3550,59.166668
8177,Campo Belo,47,1,1,1,2600,574,3174,67.53191
8178,Aclimação,34,1,1,1,1950,615,2565,75.44118
8179,Moema,70,2,3,1,3500,785,4285,61.214287
8180,Bela Vista,50,2,1,1,3490,790,4280,85.6
8181,Higienópolis,90,2,2,1,2600,960,3560,39.555557
8182,Santa Cecília,50,2,1,1,1800,500,2300,46.0
8183,Campo Belo,50,1,1,1,3700,428,4128,82.56
8184,Vila Mariana,90,2,1,1,2000,1148,3148,34.97778
8185,Other,75,3,2,1,1300,700,2000,26.666666
8186,Pinheiros,110,3,2,1,7500,1550,9050,82.27273
8187,Aclimação,176,4,5,3,8500,1260,9760,55.454544
8188,Bela Vista,25,1,1,0,1850,290,2140,85.6
8189,Vila Clementino,68,2,2,1,2500,882,3382,49.735294
8190,Liberdade,44,1,1,1,1850,660,2510,57.045456
8191,Other,71,3,2,1,2100,550,2650,37.323944
8192,Campo Belo,70,1,1,1,4500,1150,5650,80.71429
8193,Vila Buarque,86,1,1,0,2100,440,2540,29.534883
8194,Bela Vista,48,1,1,1,3200,0,3200,66.666664
8195,Itaim Bibi,50,1,2,1,2800,856,3656,73.12
8196,Pinheiros,50,2,1,1,3170,800,3970,79.4
8197,Other,96,3,3,2,3500,1018,4518,47.0625
8198,Indianópolis,86,2,2,1,3000,772,3772,43.860466
8199,Other,100,3,3,2,2900,1134,4034,40.34
8200,Vila Madalena,78,2,2,2,2040,538,2578,33.05128
8201,Mirandópolis,50,2,1,0,1500,750,2250,45.0
8202,Pompeia,75,3,2,2,3000,950,3950,52.666668
8203,Other,50,2,1,0,1200,483,1683,33.66
8204,Vila Leopoldina,153,3,4,3,9000,1200,10200,66.666664
8205,Other,69,2,1,1,2200,450,2650,38.405796
8206,Perdizes,55,2,2,1,3000,470,3470,63.090908
8207,Brooklin,80,3,3,1,2700,843,3543,44.2875
8208,Vila Buarque,35,1,1,1,1300,800,2100,60.0
8209,Pinheiros,90,3,3,2,6300,1100,7400,82.22222
8210,Vila Clementino,45,1,1,0,1800,0,1800,40.0
8211,Consolação,33,1,1,1,1600,575,2175,65.90909
8212,Other,100,2,1,1,1900,0,1900,19.0
8213,Other,49,2,1,1,2200,485,2685,54.795918
8214,Santa Cecília,85,2,2,0,2600,840,3440,40.47059
8215,Vila Olímpia,67,2,2,1,2600,969,3569,53.268658
8216,Other,47,2,1,1,1000,200,1200,25.531916
8217,Other,60,2,2,1,1800,773,2573,42.883335
8218,República,35,1,1,0,1300,555,1855,53.0
8219,Vila Mariana,70,2,2,1,2500,770,3270,46.714287
8220,Santa Cecília,30,1,1,1,2000,616,2616,87.2
8221,Vila Olímpia,45,1,1,1,3800,654,4454,98.977776
8222,Pinheiros,91,2,2,1,3000,1100,4100,45.054947
8223,Vila Madalena,25,1,1,0,2100,700,2800,112.0
8224,Morumbi,64,2,2,1,2250,460,2710,42.34375
8225,Vila Guarani,94,3,3,1,3600,600,4200,44.68085
8226,Santana,92,3,3,2,2750,1250,4000,43.47826
8227,Other,97,3,3,2,2800,790,3590,37.01031
8228,Itaim Bibi,85,2,2,2,4500,1285,5785,68.05882
8229,Vila Leopoldina,74,2,3,1,2500,0,2500,33.783783
8230,Cidade Monções,38,1,1,1,3300,550,3850,101.31579
8231,Moema,48,1,2,1,3180,949,4129,86.020836
8232,Other,58,2,1,1,1300,0,1300,22.413794
8233,Itaim Bibi,45,1,1,1,1800,762,2562,56.933334
8234,Other,34,1,1,1,1300,451,1751,51.5
8235,Saúde,50,1,1,1,2700,0,2700,54.0
8236,Saúde,85,3,2,1,2000,780,2780,32.705883
8237,Other,52,2,1,1,2500,680,3180,61.153847
8238,Other,120,3,4,2,5500,890,6390,53.25
8239,Vila Olímpia,89,3,2,2,6170,914,7084,79.595505
8240,Vila Mariana,67,2,2,1,3000,550,3550,52.985073
8241,Other,84,2,2,2,3600,600,4200,50.0
8242,Bela Vista,42,1,1,1,2700,431,3131,74.54762
8243,Itaim Bibi,105,3,3,1,5500,1346,6846,65.2
8244,Campo Belo,110,3,4,2,4000,1127,5127,46.609093
8245,Other,74,3,2,2,3500,0,3500,47.2973
8246,Other,50,2,1,1,1300,430,1730,34.6
8247,Campo Belo,50,1,2,1,3500,650,4150,83.0
8248,Other,55,2,1,1,1000,300,1300,23.636364
8249,Brooklin,50,1,2,1,3150,651,3801,76.02
8250,Bela Vista,52,1,1,0,2500,390,2890,55.576923
8251,Bela Vista,32,1,1,0,1500,375,1875,58.59375
8252,Bela Vista,53,2,2,1,2300,863,3163,59.679245
8253,Saúde,34,1,1,1,1500,600,2100,61.764706
8254,Jardim Marajoara,64,3,2,1,1570,780,2350,36.71875
8255,Other,48,2,1,1,1000,190,1190,24.791666
8256,Pinheiros,76,2,2,1,2780,882,3662,48.18421
8257,Other,38,1,1,1,1000,943,1943,51.13158
8258,Vila Prudente,56,2,1,1,2770,0,2770,49.464287
8259,Other,156,3,4,4,3300,1427,4727,30.301283
8260,Vila Mascote,103,3,3,2,3000,1200,4200,40.7767
8261,Brooklin,85,2,3,2,8500,1110,9610,113.05882
8262,Other,100,3,3,3,3900,1000,4900,49.0
8263,Brás,50,2,1,1,1600,370,1970,39.4
8264,Other,40,1,1,1,950,320,1270,31.75
8265,Santa Cecília,65,1,1,0,1200,572,1772,27.261538
8266,Paraíso,65,2,1,1,3350,880,4230,65.07692
8267,Campo Belo,75,2,2,1,1180,1384,2564,34.18667
8268,Vila Buarque,45,2,1,1,1400,500,1900,42.22222
8269,Chácara Santo Antônio,143,3,5,2,6200,1050,7250,50.6993
8270,Other,49,2,1,1,900,390,1290,26.32653
8271,Brooklin,67,1,2,2,4000,793,4793,71.537315
8272,Santana,49,1,1,1,2350,507,2857,58.30612
8273,Other,50,2,1,1,1450,525,1975,39.5
8274,Other,74,2,2,1,2440,1401,3841,51.905407
8275,Other,65,3,1,1,1150,570,1720,26.461538
8276,Other,24,1,1,1,1200,212,1412,58.833332
8277,Jaguaré,70,3,2,2,2400,705,3105,44.357143
8278,Other,147,3,4,2,5000,1200,6200,42.176872
8279,Perdizes,80,2,2,1,2700,998,3698,46.225
8280,Itaim Bibi,40,1,1,1,4200,583,4783,119.575
8281,Other,75,2,2,1,2800,917,3717,49.56
8282,Saúde,70,2,2,1,1860,970,2830,40.42857
8283,Vila Mariana,80,2,1,1,2500,750,3250,40.625
8284,Aclimação,60,2,1,0,1400,369,1769,29.483334
8285,Other,90,3,2,1,1600,710,2310,25.666666
8286,Móoca,55,2,2,1,2700,270,2970,54.0
8287,Other,69,3,2,1,2204,760,2964,42.95652
8288,Barra Funda,128,4,3,2,5500,1200,6700,52.34375
8289,Other,92,1,1,1,3200,1,3201,34.79348
8290,Brooklin,43,1,1,1,2100,850,2950,68.60465
8291,Moema,36,1,1,1,1500,1150,2650,73.611115
8292,Aclimação,105,2,3,2,7200,0,7200,68.57143
8293,Brooklin,98,2,3,2,8750,1700,10450,106.63265
8294,Other,44,1,1,1,2700,664,3364,76.454544
8295,Other,42,2,1,0,1100,270,1370,32.61905
8296,Brooklin,157,3,3,2,4000,1510,5510,35.095543
8297,Cerqueira César,100,2,2,1,4300,1124,5424,54.24
8298,Other,59,2,2,1,1500,730,2230,37.79661
8299,Paraíso,77,2,2,1,7000,1000,8000,103.8961
8300,Brooklin,127,3,3,3,7000,1700,8700,68.50394
8301,Other,86,2,3,2,4300,820,5120,59.534885
8302,Jardim Marajoara,50,2,1,1,1600,650,2250,45.0
8303,Brás,48,2,1,1,1700,360,2060,42.916668
8304,Other,75,2,1,2,3800,750,4550,60.666668
8305,Pinheiros,120,3,3,2,3900,1496,5396,44.966667
8306,Other,68,3,1,1,1700,650,2350,34.558823
8307,Other,70,3,2,1,2700,929,3629,51.842857
8308,Vila Mariana,84,2,1,1,3600,522,4122,49.07143
8309,Campo Belo,42,1,1,1,2700,545,3245,77.2619
8310,Other,157,4,4,4,7000,1400,8400,53.503185
8311,Other,94,2,2,2,4900,750,5650,60.106384
8312,Other,58,2,2,1,2500,550,3050,52.58621
8313,Higienópolis,41,1,1,1,1900,660,2560,62.439026
8314,Jabaquara,38,1,1,1,1800,349,2149,56.55263
8315,Other,45,2,1,1,1000,427,1427,31.711111
8316,Cerqueira César,72,2,2,1,2600,832,3432,47.666668
8317,Itaim Bibi,49,1,1,1,3000,1000,4000,81.63265
8318,Santa Cecília,110,2,1,0,2000,570,2570,23.363636
8319,Pinheiros,63,2,2,1,3300,1050,4350,69.04762
8320,Saúde,55,2,2,1,1665,954,2619,47.618183
8321,Other,56,2,2,1,2100,936,3036,54.214287
8322,Other,60,1,1,1,3100,535,3635,60.583332
8323,Vila Leopoldina,158,3,5,2,7500,1200,8700,55.06329
8324,Other,74,3,2,1,1700,500,2200,29.72973
8325,Higienópolis,66,2,2,1,3000,970,3970,60.151516
8326,Santana,52,2,1,1,1400,529,1929,37.096153
8327,Paraíso,71,2,2,1,3100,797,3897,54.887325
8328,Vila Madalena,70,1,1,1,5700,985,6685,95.5
8329,Consolação,57,2,2,1,5800,600,6400,112.2807
8330,Liberdade,25,1,1,0,1700,447,2147,85.88
8331,Vila Mariana,60,2,2,1,2800,685,3485,58.083332
8332,Other,50,2,1,1,1000,290,1290,25.8
8333,Other,61,2,2,1,2500,210,2710,44.42623
8334,Other,50,2,1,1,1000,584,1584,31.68
8335,Vila Madalena,79,2,3,2,5000,1370,6370,80.63291
8336,Other,64,2,2,1,1100,790,1890,29.53125
8337,Other,50,2,1,1,1600,400,2000,40.0
8338,Morumbi,78,3,2,1,1800,788,2588,33.179485
8339,Lapa,70,2,1,0,1600,290,1890,27.0
8340,Vila Clementino,57,2,1,1,3200,621,3821,67.03509
8341,Santana,58,2,2,0,1200,680,1880,32.41379
8342,Móoca,70,3,1,1,1900,735,2635,37.642857
8343,Other,67,2,2,1,3200,790,3990,59.55224
8344,Vila Andrade,96,2,2,2,3300,800,4100,42.708332
8345,Bela Vista,28,1,1,0,1100,374,1474,52.642857
8346,Vila Leopoldina,82,3,2,2,3300,950,4250,51.82927
8347,Perdizes,100,3,2,1,2500,790,3290,32.9
8348,Bela Vista,42,1,1,1,2700,431,3131,74.54762
8349,Vila Mariana,40,1,1,0,1600,858,2458,61.45
8350,Other,60,2,2,1,1300,539,1839,30.65
8351,Brás,55,2,1,1,1300,600,1900,34.545456
8352,Santo Amaro,130,3,2,2,7000,1150,8150,62.692307
8353,Morumbi,190,3,3,2,4875,681,5556,29.242105
8354,Ipiranga,39,1,1,1,1800,420,2220,56.923077
8355,Higienópolis,122,2,3,1,3500,1100,4600,37.704918
8356,Jardim América,120,2,2,0,4500,1466,5966,49.716667
8357,Vila Leopoldina,172,3,4,3,6200,1520,7720,44.88372
8358,Other,53,2,1,2,1915,535,2450,46.226414
8359,Ipiranga,80,2,2,1,1800,700,2500,31.25
8360,Aclimação,78,2,2,2,2500,230,2730,35.0
8361,Brooklin,124,3,5,2,7500,1056,8556,69.0
8362,Consolação,48,1,1,1,1800,439,2239,46.645832
8363,Pinheiros,43,1,1,1,3000,818,3818,88.790695
8364,Ipiranga,59,2,1,1,2070,760,2830,47.966103
8365,Pinheiros,75,2,2,0,2200,900,3100,41.333332
8366,Brooklin,55,2,1,1,2500,962,3462,62.945454
8367,Vila Olímpia,62,1,2,1,4850,1500,6350,102.41936
8368,Other,57,2,2,1,1400,800,2200,38.596493
8369,Other,45,2,1,1,1400,0,1400,31.11111
8370,Butantã,57,2,2,2,1600,1100,2700,47.36842
8371,Santana,44,1,1,1,2100,523,2623,59.613636
8372,Other,64,2,1,1,1400,700,2100,32.8125
8373,Barra Funda,33,1,1,0,1800,290,2090,63.333332
8374,Vila Olímpia,65,2,2,2,2700,983,3683,56.661537
8375,Other,55,2,1,1,1600,650,2250,40.909092
8376,Vila Mascote,37,2,1,0,2100,150,2250,60.81081
8377,Vila Nova Conceição,50,2,1,1,1350,810,2160,43.2
8378,Moema,45,1,2,1,1600,830,2430,54.0
8379,Cidade Monções,70,2,1,1,4450,712,5162,73.74286
8380,Jardim Paulista,72,1,2,1,4500,800,5300,73.611115
8381,Jardim Marajoara,82,3,2,1,2200,800,3000,36.585365
8382,Vila Guarani,58,2,1,1,1400,850,2250,38.793102
8383,Pinheiros,69,2,2,1,3400,830,4230,61.304348
8384,Jabaquara,47,2,1,1,1500,600,2100,44.68085
8385,Vila Clementino,85,3,3,2,3200,1150,4350,51.17647
8386,Liberdade,70,1,1,0,1200,450,1650,23.571428
8387,Itaim Bibi,77,1,2,1,4000,870,4870,63.246754
8388,Pompeia,61,2,2,1,2500,930,3430,56.229507
8389,Other,50,2,1,1,742,258,1000,20.0
8390,Itaim Bibi,60,2,2,1,2200,550,2750,45.833332
8391,Other,62,2,1,1,1150,420,1570,25.32258
8392,Brooklin,85,3,3,2,3600,823,4423,52.035294
8393,Other,44,2,1,0,1300,0,1300,29.545454
8394,Santana,164,4,4,2,3500,1530,5030,30.670732
8395,Other,89,2,1,1,2500,889,3389,38.07865
8396,Pinheiros,65,2,2,1,4400,820,5220,80.30769
8397,Jardim América,105,2,3,1,5300,1038,6338,60.361904
8398,Moema,45,1,1,0,2600,0,2600,57.77778
8399,Vila Buarque,25,1,1,0,2000,365,2365,94.6
8400,Tatuapé,137,3,3,3,3000,1395,4395,32.08029
8401,Paraíso,147,3,3,2,3800,1530,5330,36.258503
8402,Moema,123,3,4,2,8000,1253,9253,75.227646
8403,Other,50,2,1,1,1500,500,2000,40.0
8404,Vila Mariana,70,2,1,0,2200,310,2510,35.857143
8405,Vila Nova Conceição,57,2,2,1,2800,1259,4059,71.210526
8406,Paraíso,60,1,1,0,1850,350,2200,36.666668
8407,Vila Mariana,119,3,2,2,6200,1400,7600,63.865547
8408,Other,120,4,2,0,6000,1250,7250,60.416668
8409,Indianópolis,170,4,4,2,6000,1576,7576,44.564705
8410,Itaim Bibi,50,1,1,0,4300,100,4400,88.0
8411,Other,43,2,1,0,1300,250,1550,36.046513
8412,Butantã,65,2,2,2,1700,730,2430,37.384617
8413,Other,58,2,2,1,1500,600,2100,36.206898
8414,Cambuci,60,2,2,1,2700,790,3490,58.166668
8415,Brooklin,120,3,3,2,6500,1650,8150,67.916664
8416,Itaim Bibi,80,2,1,2,2900,1083,3983,49.7875
8417,Santa Cecília,30,1,1,1,2200,435,2635,87.833336
8418,Jardim Paulista,50,2,1,1,2600,837,3437,68.74
8419,Pompeia,60,2,2,2,2600,900,3500,58.333332
8420,Santa Cecília,30,1,1,0,1200,385,1585,52.833332
8421,Higienópolis,64,2,1,1,2000,669,2669,41.703125
8422,Consolação,40,1,1,1,2250,590,2840,71.0
8423,Other,40,1,1,0,750,0,750,18.75
8424,Other,168,3,5,3,8000,1300,9300,55.357143
8425,Santa Cecília,34,1,1,1,2500,450,2950,86.76471
8426,Cerqueira César,40,1,1,1,1700,590,2290,57.25
8427,Pinheiros,50,1,1,0,2700,651,3351,67.02
8428,Other,78,3,2,2,1800,800,2600,33.333332
8429,Itaim Bibi,48,1,2,1,2000,687,2687,55.979168
8430,Vila Olímpia,56,2,2,2,2750,1130,3880,69.28571
8431,Other,49,2,1,1,2530,336,2866,58.489796
8432,Vila Olímpia,55,1,1,1,4000,850,4850,88.181816
8433,Bela Vista,60,1,1,0,1350,525,1875,31.25
8434,Higienópolis,45,1,1,1,3000,1165,4165,92.55556
8435,Vila Guarani,49,1,1,1,1500,350,1850,37.7551
8436,Other,52,2,1,1,1550,470,2020,38.846153
8437,Moema,130,3,2,2,3200,0,3200,24.615385
8438,Vila Clementino,70,2,1,1,2000,918,2918,41.685715
8439,Vila Olímpia,70,2,1,1,8000,975,8975,128.21428
8440,Other,84,3,2,2,3800,560,4360,51.904762
8441,Vila Buarque,60,2,1,0,2500,450,2950,49.166668
8442,Liberdade,55,2,1,1,1700,600,2300,41.81818
8443,Other,131,3,1,3,5500,1400,6900,52.671757
8444,Pinheiros,55,2,1,0,2100,467,2567,46.672726
8445,Other,62,2,2,1,2800,550,3350,54.032257
8446,Chácara Santo Antônio,54,2,1,1,2800,550,3350,62.037037
8447,Brooklin,45,1,1,1,2200,870,3070,68.22222
8448,Pompeia,81,3,3,2,2800,898,3698,45.65432
8449,Vila Clementino,60,2,2,1,3500,580,4080,68.0
8450,Other,49,2,1,1,2300,540,2840,57.959183
8451,Vila Mariana,64,2,2,1,2400,550,2950,46.09375
8452,Ipiranga,15,1,1,0,1050,0,1050,70.0
8453,Bela Vista,41,1,1,1,3400,662,4062,99.07317
8454,Bela Vista,165,3,2,1,3390,1337,4727,28.648485
8455,Consolação,65,1,1,1,1450,850,2300,35.384617
8456,Mirandópolis,27,1,1,0,900,200,1100,40.74074
8457,Other,110,3,4,2,5500,1200,6700,60.909092
8458,Other,64,2,1,1,1500,282,1782,27.84375
8459,Other,60,2,1,1,1160,240,1400,23.333334
8460,Cerqueira César,100,2,3,1,6000,1638,7638,76.38
8461,Other,50,1,1,1,4000,742,4742,94.84
8462,Cambuci,36,1,1,1,1530,660,2190,60.833332
8463,Santo Amaro,53,1,2,1,2990,875,3865,72.92453
8464,Vila Leopoldina,140,3,3,2,5500,1400,6900,49.285713
8465,Cambuci,27,1,1,0,1300,150,1450,53.703705
8466,Itaim Bibi,35,1,1,1,2800,750,3550,101.42857
8467,Other,46,1,1,1,1800,1300,3100,67.391304
8468,Jardim Paulista,60,2,2,0,1800,886,2686,44.766666
8469,Campo Belo,130,3,5,2,4980,1400,6380,49.076923
8470,Pompeia,40,1,1,1,2100,530,2630,65.75
8471,Liberdade,43,2,1,1,1600,450,2050,47.67442
8472,Other,56,2,1,1,1300,524,1824,32.57143
8473,Jardim Paulista,30,1,1,1,2300,830,3130,104.333336
8474,Other,45,2,1,0,1000,50,1050,23.333334
8475,Lapa,62,2,3,1,2800,580,3380,54.51613
8476,Pinheiros,35,1,1,1,3500,500,4000,114.28571
8477,República,39,1,1,1,1750,750,2500,64.10256
8478,Jardim Paulista,35,1,1,0,1500,400,1900,54.285713
8479,Other,43,1,1,1,1550,545,2095,48.720932
8480,Vila Olímpia,65,2,2,1,2500,1200,3700,56.923077
8481,Other,54,2,1,1,1380,625,2005,37.12963
8482,Jaguaré,52,2,1,1,1400,403,1803,34.673077
8483,Moema,50,1,2,1,2591,831,3422,68.44
8484,Cidade Monções,70,2,2,1,4200,770,4970,71.0
8485,Bela Vista,63,2,1,2,3900,1293,5193,82.42857
8486,Jardim Marajoara,68,3,2,1,2500,0,2500,36.764706
8487,Other,55,2,1,1,1100,380,1480,26.90909
8488,Other,55,2,1,1,1000,503,1503,27.327272
8489,Santa Cecília,49,2,1,1,2500,480,2980,60.816326
8490,Jardim Paulista,54,2,1,1,3300,467,3767,69.75926
8491,Perdizes,80,2,2,1,3700,703,4403,55.0375
8492,Other,54,2,1,1,1000,220,1220,22.592592
8493,Indianópolis,40,1,1,1,2100,800,2900,72.5
8494,Brooklin,43,1,1,1,1800,630,2430,56.511627
8495,Vila Olímpia,95,3,4,2,9100,1300,10400,109.47369
8496,Jabaquara,78,3,2,1,1300,599,1899,24.346153
8497,Vila Leopoldina,128,4,4,2,5500,1500,7000,54.6875
8498,Campo Belo,47,1,1,1,2299,618,2917,62.06383
8499,Jaguaré,55,2,1,1,1500,470,1970,35.81818
8500,Butantã,75,2,2,1,2200,660,2860,38.133335
8501,Vila Nova Conceição,36,1,1,1,2836,967,3803,105.638885
8502,Mirandópolis,100,3,2,0,1800,0,1800,18.0
8503,Brooklin,34,1,1,1,2800,350,3150,92.64706
8504,Vila Mariana,54,2,1,1,2300,630,2930,54.25926
8505,Barra Funda,67,2,1,1,3000,720,3720,55.52239
8506,Other,65,3,2,2,1500,944,2444,37.6
8507,Other,83,2,3,2,4500,699,5199,62.638554
8508,Bela Vista,45,1,1,0,1600,0,1600,35.555557
8509,Bela Vista,50,2,1,0,2200,705,2905,58.1
8510,Barra Funda,53,1,1,1,2800,403,3203,60.433964
8511,Perdizes,67,2,2,2,3800,900,4700,70.149254
8512,Jardim Marajoara,113,2,2,1,3300,1100,4400,38.938053
8513,Jardim Marajoara,93,3,3,2,2200,960,3160,33.978493
8514,Moema,70,2,2,1,3000,880,3880,55.42857
8515,Vila Madalena,90,1,2,1,3000,1400,4400,48.88889
8516,Perdizes,45,1,1,1,2200,602,2802,62.266666
8517,Perdizes,30,1,1,1,1980,570,2550,85.0
8518,Jardim Paulista,60,2,1,2,2800,1000,3800,63.333332
8519,Other,48,2,1,1,2600,0,2600,54.166668
8520,Consolação,117,3,3,1,3700,1206,4906,41.931625
8521,Pompeia,70,2,1,2,6500,1340,7840,112.0
8522,Jardim Paulista,68,2,1,1,1800,1200,3000,44.117645
8523,Jardim Paulista,78,2,3,2,5540,1360,6900,88.46154
8524,Brooklin,35,1,1,1,2300,525,2825,80.71429
8525,Consolação,65,2,1,1,2700,0,2700,41.53846
8526,Vila Prudente,50,2,1,1,1800,300,2100,42.0
8527,Vila Olímpia,70,2,2,1,5500,700,6200,88.57143
8528,Vila Clementino,93,2,3,1,2350,1200,3550,38.172043
8529,Other,84,3,3,2,2500,584,3084,36.714287
8530,Moema,66,2,2,1,2100,936,3036,46.0
8531,Pinheiros,70,1,2,1,1850,634,2484,35.485714
8532,Liberdade,28,1,1,0,2100,250,2350,83.92857
8533,Itaim Bibi,49,1,1,1,3000,999,3999,81.61224
8534,Higienópolis,45,1,1,0,1699,390,2089,46.422222
8535,Bela Vista,45,1,1,1,1600,722,2322,51.6
8536,Pinheiros,76,2,2,1,3200,826,4026,52.973682
8537,Vila Madalena,48,2,1,1,2000,320,2320,48.333332
8538,Cidade Monções,145,3,4,2,5200,991,6191,42.696552
8539,Other,68,2,2,1,2500,800,3300,48.52941
8540,Saúde,70,2,2,1,1850,653,2503,35.75714
8541,Other,45,1,1,0,1300,50,1350,30.0
8542,Vila Mariana,90,3,2,1,2500,900,3400,37.77778
8543,Campo Belo,83,2,3,2,5100,800,5900,71.084335
8544,Liberdade,50,1,1,0,1100,390,1490,29.8
8545,Other,50,2,1,1,1350,267,1617,32.34
8546,Other,70,3,2,2,2700,760,3460,49.42857
8547,Other,40,2,1,1,2100,446,2546,63.65
8548,Other,48,2,1,1,1400,133,1533,31.9375
8549,Other,81,2,2,2,2300,727,3027,37.37037
8550,Aclimação,46,1,1,1,1000,451,1451,31.543478
8551,Vila Madalena,45,1,1,1,2300,730,3030,67.333336
8552,Jardim Paulista,94,3,2,1,4300,793,5093,54.18085
8553,Santo Amaro,31,1,1,1,2500,642,3142,101.354836
8554,Campo Belo,70,2,2,2,3900,777,4677,66.814285
8555,Other,49,2,1,1,1000,400,1400,28.571428
8556,Bela Vista,45,1,1,1,1700,690,2390,53.11111
8557,Vila Mariana,90,3,3,1,3400,885,4285,47.61111
8558,Vila Mascote,45,2,1,0,2100,200,2300,51.11111
8559,Pompeia,68,2,2,1,3200,980,4180,61.47059
8560,Other,52,1,1,1,2300,500,2800,53.846153
8561,Morumbi,60,2,2,1,1750,900,2650,44.166668
8562,Saúde,70,3,1,2,1500,1050,2550,36.42857
8563,Bela Vista,157,3,2,0,2999,400,3399,21.649681
8564,Other,62,2,3,2,2150,790,2940,47.419353
8565,Santa Cecília,80,2,2,0,2500,400,2900,36.25
8566,Cambuci,48,2,1,0,1500,480,1980,41.25
8567,Butantã,25,1,1,0,2790,0,2790,111.6
8568,Vila Prudente,70,2,1,0,1250,0,1250,17.857143
8569,Consolação,55,1,1,1,5200,1450,6650,120.90909
8570,Pompeia,104,3,3,2,4500,834,5334,51.28846
8571,Pinheiros,95,3,2,2,5500,1268,6768,71.2421
8572,Pinheiros,75,2,2,1,3900,793,4693,62.573334
8573,Other,65,2,2,2,1500,1000,2500,38.46154
8574,Vila Madalena,70,2,2,1,4000,797,4797,68.52857
8575,Vila Mariana,31,1,1,1,2420,528,2948,95.09677
8576,Chácara Santo Antônio,65,2,2,1,4500,741,5241,80.63077
8577,Brooklin,55,2,2,1,2800,1014,3814,69.34545
8578,Vila Olímpia,70,2,1,1,2200,700,2900,41.42857
8579,Other,75,2,2,2,4400,1172,5572,74.293335
8580,Vila Clementino,39,1,1,0,1399,397,1796,46.05128
8581,Other,40,1,1,0,1250,70,1320,33.0
8582,Tatuapé,90,3,1,0,2600,800,3400,37.77778
8583,Jardim América,90,2,2,1,3600,1410,5010,55.666668
8584,Other,37,1,1,1,2300,512,2812,76.0
8585,Other,49,1,2,1,3100,550,3650,74.4898
8586,Itaim Bibi,90,2,1,1,5700,996,6696,74.4
8587,Other,55,2,1,1,1850,640,2490,45.272728
